//MAP CONVERTED BY dmm2tgm.py THIS HEADER COMMENT PREVENTS RECONVERSION, DO NOT REMOVE
"a" = (
/turf/space,
/area/space)
"b" = (
/turf/unsimulated/wall/other,
/area/vr/roman)
"c" = (
/turf/unsimulated/beach/sand,
/area/vr/roman)
"d" = (
/obj/effect/landmark{
	name = "avatarspawn"
	},
/turf/unsimulated/beach/sand,
/area/vr/roman)
"e" = (
/turf/unsimulated/floor{
	tag = "icon-warnplate (NORTHWEST)";
	icon_state = "warnplate";
	dir = 9
	},
/area/vr/roman)
"f" = (
/turf/unsimulated/floor{
	tag = "icon-warnplate (NORTH)";
	icon_state = "warnplate";
	dir = 1
	},
/area/vr/roman)
"g" = (
/turf/unsimulated/floor{
	tag = "icon-warnplate (NORTHEAST)";
	icon_state = "warnplate";
	dir = 5
	},
/area/vr/roman)
"h" = (
/turf/unsimulated/floor{
	icon_state = "warnplate";
	dir = 8
	},
/area/vr/roman)
"i" = (
/turf/unsimulated/floor/lava/dense,
/area/vr/roman)
"j" = (
/turf/unsimulated/floor{
	icon_state = "panelscorched"
	},
/area/vr/roman)
"k" = (
/turf/unsimulated/floor{
	tag = "icon-warnplate (SOUTHWEST)";
	icon_state = "warnplate";
	dir = 10
	},
/area/vr/roman)
"l" = (
/turf/unsimulated/floor{
	tag = "icon-warnplate";
	icon_state = "warnplate";
	dir = 2
	},
/area/vr/roman)
"m" = (
/turf/unsimulated/floor{
	tag = "icon-warnplate (SOUTHEAST)";
	icon_state = "warnplate";
	dir = 6
	},
/area/vr/roman)

(1,1,1) = {"
a
a
a
a
a
a
a
a
a
a
a
b
b
b
b
b
b
b
b
a
a
a
a
a
a
a
a
a
a
a
"}
(2,1,1) = {"
a
a
a
a
a
a
a
a
b
b
b
b
c
c
c
c
c
c
b
b
b
b
a
a
a
a
a
a
a
a
"}
(3,1,1) = {"
a
a
a
a
a
a
a
b
b
c
c
c
c
c
c
c
c
c
c
c
c
b
b
a
a
a
a
a
a
a
"}
(4,1,1) = {"
a
a
a
a
a
b
b
b
c
c
c
c
c
c
d
d
c
c
c
c
c
c
b
b
b
a
a
a
a
a
"}
(5,1,1) = {"
a
a
a
a
b
b
c
c
c
c
c
c
c
c
c
c
c
c
c
c
c
c
c
d
b
b
a
a
a
a
"}
(6,1,1) = {"
a
a
a
b
b
d
c
c
e
h
k
c
c
c
c
c
c
c
c
c
c
c
c
d
d
b
b
a
a
a
"}
(7,1,1) = {"
a
a
a
b
d
d
c
c
f
i
l
c
c
c
c
c
c
c
c
c
c
e
h
k
c
c
b
a
a
a
"}
(8,1,1) = {"
a
a
b
b
c
c
c
c
g
j
m
c
c
c
c
c
c
c
c
c
c
f
i
l
c
c
b
b
a
a
"}
(9,1,1) = {"
a
b
b
c
c
c
c
c
c
c
c
c
c
c
d
d
c
c
c
c
c
g
j
m
c
c
c
b
b
a
"}
(10,1,1) = {"
a
b
c
c
c
c
c
c
c
c
c
c
c
c
c
c
c
c
c
c
c
c
c
c
c
c
c
c
b
a
"}
(11,1,1) = {"
a
b
c
c
c
c
c
c
c
c
c
d
c
c
c
c
c
c
d
c
c
c
c
c
c
c
c
c
b
a
"}
(12,1,1) = {"
b
b
c
c
c
c
c
c
c
c
d
b
c
c
c
c
c
c
b
d
c
c
c
c
c
c
c
c
b
b
"}
(13,1,1) = {"
b
c
c
c
c
c
c
c
c
c
c
c
c
c
c
c
c
c
c
c
c
c
c
c
c
c
c
c
c
b
"}
(14,1,1) = {"
b
c
c
c
e
h
k
c
c
c
c
c
c
c
c
c
c
c
c
c
c
c
c
c
c
c
c
c
c
b
"}
(15,1,1) = {"
b
c
c
d
f
i
l
c
c
d
c
c
c
c
c
c
c
c
c
c
c
d
c
c
c
c
d
c
c
b
"}
(16,1,1) = {"
b
c
c
d
g
j
m
c
c
d
c
c
c
c
c
c
c
c
c
c
c
d
c
c
c
c
d
c
c
b
"}
(17,1,1) = {"
b
c
c
c
c
c
c
c
c
c
c
c
c
c
c
c
c
c
c
c
c
c
c
c
c
c
c
c
c
b
"}
(18,1,1) = {"
b
c
c
c
c
c
c
c
c
c
c
c
c
c
c
c
c
c
c
c
c
c
c
c
c
c
c
c
c
b
"}
(19,1,1) = {"
b
b
c
c
c
c
c
c
c
c
d
b
c
c
c
c
c
c
b
d
c
c
c
c
c
c
c
c
b
b
"}
(20,1,1) = {"
a
b
c
c
c
c
c
c
c
c
c
d
c
c
c
c
c
c
d
c
c
c
c
c
c
c
c
c
b
a
"}
(21,1,1) = {"
a
b
c
c
c
c
c
c
c
c
c
c
c
c
c
c
c
c
c
c
c
c
c
c
c
c
c
c
b
a
"}
(22,1,1) = {"
a
b
b
c
c
c
c
c
c
c
c
c
c
c
d
d
c
c
c
c
c
c
c
c
c
c
c
b
b
a
"}
(23,1,1) = {"
a
a
b
b
c
c
c
c
c
c
c
c
c
c
c
c
c
c
c
c
c
c
c
c
c
c
b
b
a
a
"}
(24,1,1) = {"
a
a
a
b
d
d
c
c
c
c
c
c
c
c
c
c
c
c
c
c
c
c
c
c
d
d
b
a
a
a
"}
(25,1,1) = {"
a
a
a
b
b
d
c
c
c
c
c
c
c
c
c
c
c
c
e
h
k
c
c
c
d
b
b
a
a
a
"}
(26,1,1) = {"
a
a
a
a
b
b
c
c
c
c
c
c
c
c
c
c
c
c
f
i
l
c
c
c
b
b
a
a
a
a
"}
(27,1,1) = {"
a
a
a
a
a
b
b
b
c
c
c
c
c
c
d
d
c
c
g
j
m
c
b
b
b
a
a
a
a
a
"}
(28,1,1) = {"
a
a
a
a
a
a
a
b
b
c
c
c
c
c
c
c
c
c
c
c
c
b
b
a
a
a
a
a
a
a
"}
(29,1,1) = {"
a
a
a
a
a
a
a
a
b
b
b
b
c
c
c
c
c
c
b
b
b
b
a
a
a
a
a
a
a
a
"}
(30,1,1) = {"
a
a
a
a
a
a
a
a
a
a
a
b
b
b
b
b
b
b
b
a
a
a
a
a
a
a
a
a
a
a
"}
