//MAP CONVERTED BY dmm2tgm.py THIS HEADER COMMENT PREVENTS RECONVERSION, DO NOT REMOVE
"a" = (
/turf/space,
/area/space)
"b" = (
/turf/unsimulated/wall/metal,
/area/vr/lobby)
"c" = (
/turf/unsimulated/floor{
	tag = "icon-dark";
	icon_state = "dark"
	},
/area/vr/lobby)
"d" = (
/turf/unsimulated/wall/fakeglass{
	dir = 8;
	icon_state = "fakewindows3";
	tag = "icon-fakewindows (WEST)"
	},
/area/vr/lobby)
"e" = (
/turf/unsimulated/floor{
	icon_state = "gcircuit"
	},
/area/vr/lobby)
"f" = (
/obj/structure/decor/machinery/telecomms/processor,
/turf/unsimulated/floor{
	tag = "icon-dark";
	icon_state = "dark"
	},
/area/vr/lobby)
"g" = (
/turf/unsimulated/floor{
	icon_state = "light_on"
	},
/area/vr/lobby)
"h" = (
/turf/unsimulated/wall/fakeglass{
	dir = 1;
	icon_state = "fakewindows";
	tag = "icon-fakewindows (WEST)"
	},
/area/vr/lobby)
"i" = (
/turf/unsimulated/wall/fakeglass{
	dir = 0;
	icon_state = "fakewindows";
	tag = "icon-fakewindows (EAST)"
	},
/area/vr/lobby)
"j" = (
/obj/structure/decor/machinery/telecomms/server,
/turf/unsimulated/floor{
	icon_state = "gcircuit"
	},
/area/vr/lobby)
"k" = (
/obj/structure/decor/machinery/telecomms/relay,
/turf/unsimulated/floor{
	icon_state = "gcircuit"
	},
/area/vr/lobby)
"l" = (
/obj/structure/decor/machinery/telecomms/hub,
/turf/unsimulated/floor{
	tag = "icon-dark";
	icon_state = "dark"
	},
/area/vr/lobby)
"m" = (
/obj/machinery/computer/vr_control,
/turf/unsimulated/floor{
	tag = "icon-dark";
	icon_state = "dark"
	},
/area/vr/lobby)
"n" = (
/turf/unsimulated/wall/fakeglass{
	icon_state = "fakewindows";
	dir = 8
	},
/area/vr/lobby)
"o" = (
/turf/unsimulated/wall/fakeglass{
	tag = "icon-fakewindows (EAST)";
	icon_state = "fakewindows";
	dir = 4
	},
/area/vr/lobby)
"p" = (
/obj/effect/landmark{
	name = "avatarspawn"
	},
/turf/unsimulated/floor{
	icon_state = "gcircuit"
	},
/area/vr/lobby)
"q" = (
/obj/structure/decor/machinery/telecomms/processor,
/turf/simulated/floor/bluegrid{
	icon_state = "dark";
	name = "Mainframe Floor";
	nitrogen = 100;
	oxygen = 0;
	temperature = 80
	},
/area/vr/lobby)
"r" = (
/turf/unsimulated/wall/fakeglass,
/area/vr/lobby)

(1,1,1) = {"
a
a
a
a
a
a
a
a
a
a
a
a
a
a
a
a
a
a
a
a
a
a
a
a
a
"}
(2,1,1) = {"
a
a
a
a
a
a
a
a
a
a
a
a
a
a
a
a
a
a
a
a
a
a
a
a
a
"}
(3,1,1) = {"
a
a
a
a
a
b
b
b
b
b
b
a
a
a
a
a
a
a
a
a
a
a
a
a
a
"}
(4,1,1) = {"
a
a
a
a
a
b
b
c
e
c
b
b
b
b
b
a
a
a
a
a
a
a
a
a
a
"}
(5,1,1) = {"
a
a
a
a
a
b
c
g
e
g
c
d
e
e
b
a
a
a
a
a
a
a
a
a
a
"}
(6,1,1) = {"
a
a
a
a
a
b
e
e
j
e
e
m
e
e
b
a
a
a
a
a
a
a
a
a
a
"}
(7,1,1) = {"
a
a
a
a
a
b
c
g
e
g
c
d
e
e
b
a
a
a
a
a
a
a
a
a
a
"}
(8,1,1) = {"
a
a
a
a
a
b
e
e
k
e
e
m
e
e
b
a
a
a
a
a
a
a
a
a
a
"}
(9,1,1) = {"
a
a
a
a
a
b
c
g
e
g
c
d
e
e
b
a
a
a
a
a
a
a
a
a
a
"}
(10,1,1) = {"
a
a
a
a
a
b
e
e
j
e
e
m
e
e
b
a
a
a
a
a
a
a
a
a
a
"}
(11,1,1) = {"
a
a
a
a
a
b
c
g
e
g
c
d
e
e
b
a
a
a
a
a
a
a
a
a
a
"}
(12,1,1) = {"
a
a
a
a
a
b
e
e
k
e
e
m
e
e
b
a
a
a
a
a
a
a
a
a
a
"}
(13,1,1) = {"
a
a
a
a
a
b
c
g
e
g
c
d
e
e
b
a
a
a
a
a
a
a
a
a
a
"}
(14,1,1) = {"
a
a
a
a
a
b
e
e
j
e
e
m
e
e
b
a
a
a
a
a
a
a
a
a
a
"}
(15,1,1) = {"
a
a
a
a
a
b
c
g
e
g
c
d
e
e
b
a
a
a
a
a
a
a
a
a
a
"}
(16,1,1) = {"
a
a
a
a
a
b
b
c
e
c
b
b
c
c
b
b
a
a
a
a
a
a
a
a
a
"}
(17,1,1) = {"
a
a
a
a
a
b
b
b
b
b
b
d
e
e
d
b
b
b
a
a
a
a
a
a
a
"}
(18,1,1) = {"
a
a
a
a
a
b
b
b
b
e
e
f
e
e
f
e
e
b
b
b
b
a
a
a
a
"}
(19,1,1) = {"
a
a
a
a
a
b
e
e
e
e
g
n
e
e
n
g
e
e
e
e
b
a
a
a
a
"}
(20,1,1) = {"
a
a
a
a
a
b
e
g
c
g
c
o
e
e
o
c
g
c
g
e
b
a
a
a
a
"}
(21,1,1) = {"
a
a
a
a
b
b
e
c
e
e
e
l
e
e
l
e
e
e
c
e
b
b
a
a
a
"}
(22,1,1) = {"
a
a
a
a
b
e
e
g
e
c
g
n
e
e
n
g
c
e
g
e
e
b
a
a
a
"}
(23,1,1) = {"
a
a
a
b
b
e
g
c
e
g
c
o
e
e
o
c
g
e
c
g
e
b
b
a
a
"}
(24,1,1) = {"
a
a
b
b
d
f
h
i
l
h
i
b
c
c
b
h
r
l
h
r
f
d
b
b
a
"}
(25,1,1) = {"
a
a
b
c
e
e
e
e
e
e
e
c
p
p
c
e
e
e
e
e
e
e
c
b
a
"}
(26,1,1) = {"
a
a
b
c
e
e
e
e
e
e
e
c
p
p
c
e
e
e
e
e
e
e
c
b
a
"}
(27,1,1) = {"
a
a
b
b
d
f
h
i
l
h
i
b
c
c
b
h
i
l
h
i
f
d
b
b
a
"}
(28,1,1) = {"
a
a
a
b
b
e
g
c
e
g
c
n
e
e
n
c
g
e
c
g
e
b
b
a
a
"}
(29,1,1) = {"
a
a
a
a
b
e
e
g
e
c
g
o
e
e
o
g
c
e
g
e
e
b
a
a
a
"}
(30,1,1) = {"
a
a
a
a
b
b
e
c
e
e
e
l
e
e
l
e
e
e
c
e
b
b
a
a
a
"}
(31,1,1) = {"
a
a
a
a
a
b
e
g
c
g
c
n
e
e
n
c
g
c
g
e
b
a
a
a
a
"}
(32,1,1) = {"
a
a
a
a
a
b
e
e
e
e
g
o
e
e
o
g
e
e
e
e
b
a
a
a
a
"}
(33,1,1) = {"
a
a
a
a
a
b
b
b
b
e
e
f
e
e
q
e
e
b
b
b
b
a
a
a
a
"}
(34,1,1) = {"
a
a
a
a
a
b
b
b
b
b
b
d
e
e
d
b
b
b
a
a
a
a
a
a
a
"}
(35,1,1) = {"
a
a
a
a
a
b
b
c
e
c
b
b
c
c
b
b
a
a
a
a
a
a
a
a
a
"}
(36,1,1) = {"
a
a
a
a
a
b
c
g
e
g
c
d
e
e
b
a
a
a
a
a
a
a
a
a
a
"}
(37,1,1) = {"
a
a
a
a
a
b
e
e
j
e
e
m
e
e
b
a
a
a
a
a
a
a
a
a
a
"}
(38,1,1) = {"
a
a
a
a
a
b
c
g
e
g
c
d
e
e
b
a
a
a
a
a
a
a
a
a
a
"}
(39,1,1) = {"
a
a
a
a
a
b
e
e
k
e
e
m
e
e
b
a
a
a
a
a
a
a
a
a
a
"}
(40,1,1) = {"
a
a
a
a
a
b
c
g
e
g
c
d
e
e
b
a
a
a
a
a
a
a
a
a
a
"}
(41,1,1) = {"
a
a
a
a
a
b
e
e
j
e
e
m
e
e
b
a
a
a
a
a
a
a
a
a
a
"}
(42,1,1) = {"
a
a
a
a
a
b
c
g
e
g
c
d
e
e
b
a
a
a
a
a
a
a
a
a
a
"}
(43,1,1) = {"
a
a
a
a
a
b
e
e
k
e
e
m
e
e
b
a
a
a
a
a
a
a
a
a
a
"}
(44,1,1) = {"
a
a
a
a
a
b
c
g
e
g
c
d
e
e
b
a
a
a
a
a
a
a
a
a
a
"}
(45,1,1) = {"
a
a
a
a
a
b
e
e
j
e
e
m
e
e
b
a
a
a
a
a
a
a
a
a
a
"}
(46,1,1) = {"
a
a
a
a
a
b
c
g
e
g
c
d
e
e
b
a
a
a
a
a
a
a
a
a
a
"}
(47,1,1) = {"
a
a
a
a
a
b
b
c
e
c
b
b
b
b
b
a
a
a
a
a
a
a
a
a
a
"}
(48,1,1) = {"
a
a
a
a
a
b
b
b
b
b
b
a
a
a
a
a
a
a
a
a
a
a
a
a
a
"}
(49,1,1) = {"
a
a
a
a
a
a
a
a
a
a
a
a
a
a
a
a
a
a
a
a
a
a
a
a
a
"}
(50,1,1) = {"
a
a
a
a
a
a
a
a
a
a
a
a
a
a
a
a
a
a
a
a
a
a
a
a
a
"}
