"a" = (/turf/space,/area/space)
"b" = (/turf/unsimulated/wall/metal,/area/vr/lobby)
"c" = (/turf/unsimulated/floor{tag = "icon-dark"; icon_state = "dark"},/area/vr/lobby)
"d" = (/turf/unsimulated/wall/fakeglass{dir = 8; icon_state = "fakewindows3"; tag = "icon-fakewindows (WEST)"},/area/vr/lobby)
"e" = (/turf/unsimulated/floor{icon_state = "gcircuit"},/area/vr/lobby)
"f" = (/obj/machinery/telecomms/processor/preset_cent,/turf/unsimulated/floor{tag = "icon-dark"; icon_state = "dark"},/area/vr/lobby)
"g" = (/turf/unsimulated/floor{icon_state = "light_on"},/area/vr/lobby)
"h" = (/turf/unsimulated/wall/fakeglass{dir = 1; icon_state = "fakewindows"; tag = "icon-fakewindows (WEST)"},/area/vr/lobby)
"i" = (/turf/unsimulated/wall/fakeglass{dir = 0; icon_state = "fakewindows"; tag = "icon-fakewindows (EAST)"},/area/vr/lobby)
"j" = (/obj/machinery/telecomms/server/presets/centcomm,/turf/unsimulated/floor{icon_state = "gcircuit"},/area/vr/lobby)
"k" = (/obj/machinery/telecomms/relay/preset/centcom,/turf/unsimulated/floor{icon_state = "gcircuit"},/area/vr/lobby)
"l" = (/obj/machinery/telecomms/hub/preset_cent,/turf/unsimulated/floor{tag = "icon-dark"; icon_state = "dark"},/area/vr/lobby)
"m" = (/obj/machinery/computer/vr_control,/turf/unsimulated/floor{tag = "icon-dark"; icon_state = "dark"},/area/vr/lobby)
"n" = (/turf/unsimulated/wall/fakeglass{icon_state = "fakewindows"; dir = 8},/area/vr/lobby)
"o" = (/turf/unsimulated/wall/fakeglass{tag = "icon-fakewindows (EAST)"; icon_state = "fakewindows"; dir = 4},/area/vr/lobby)
"p" = (/obj/effect/landmark{name = "avatarspawn"},/turf/unsimulated/floor{icon_state = "gcircuit"},/area/vr/lobby)
"q" = (/turf/unsimulated/wall/fakeglass,/area/vr/lobby)

(1,1,1) = {"
aaaaaaaaaaaaaaaaaaaaaaaaaaaaaaaaaaaaaaaaaaaaaaaaaa
aaaaaaaaaaaaaaaaaaaaaaaaaaaaaaaaaaaaaaaaaaaaaaaaaa
aaaaaaaaaaaaaaaaaaaaaaabbbbaaaaaaaaaaaaaaaaaaaaaaa
aaaaaaaaaaaaaaaaaaaaaabbccbbaaaaaaaaaaaaaaaaaaaaaa
aaaaaaaaaaaaaaaaaaaabbbdeedbbbaaaaaaaaaaaaaaaaaaaa
aabbbbbbbbbbbbbbbbbbbeefeefeebbbbbbbbbbbbbbbbbbbaa
aabbcecececececbbbeeeegheehgeeeebbbcecececececbbaa
aabcgegegegegegcbbegcgcieeicgcgebbcgegegegegegcbaa
aabeejekejekejeebbeceeeleeleeecebbeejekejekejeebaa
aabcgegegegegegcbeegecgheehgcegeebcgegegegegegcbaa
aabbcecececececbbegcegcieeicgecgebbcecececececbbaa
aaabdmdmdmdmdmdbdfnolnobccbnolnofdbdmdmdmdmdmdbaaa
aaabeeeeeeeeeeeceeeeeeecppceeeeeeeceeeeeeeeeeebaaa
aaabeeeeeeeeeeeceeeeeeecppceeeeeeeceeeeeeeeeeebaaa
aaabbbbbbbbbbbbbdfnolnobccbnolnofdbbbbbbbbbbbbbaaa
aaaaaaaaaaaaaaabbegcegcheehcgecgebbaaaaaaaaaaaaaaa
aaaaaaaaaaaaaaaabeegecgqeeigcegeebaaaaaaaaaaaaaaaa
aaaaaaaaaaaaaaaabbeceeeleeleeecebbaaaaaaaaaaaaaaaa
aaaaaaaaaaaaaaaaabegcgcheehcgcgebaaaaaaaaaaaaaaaaa
aaaaaaaaaaaaaaaaabeeeegqeeigeeeebaaaaaaaaaaaaaaaaa
aaaaaaaaaaaaaaaaabbbbeefeefeebbbbaaaaaaaaaaaaaaaaa
aaaaaaaaaaaaaaaaaaaabbbdeedbbbaaaaaaaaaaaaaaaaaaaa
aaaaaaaaaaaaaaaaaaaaaabbccbbaaaaaaaaaaaaaaaaaaaaaa
aaaaaaaaaaaaaaaaaaaaaaabbbbaaaaaaaaaaaaaaaaaaaaaaa
aaaaaaaaaaaaaaaaaaaaaaaaaaaaaaaaaaaaaaaaaaaaaaaaaa
"}
