"a" = (/turf/template_noop,/area/template_noop)
"H" = (/turf/simulated/wall,/area/ruin/space)
"I" = (/mob/living/simple_animal/hostile/carp/megacarp,/turf/space,/area/ruin/space)
"L" = (/turf/space,/area/ruin/space)
"P" = (/obj/structure/lattice,/turf/space,/area/ruin/space)

(1,1,1) = {"
aaaaaaaaaaaaaaaaaaaaaaaaaaaaaaaaaaaaaaaaaaaaaaaaaaaaaaaaaaaaaaaaaaaaaaaaaaaaaaaaaaaaaaaaaaaaaaaaaaaa
aaaaaaaaaaaaaaaaaaaaaaaaaaaaaaaaaaaaaaaaaaaaaaaaaaaaaaaaaaaaaaaaaaaaaaaaaaaaaaaaaaaaaaaaaaaaaaaaaaaa
aaaaaaaaaaaaaaaaaaaaaaaaaaaaaaaaaaaaaaaaaaaaaaaaaaaaaaaaaaaaaaaaaaaaaaaaaaaaaaaaaaaaaaaaaaaaaaaaaaaa
aaaaaaaaaaaaaaaaaaaaaaaaaaaaaaaaaaaaaaaaaaaaaaaaaaaaaaaaaaaaaaaaaaaaaaaaaaaaaaaaaaaaaaaaaaaaaaaaaaaa
aaaaaaaaaaaaaaaaaaaaaaaaaaaaaaaaaaaaaaaaaaaaaaaaaaaaaaaaaaaaaaaaaaaaaaaaaaaaaaaaaaaaaaaaaaaaaaaaaaaa
aaaaaaaaaaaaaaaaaaaaaaaaaaaaaaaaaaaaaaaaaaaaaaaaaaaaaaaaaaaaaaaaaaaaaaaaaaaaaaaaaaaaaaaaaaaaaaaaaaaa
aaaaaaaaaaaaaaaaaaaaaaaaaaaaaaaaaaaaaaaaaaaaaaaaaaaaaaaaaaaaaaaaaaaaaaaaaaaaaaaaaaaaaaaaaaaaaaaaaaaa
aaaaaaaaaaaaaaaaaaaaaaaaaaaaaaaaaaaaaaaaaaaaaaaaaaaaaaaaaaaaaaaaaaaaaaaaaaaaaaaaaaaaaaaaaaaaaaaaaaaa
aaaaaaaHLLHHHHHHHHHHHHHHHHHHHHHHHHHHHHHHHHHHHHHHHHHHHHHHHHHHHHHHHHHHHHHHHHHHHHLLLLLLLLLLLLLaaaaaaaaa
aaaaaaaHLLHLLLLLLLLLHLLLLLLLLHLLLLLLLLLLLHLLLLLLLLLLLHLLLLLLLLLLLLLLLLLLLLLLLLLLLLLLLLLLLLLaaaaaaaaa
aaaaaaaHLLHLLLLLLLLLHLLLLLLLLHLLLLLLLLLLLHLLLLLLLLLLLHLLLLLLLLLLLLLLLLLLLLLLLLLLLLLLLLLLLLLaaaaaaaaa
aaaaaaaHLLHHHHHLLHLLHHHHHHHLLHLLHLLHHHHLLHLLHHHHHHHLLHLLHHHHHLLLLLLLLLLLLLLLLLLLLLLLLLLLLLLaaaaaaaaa
aaaaaaaHLLLLLLLLLHLLHLLLLLHLLHLLHLLHLLLLLHLLHLLLLLHLLHLLHHHHHLLLLLLLLLLLLLLLLLLLLLLLLLLLLLLaaaaaaaaa
aaaaaaaHLLLLLLLLLHLLHLLLLLHLLHLLHLLHLLLLLHLLHLLLLLHLLHLLHHHHHLLLLLLLLLLLLLLLLLLLLLLLLLLLLLLaaaaaaaaa
aaaaaaaHLLHHHHHHHHLLHHHHLLHLLHLLHLLHLLHHHHLHHLLHHHHLLHLLLLLHHLLLLLLLLLLLLLLLLLLLLLLLLLLLLLLaaaaaaaaa
aaaaaaaHLLLLLLLLLHLLLLLHLLHLLHLLHLLHLLHLLLLLHLLHLLLLLHLLLLLHHLLLLLLLLLLLLLLLLLLLLLLLLLLLLLLaaaaaaaaa
aaaaaaaHLLLLLLLLLHLLLLLHLLHLLHLLHLLHLLHLLLLLHLLHLLHHHHHHHLLHHLLLLLLLLLLLLLLLLLLLLLLLLLLLLLLaaaaaaaaa
aaaaaaaHLLHHHHHHHHHHHLLHLLHLLHLLHLLHLLHLLLLLHLLHLLHLLLLLHLLLHLLLLLLLLLLLLLLLLLLLLLLLLLLLLLLaaaaaaaaa
aaaaaaaHLLLLLLLLLLLLHLLHLLHLLHLLHLLHLLHHHHHHHLLHLLHLLLLLHLLLHLLLLLLLLLLLLLLLLLLLLLLLLLLLLLLaaaaaaaaa
aaaaaaaHLLLLLLLLLLLLHLLHLLHLLHLLLLLLLLLLLLLLLLLHLLHLLHHHHHLLHLLLLLLLLLLLLLLLLLLLLLLLLLLLLLLaaaaaaaaa
aaaaaaaHLLHHHHHHHHHHHLLHLLHLLHLLLLLLLLLLLLLLLLLHLLHLLHLLLLLLHLLLLLLLLLLLLLLLLLLLLLLLLLLLLLLaaaaaaaaa
aaaaaaaHLLLLLLLLLLLLHLLHLLHLLHLLHLLHHHHHLLHHHHHHLLHLLHLLLLLLHLLLLLLLLLLLLLLLLLLLLLLLLLLLLLLaaaaaaaaa
aaaaaaaHLLLLLLLLLLLLHLLHLLHLLHLLHLLHLLLHLLHLLLHHLLHLLHLLHHHHHLLLLLLLLLLLLLLLLLLLLLLLLLLLLLLaaaaaaaaa
aaaaaaaHLLHHHHHHHHHHHHHHLLHLLHLLHLLHLLLHLLHHHHHHLLHLLHLLLLLLLLLLLLLLLLLLLLLLLLLLLLLLLLLLLLLaaaaaaaaa
aaaaaaaHLLLLLLLLLLLLLLLLLLHLLHLLHLLHLLLHLLLLLLLHLLHLLHLLLLLLLLLLLLLLLLLLLLLLLLLLLLLLLLLLLLLaaaaaaaaa
aaaaaaaHLLLLLLLLLLLLLLLLLLHLLHLLHLLHLLLLLLLLLLLHLLHLLHLLLLLLLLLLLLLLLLLLLLLLLLLLLLLLLLLLLLLaaaaaaaaa
aaaaaaaHLLHHHHHHHHHHHHHHLLHLLHLLHLLHHHHHHHHHHHHHLLHLLHHHHLLLLLLLLLLLLLLLLLLLLLLLLLLLLLLLLLLaaaaaaaaa
aaaaaaaHLLLLLLLLLLLLLLLHLLLLLHLLHLLLLLLLLLLLHLLLLLLLLLLLHLLLLLLLLLLLLLLLLLLLLLLLLLLLLLLLLLLaaaaaaaaa
aaaaaaaHLLLLLLLLLLLLLLLHLLLLLHLLHLLLLLLLLLLLHLLLLLLLLLLLHLLLLLLLLLLLLLLLLLLLLLLLLLLLLLLLLLLaaaaaaaaa
aaaaaaaHLLHHHHHHHHHHHLLHHHHHHHLLHHHHHHHHHHLLHLLHHHHHHHHHHLLLLLLLLLLLLLLLLLLLLLLLLLLLLLLLLLLaaaaaaaaa
aaaaaaaHLLLLLLLLLLLLHLLLLLLLLLLLLLLLLLLLLLLLHLLHLLLLLLLLLLLLLLLLLLLLLLLLLLLLLLLLLLLLLLLLLLLaaaaaaaaa
aaaaaaaHLLLLLLLLLLLLHLLLLLLLLLLLLLLLLLLLLLLLHLLHLLLLLLLLLLLLLLLLLLLLLLLLLLLLLLLLLLLLLLLLLLLaaaaaaaaa
aaaaaaaHLLHHHHHHHHHHHHHHHHHHHHHHHLLHHHHHHHHHHLLHLLHHHHLLLLLLLLLLLLLLLLLLLLLLLLLLLLLLLLLLLLLaaaaaaaaa
aaaaaaaHLLLLLLLLLLLLHLLLLLLLLLLLHLLHLLLLLLLLHLLHLLHLLHLLLLLLLLLLLLLLLLLLLLLLLLLLLLLLLLLLLLLaaaaaaaaa
aaaaaaaHLLLLLLLLLLLLHLLLLLLLLLLLHLLHLLLLLLLLHLLHLLHLLHLLLLLLLLLLLLLLLLLLLLLLLLLLLLLLLLLLLLLaaaaaaaaa
aaaaaaaHLLHHHHHHHHHHHLLHLLHHHHHHHLLHHHHHHHLLHLLHLLLLLHLLLLLLLLLLLLLLLLLLLLLLLLLLLLLLLLLLLLLaaaaaaaaa
aaaaaaaHLLLLLLLLLLLLHLLHLLHHHHHHHLLHHHHHHHLLHLLHLLLLLHLLLLLLLLLLLLLLLLLLLLLLLLLLLLLLLLLLLLLaaaaaaaaa
aaaaaaaHLLLLLLLLLLLLHLLHLLHHHHHHHLLHHHHHHHLLHLLHHHHHHHLLLLLLLLLLLLLLLLLLLLLLLLLLLLLLLLLLLLLaaaaaaaaa
aaaaaaaHHHHHHHHHHHHHHHHHLLLLLLLLLLLLLLLLLLLLHLLLLLLLLHLLLLLLLLLLLLLLLLLLLLLLLLLLLLLLLLLLLLLaaaaaaaaa
aaaaaaaHLLLLLLLLLLLLLLLHLLLLLLLLLLLLLLLLLLLLHLLLLLLLLHLLLLLLLLLLLLLLLLLLLLLLLLLLLLLLLLLLLLLaaaaaaaaa
aaaaaaaHLLLLLLLLLLLLLLLHLLHHHHHHHLLHHHHHHHLLHHHHHHHLLHLLLLLLLLLLLLLLLLLLLLLLLLLLLLLLLLLLLLLaaaaaaaaa
aaaaaaaHLLHHHLLHHHHHHLLHLLHLLLLLHLLHLLLLLLLLLLLLLLHLLHLLLLLLLLLLLLLLLLLLLLLLLLLLLLLLLLLLLLLaaaaaaaaa
aaaaaaaHLLLLHLLHLLLLHLLHLLHLLLLLHLLHLLLLLLLLLLLLLLHLLHLLLLLLLLLLLLLLLLLLLLLLLLLLLLLLLLLLLLLaaaaaaaaa
aaaaaaaHLLLLHLLHLLLLHLLHLLHHHHLLHLLHLLHHHHHHHHHHLLHLLHLLLLLLLLLLLLLLLLLLLLLLLLLLLLLLLLLLLLLaaaaaaaaa
aaaaaaaHHHLLHLLHHHLLHLLHLLLLLLLLHLLHLLLLLLLLLLLHLLHLLHLLLLLLLLLLLLLLLLLLLLLLLLLLLLLLLLLLLLLaaaaaaaaa
aaaaaaaHLLLLHLLLLHLLHLLHLLLLLLLLHLLHLLLLLLLLLLLHLLHLLHLLLLLLLLLLLLLLLLLLLLLLLLLLLLLLLLLLLLLaaaaaaaaa
aaaaaaaHLLLLHLLLLHLLHLLHHHHHHHHHHHHHHHHHHHHHHLLHHHHHHHHHHHLLLLLLLLLLLLLLLLLLLLLLLLLLLLLLLLLaaaaaaaaa
aaaaaaaHLLHHHLLLLLLLHLLLLLLLLLLLLLHHHLLHLLHLLLLLLHLLHLLHHHLLLLLLLLLLLLLLLLLLLLLLLLLLLLLLLLLaaaaaaaaa
aaaaaaaHLLLLHLLLLLLLHLLLLLLLLLLLLLHHLLLPLLPLLLLLLPLLPLLLHHLLLLLLLLLLLLLLLLLLLLLLLLLLLLLLLLLaaaaaaaaa
aaaaaaaHLLLLHHHHHHLLHHHLLHLLHHHHLLHLLLLPLLPLLLLLLPLLPLLLLHLLLLLLLLLLLLLLLLLLLLLLLLLLLLLLLLLaaaaaaaaa
aaaaaaaHLLLLLLHLLHLLLLHLLHLLHLLHLLHLLLLPLLPLLLLLLPLLPLLLLHLLLLLLLLLLLLLLLLLLLLLLLLLLLLLLLLLaaaaaaaaa
aaaaaaaHLLLLLLHLLHLLLLHLLHLLHLLHLLHHPPPHPPHLLLLLLHPPHPPPHHLLLLLLLLLLLLLLLLLLLLLLLLLLLLLLLLLaaaaaaaaa
aaaaaaaHHHHHLLHLLHHHLLHLLHLLHLLHLLHLLLLPLLPLLLLLLPLLPLLLLHLLLLLLLLLLLLLLLLLLLLLLLLLLLLLLLLLaaaaaaaaa
aaaaaaaHLLLLLLHLLLLHLLHLLHLLHLLHLLHLLLLPLLPLLLLLLPLLPLLLLHLLLLLLLLLLLLLLLLLLLLLLLLLLLLLLLLLaaaaaaaaa
aaaaaaaHLLLLLLHLLLLHLLHLLHLLHLLLLLHHPPPHPPHLLLLLLHPPHPPPHHLLLLLLLLLLLLLLLLLLLLLLLLLLLLLLLLLaaaaaaaaa
aaaaaaaHLLHLLHHHHLLHLLHLLHLLHLLLLLHLLLLLLLLLLLLLLLLLLLLLLHLLLLLLLLLLLLLLLLLLLLLLLLLLLLLLLLLaaaaaaaaa
aaaaaaaHLLHLLHLLHLLHLLHHHHLLHHHHHHHLLLLLLLLLLLLLLLLLLLLLLHLLLLLLLLLLLLLLLLLLLLLLLLLLLLLLLLLaaaaaaaaa
aaaaaaaHLLHLLHLLHLLHLLLLLLLLLLLLLLLLLLLLLLLILLLLLLLLLLLLLLLLLLLLLLLLLLLLLLLLLLLLLLLLLLLLLLLaaaaaaaaa
aaaaaaaHLLHLLHLLHLLHLLLLLLLLLLLLLLLLLLLLLLLLLLLLILLLLLLLLLLLLLLLLLLLLLLLLLLLLLLLLLLLLLLLLLLaaaaaaaaa
aaaaaaaHLLHLLHLLHLLHHHHHHHHHHLLHLLHLLLLLLLLLLLLLLLLLLLLLLHLLLLLLLLLLLLLLLLLLLLLLLLLLLLLLLLLaaaaaaaaa
aaaaaaaHLLHLLHLLHLLLLLLLLLLLLLLHLLHLLLLLLLLLLLLLLLLLLLLLLHLLLLLLLLLLLLLLLLLLLLLLLLLLLLLLLLLaaaaaaaaa
aaaaaaaHLLHLLHLLHLLLLLLLLLLLLLLHLLHHPPPHPPHLLLLLLHPPHPPPHHLLLLLLLLLLLLLLLLLLLLLLLLLLLLLLLLLaaaaaaaaa
aaaaaaaHLLHLLHLLHHHHHHHHHHHHHHHHLLHLLLLPLLPLLLLLLPLLPLLLLHLLLLLLLLLLLLLLLLLLLLLLLLLLLLLLLLLaaaaaaaaa
aaaaaaaHLLHLLHLLLLLLLLLLLLLLLLLLLLHLLLLPLLPLLLLLLPLLPLLLLHLLLLLLLLLLLLLLLLLLLLLLLLLLLLLLLLLaaaaaaaaa
aaaaaaaHLLHLLHLLLLLLLLLLLLLLLLLLLLHHPPPHPPHLLLLLLHPPHPPPHHLLLLLLLLLLLLLLLLLLLLLLLLLLLLLLLLLaaaaaaaaa
aaaaaaaHLLHHHHHHHHHHHHHHHHHHHHHHLLHLLLLPLLPLLLLLLPLLPLLLLHLLLLLLLLLLLLLLLLLLLLLLLLLLLLLLLLLaaaaaaaaa
aaaaaaaHLLLLLLLLLLLLLLLLLLLLLLLHLLHLLLLPLLPLLLLLLPLLPLLLLHLLLLLLLLLLLLLLLLLLLLLLLLLLLLLLLLLaaaaaaaaa
aaaaaaaHLLLLLLLLLLLLLLLLLLLLLLLHLLHHLLLPLLPLLLLLLPLLPLLLHHLLLLLLLLLLLLLLLLLLLLLLLLLLLLLLLLLaaaaaaaaa
aaaaaaaHHHHHHLLHHLLHHHHHHHHHHLLHLLHHHLLHLLHLLHHLLHLLHLLHHHLLLLLLLLLLLLLLLLLLLLLLLLLLLLLLLLLaaaaaaaaa
aaaaaaaHLLLLLLLHHLLHLLLLLLLLHLLHHHHHHHHHHHHHHHHHHHHHHHHHHHLLLLLLLLLLLLLLLLLLLLLLLLLLLLLLLLLaaaaaaaaa
aaaaaaaHLLLLLLLHHLLHLLLLLLLLHLLHLLLLLLLLLLLLLLLLLLLLLLLLLLLLLLLLLLLLLLLLLLLLLLLLLLLLLLLLLLLaaaaaaaaa
aaaaaaaHLLHHHHHHHLLHLLHHHHHHHLLHLLLLLLLLLLLLLLLLLLLLLLLLLLLLLLLLLLLLLLLLLLLLLLLLLLLLLLLLLLLaaaaaaaaa
aaaaaaaHLLHLLLLLLLLHLLHLLLLLLLLHLLHHHLLLLLLLLLLLLLLLLLLLLLLLLLLLLLLLLLLLLLLLLLLLLLLLLLLLLLLaaaaaaaaa
aaaaaaaHLLHLLLLLLLLHLLHLLLLLLLLHLLHLLLLLLLLLLLLLLLLLLLLLLLLLLLLLLLLLLLLLLLLLLLLLLLLLLLLLLLLaaaaaaaaa
aaaaaaaHLLHLLHHHHHHHLLHLLHHHHHHHLLHLLLLLLLLLLLLLLLLLLLLLLLLLLLLLLLLLLLLLLLLLLLLLLLLLLLLLLLLaaaaaaaaa
aaaaaaaHLLHLLLLLLLLLLLHLLLLLLLLHLLLLLHLLLLLLLLLLLLLLLLLLLLLLLLLLLLLLLLLLLLLLLLLLLLLLLLLLLLLaaaaaaaaa
aaaaaaaHLLHLLLLLLLLLLLHLLLLLLLLHLLLLLHLLLLLLLLLLLLLLLLLLLLLLLLLLLLLLLLLLLLLLLLLLLLLLLLLLLLLaaaaaaaaa
aaaaaaaHLLHLLHHHHHHHHHHHHHHHHHHHLLHLLHLLLLLLLLLLLLLLLLLLLLLLLLLLLLLLLLLLLLLLLLLLLLLLLLLLLLLaaaaaaaaa
aaaaaaaHLLHLLLLLLLLHLLHLLLLLLLLLLLHLLLLLLLLLLLLLLLLLLLLLLLLLLLLLLLLLLLLLLLLLLLLLLLLLLLLLLLLaaaaaaaaa
aaaaaaaHLLHLLLLLLLLHLLHLLLLLLLLLLLHLLLLLLLLLLLLLLLLLLLLLLLLLLLLLLLLLLLLLLLLLLLLLLLLLLLLLLLLaaaaaaaaa
aaaaaaaHLLHLLHHHHHHHLLHLLHHHHHHHLLHLLLLLLLLLLLLLLLLLLLLLLLLLLLLLLLLLLLLLLLLLLLLLLLLLLLLLLLLaaaaaaaaa
aaaaaaaHLLLLLLLLLLLLLLHLLHLLLLLLLLLLLLLLLLLLLLLLLLLLLLLLLLLLLLLLLLLLLLLLLLLLLLLLLLLLLLLLLLLaaaaaaaaa
aaaaaaaHLLLLLLLLLLLLLLHLLHLLLLLLLLLLLLLLLLLLLLLLLLLLLLLLLLLLLLLLLLLLLLLLLLLLLLLLLLLLLLLLLLLaaaaaaaaa
aaaaaaaHLLHHHHHHHHHHHHHLLHLLLLLLLLLLLLLLLLLLLLLLLLLLLLLLLLLLLLLLLLLLLLLLLLLLLLLLLLLLLLLLLLLaaaaaaaaa
aaaaaaaHLLLLLLLLLLLLLLLLLHLLLLLLLLLLLLLLLLLLLLLLLLLLLLLLLLLLLLLLLLLLLLLLLLLLLLLLLLLLLLLLLLLaaaaaaaaa
aaaaaaaHLLLLLLLLLLLLLLLLLHLLLLLLLLLLLLLLLLLLLLLLLLLLLLLLLLLLLLLLLLLLLLLLLLLLLLLLLLLLLLLLLLLaaaaaaaaa
aaaaaaaHHHHHHHHLLHHHHHHHHHLLLLLLLLLLLLLLLLLLLLLLLLLLLLLLLLLLLLLLLLLLLLLLLLLLLLLLLLLLLLLLLLLaaaaaaaaa
aaaaaaaHLLLLLLLLLLLLLLLLLHLLLLLLLLLLLLLLLLLLLLLLLLLLLLLLLLLLLLLLLLLLLLLLLLLLLLLLLLLLLLLLLLLaaaaaaaaa
aaaaaaaHLLLLLLLLLLLLLLLLLHLLLLLLLLLLLLLLLLLLLLLLLLLLLLLLLLLLLLLLLLLLLLLLLLLLLLLLLLLLLLLLLLLaaaaaaaaa
aaaaaaaHLLHHHHHHHHHHHHHLLHLLLLLLLLLLLLLLLLLLLLLLLLLLLLLLLLLLLLLLLLLLLLLLLLLLLLLLLLLLLLLLLLLaaaaaaaaa
aaaaaaaHLLLLLLLLHLLLLLLLLHLLLLLLLLLLLLLLLLLLLLLLLLLLLLLLLLLLLLLLLLLLLLLLLLLLLLLLLLLLLLLLLLLaaaaaaaaa
aaaaaaaHLLLLLLLLHLLLLLLLLHLLLLLLLLLLLLLLLLLLLLLLLLLLLLLLLLLLLLLLLLLLLLLLLLLLLLLLLLLLLLLLLLLaaaaaaaaa
aaaaaaaHHHHHHHHHHHHHHHHHHHLLLLLLLLLLLLLLLLLLLLLLLLLLLLLLLLLLLLLLLLLLLLLLLLLLLLLLLLLLLLLLLLLaaaaaaaaa
aaaaaaaaaaaaaaaaaaaaaaaaaaaaaaaaaaaaaaaaaaaaaaaaaaaaaaaaaaaaaaaaaaaaaaaaaaaaaaaaaaaaaaaaaaaaaaaaaaaa
aaaaaaaaaaaaaaaaaaaaaaaaaaaaaaaaaaaaaaaaaaaaaaaaaaaaaaaaaaaaaaaaaaaaaaaaaaaaaaaaaaaaaaaaaaaaaaaaaaaa
aaaaaaaaaaaaaaaaaaaaaaaaaaaaaaaaaaaaaaaaaaaaaaaaaaaaaaaaaaaaaaaaaaaaaaaaaaaaaaaaaaaaaaaaaaaaaaaaaaaa
aaaaaaaaaaaaaaaaaaaaaaaaaaaaaaaaaaaaaaaaaaaaaaaaaaaaaaaaaaaaaaaaaaaaaaaaaaaaaaaaaaaaaaaaaaaaaaaaaaaa
aaaaaaaaaaaaaaaaaaaaaaaaaaaaaaaaaaaaaaaaaaaaaaaaaaaaaaaaaaaaaaaaaaaaaaaaaaaaaaaaaaaaaaaaaaaaaaaaaaaa
aaaaaaaaaaaaaaaaaaaaaaaaaaaaaaaaaaaaaaaaaaaaaaaaaaaaaaaaaaaaaaaaaaaaaaaaaaaaaaaaaaaaaaaaaaaaaaaaaaaa
aaaaaaaaaaaaaaaaaaaaaaaaaaaaaaaaaaaaaaaaaaaaaaaaaaaaaaaaaaaaaaaaaaaaaaaaaaaaaaaaaaaaaaaaaaaaaaaaaaaa
"}
