//MAP CONVERTED BY dmm2tgm.py THIS HEADER COMMENT PREVENTS RECONVERSION, DO NOT REMOVE
"a" = (
/turf/simulated/floor/plating,
/area/dababyruin)
"b" = (
/turf/simulated/wall,
/area/dababyruin)
"c" = (
/obj/effect/spawner/lootdrop/animals4maint,
/turf/simulated/floor/plating,
/area/dababyruin)
"d" = (
/obj/effect/spawner/lootdrop/maintenance,
/obj/structure/table,
/turf/simulated/floor/plating,
/area/dababyruin)
"e" = (
/obj/structure/table,
/turf/simulated/floor/plating,
/area/dababyruin)
"f" = (
/obj/effect/spawner/lootdrop/maintenance,
/obj/structure/table,
/turf/simulated/floor/plating/damaged,
/area/dababyruin)
"g" = (
/turf/simulated/floor/plating/damaged,
/area/dababyruin)
"h" = (
/turf/simulated/floor/plating/burnt,
/area/dababyruin)
"i" = (
/obj/effect/spawner/random_spawners/blood_often,
/turf/simulated/floor/plating/burnt,
/area/dababyruin)
"j" = (
/obj/effect/spawner/random_spawners/oil_maybe,
/turf/simulated/floor/plating,
/area/dababyruin)
"k" = (
/obj/effect/spawner/lootdrop/maintenance,
/turf/simulated/floor/plating,
/area/dababyruin)
"l" = (
/obj/effect/spawner/random_spawners/dirt_frequent,
/turf/simulated/floor/plating/damaged,
/area/dababyruin)
"m" = (
/obj/effect/spawner/random_spawners/dirt_frequent,
/turf/simulated/floor/plating/burnt,
/area/dababyruin)
"n" = (
/obj/effect/spawner/random_spawners/grille_often,
/turf/simulated/floor/plating/damaged,
/area/dababyruin)
"o" = (
/obj/effect/spawner/random_spawners/grille_often,
/turf/simulated/floor/plating,
/area/dababyruin)
"p" = (
/obj/effect/spawner/random_spawners/dirt_rare,
/turf/simulated/floor/plating,
/area/dababyruin)
"q" = (
/obj/effect/spawner/random_spawners/grille_maybe,
/turf/simulated/floor/plating/burnt,
/area/dababyruin)
"r" = (
/obj/effect/spawner/random_spawners/dirt_frequent,
/turf/simulated/floor/plating,
/area/dababyruin)
"s" = (
/obj/effect/spawner/random_spawners/oil_maybe,
/turf/simulated/floor/plating/burnt,
/area/dababyruin)
"t" = (
/obj/effect/spawner/random_spawners/dirt_rare,
/turf/simulated/floor/plating/burnt,
/area/dababyruin)
"u" = (
/obj/effect/spawner/lootdrop/maintenance,
/obj/structure/table,
/obj/effect/spawner/random_spawners/cobweb_right_rare,
/turf/simulated/floor/plating,
/area/dababyruin)
"v" = (
/obj/effect/spawner/random_spawners/cobweb_right_frequent,
/turf/simulated/floor/plating/damaged,
/area/dababyruin)
"w" = (
/obj/effect/spawner/random_spawners/oil_maybe,
/turf/simulated/floor/plating/damaged,
/area/dababyruin)
"x" = (
/obj/effect/spawner/random_spawners/dirt_frequent,
/obj/effect/spawner/random_spawners/cobweb_right_frequent,
/turf/simulated/floor/plating,
/area/dababyruin)
"y" = (
/obj/effect/spawner/random_spawners/cobweb_right_frequent,
/turf/simulated/floor/plating,
/area/dababyruin)
"z" = (
/obj/effect/spawner/lootdrop/maintenance,
/obj/structure/table,
/obj/effect/spawner/random_spawners/cobweb_left_frequent,
/turf/simulated/floor/plating,
/area/dababyruin)
"A" = (
/obj/effect/spawner/random_spawners/cobweb_right_rare,
/turf/simulated/floor/plating,
/area/dababyruin)
"B" = (
/obj/effect/spawner/random_spawners/grille_often,
/turf/simulated/floor/plating/burnt,
/area/dababyruin)
"C" = (
/obj/effect/spawner/random_spawners/blood_often,
/obj/effect/spawner/random_spawners/grille_maybe,
/turf/simulated/floor/plating/burnt,
/area/dababyruin)
"D" = (
/obj/effect/spawner/lootdrop/maintenance,
/turf/simulated/floor/plating/burnt,
/area/dababyruin)
"E" = (
/obj/effect/spawner/lootdrop/maintenance,
/turf/simulated/floor/plating/damaged,
/area/dababyruin)
"F" = (
/turf/template_noop,
/area/template_noop)

(1,1,1) = {"
a
b
b
b
b
b
b
h
h
t
k
p
F
t
F
"}
(2,1,1) = {"
j
a
j
a
c
F
F
a
j
a
a
a
j
j
r
"}
(3,1,1) = {"
a
F
F
s
h
j
p
a
a
b
h
b
F
k
r
"}
(4,1,1) = {"
b
b
b
b
b
b
b
b
b
b
B
b
b
b
b
"}
(5,1,1) = {"
F
F
F
t
D
s
h
b
b
z
a
F
r
F
b
"}
(6,1,1) = {"
a
c
a
a
a
a
j
w
b
b
r
F
k
p
F
"}
(7,1,1) = {"
F
a
p
a
e
f
a
l
E
b
a
c
a
a
a
"}
(8,1,1) = {"
b
b
q
q
b
b
v
l
g
b
b
o
o
b
d
"}
(9,1,1) = {"
l
n
g
g
g
b
b
a
c
r
b
h
h
b
b
"}
(10,1,1) = {"
m
o
r
r
a
j
b
x
r
a
b
b
h
F
F
"}
(11,1,1) = {"
m
o
k
a
a
a
b
b
y
i
h
C
i
m
F
"}
(12,1,1) = {"
h
b
b
u
a
a
j
b
b
o
o
b
b
h
m
"}
(13,1,1) = {"
h
g
b
b
u
k
a
s
b
A
a
k
b
a
r
"}
(14,1,1) = {"
m
l
b
b
b
l
l
g
b
b
r
r
b
c
F
"}
(15,1,1) = {"
a
F
F
F
F
F
F
F
F
b
F
F
b
F
F
"}
