"a" = (/turf/simulated/floor/plating,/area/dababyruin)
"b" = (/turf/simulated/wall,/area/dababyruin)
"c" = (/obj/effect/spawner/lootdrop/animals4maint,/turf/simulated/floor/plating,/area/dababyruin)
"d" = (/obj/effect/spawner/lootdrop/maintenance,/obj/structure/table,/turf/simulated/floor/plating,/area/dababyruin)
"e" = (/obj/structure/table,/turf/simulated/floor/plating,/area/dababyruin)
"f" = (/obj/effect/spawner/lootdrop/maintenance,/obj/structure/table,/turf/simulated/floor/plating/damaged,/area/dababyruin)
"g" = (/turf/simulated/floor/plating/damaged,/area/dababyruin)
"h" = (/turf/simulated/floor/plating/burnt,/area/dababyruin)
"i" = (/obj/effect/spawner/random_spawners/blood_often,/turf/simulated/floor/plating/burnt,/area/dababyruin)
"j" = (/obj/effect/spawner/random_spawners/oil_maybe,/turf/simulated/floor/plating,/area/dababyruin)
"k" = (/obj/effect/spawner/lootdrop/maintenance,/turf/simulated/floor/plating,/area/dababyruin)
"l" = (/obj/effect/spawner/random_spawners/dirt_frequent,/turf/simulated/floor/plating/damaged,/area/dababyruin)
"m" = (/obj/effect/spawner/random_spawners/dirt_frequent,/turf/simulated/floor/plating/burnt,/area/dababyruin)
"n" = (/obj/effect/spawner/random_spawners/grille_often,/turf/simulated/floor/plating/damaged,/area/dababyruin)
"o" = (/obj/effect/spawner/random_spawners/grille_often,/turf/simulated/floor/plating,/area/dababyruin)
"p" = (/obj/effect/spawner/random_spawners/dirt_rare,/turf/simulated/floor/plating,/area/dababyruin)
"q" = (/obj/effect/spawner/random_spawners/grille_maybe,/turf/simulated/floor/plating/burnt,/area/dababyruin)
"r" = (/obj/effect/spawner/random_spawners/dirt_frequent,/turf/simulated/floor/plating,/area/dababyruin)
"s" = (/obj/effect/spawner/random_spawners/oil_maybe,/turf/simulated/floor/plating/burnt,/area/dababyruin)
"t" = (/obj/effect/spawner/random_spawners/dirt_rare,/turf/simulated/floor/plating/burnt,/area/dababyruin)
"u" = (/obj/effect/spawner/lootdrop/maintenance,/obj/structure/table,/obj/effect/spawner/random_spawners/cobweb_right_rare,/turf/simulated/floor/plating,/area/dababyruin)
"v" = (/obj/effect/spawner/random_spawners/cobweb_right_frequent,/turf/simulated/floor/plating/damaged,/area/dababyruin)
"w" = (/obj/effect/spawner/random_spawners/oil_maybe,/turf/simulated/floor/plating/damaged,/area/dababyruin)
"x" = (/obj/effect/spawner/random_spawners/dirt_frequent,/obj/effect/spawner/random_spawners/cobweb_right_frequent,/turf/simulated/floor/plating,/area/dababyruin)
"y" = (/obj/effect/spawner/random_spawners/cobweb_right_frequent,/turf/simulated/floor/plating,/area/dababyruin)
"z" = (/obj/effect/spawner/lootdrop/maintenance,/obj/structure/table,/obj/effect/spawner/random_spawners/cobweb_left_frequent,/turf/simulated/floor/plating,/area/dababyruin)
"A" = (/obj/effect/spawner/random_spawners/cobweb_right_rare,/turf/simulated/floor/plating,/area/dababyruin)
"B" = (/obj/effect/spawner/random_spawners/grille_often,/turf/simulated/floor/plating/burnt,/area/dababyruin)
"C" = (/obj/effect/spawner/random_spawners/blood_often,/obj/effect/spawner/random_spawners/grille_maybe,/turf/simulated/floor/plating/burnt,/area/dababyruin)
"D" = (/obj/effect/spawner/lootdrop/maintenance,/turf/simulated/floor/plating/burnt,/area/dababyruin)
"E" = (/obj/effect/spawner/lootdrop/maintenance,/turf/simulated/floor/plating/damaged,/area/dababyruin)
"F" = (/turf/template_noop,/area/template_noop)

(1,1,1) = {"
ajabFaFblmmhhma
baFbFcabnoobglF
bjFbFapqgrkbbbF
basbtaaqgraubbF
bchbDaebgaaaubF
bFjbsafbbjaaklF
bFpbhjavbbbjalF
haabbwllaxbbsgF
hjabbbEgcrybbbF
tabbzbbbraioAbb
kahBarabbbhoarF
pabbFFcohbCbkrF
FjFbrkaohhibbbb
tjkbFpabbFmhacF
FrrbbFadbFFmrFF
"}
