//MAP CONVERTED BY dmm2tgm.py THIS HEADER COMMENT PREVENTS RECONVERSION, DO NOT REMOVE
"a" = (
/turf/simulated/wall/cult,
/area/lavaland/surface/outdoors/unexplored/danger)
"b" = (
/obj/structure/stone_tile/slab,
/turf/template_noop,
/area/lavaland/surface/outdoors/unexplored/danger)
"c" = (
/turf/template_noop,
/area/lavaland/surface/outdoors/unexplored/danger)
"w" = (
/obj/structure/stone_tile/center/cracked,
/obj/structure/stone_tile/surrounding/cracked,
/obj/structure/stone_tile/slab/cracked{
	dir = 10
	},
/turf/template_noop,
/area/lavaland/surface/outdoors/unexplored/danger)
"I" = (
/obj/structure/stone_tile,
/obj/structure/stone_tile{
	dir = 4
	},
/obj/structure/stone_tile{
	dir = 8
	},
/obj/structure/stone_tile/cracked{
	dir = 1
	},
/turf/template_noop,
/area/lavaland/surface/outdoors/unexplored/danger)
"M" = (
/obj/structure/stone_tile/slab/cracked{
	dir = 5
	},
/turf/template_noop,
/area/lavaland/surface/outdoors/unexplored/danger)
"R" = (
/obj/structure/stone_tile/block/cracked{
	dir = 8
	},
/obj/structure/stone_tile/block{
	dir = 4
	},
/turf/template_noop,
/area/lavaland/surface/outdoors/unexplored/danger)

(1,1,1) = {"
c
c
c
c
c
"}
(2,1,1) = {"
a
c
c
c
a
"}
(3,1,1) = {"
b
I
w
R
M
"}
(4,1,1) = {"
a
c
c
c
a
"}
(5,1,1) = {"
c
c
c
c
c
"}
