//MAP CONVERTED BY dmm2tgm.py THIS HEADER COMMENT PREVENTS RECONVERSION, DO NOT REMOVE
"a" = (
/turf/simulated/wall/cult,
/area/lavaland/surface/outdoors/unexplored/danger)
"b" = (
/obj/structure/stone_tile/surrounding,
/obj/structure/stone_tile/center,
/turf/template_noop,
/area/lavaland/surface/outdoors/unexplored/danger)
"c" = (
/turf/template_noop,
/area/lavaland/surface/outdoors/unexplored/danger)
"g" = (
/obj/structure/stone_tile/slab/cracked,
/turf/template_noop,
/area/lavaland/surface/outdoors/unexplored/danger)
"h" = (
/obj/structure/stone_tile/slab,
/turf/template_noop,
/area/lavaland/surface/outdoors/unexplored/danger)
"m" = (
/obj/structure/stone_tile/block,
/obj/structure/stone_tile/block/cracked{
	dir = 1
	},
/turf/template_noop,
/area/lavaland/surface/outdoors/unexplored/danger)
"o" = (
/obj/structure/stone_tile/block{
	dir = 1
	},
/obj/structure/stone_tile/burnt,
/obj/structure/stone_tile/surrounding_tile{
	dir = 8
	},
/turf/template_noop,
/area/lavaland/surface/outdoors/unexplored/danger)

(1,1,1) = {"
c
a
h
a
c
"}
(2,1,1) = {"
c
c
m
c
c
"}
(3,1,1) = {"
c
c
b
c
c
"}
(4,1,1) = {"
c
c
o
c
c
"}
(5,1,1) = {"
c
a
g
a
c
"}
