//MAP CONVERTED BY dmm2tgm.py THIS HEADER COMMENT PREVENTS RECONVERSION, DO NOT REMOVE
"a" = (
/turf/simulated/wall/clockwork,
/area/lavaland/surface/outdoors/unexplored/danger)
"b" = (
/turf/simulated/floor/clockwork/lavaland_air,
/area/lavaland/surface/outdoors/unexplored/danger)
"c" = (
/turf/template_noop,
/area/lavaland/surface/outdoors/unexplored/danger)

(1,1,1) = {"
c
c
c
c
c
"}
(2,1,1) = {"
a
c
c
c
a
"}
(3,1,1) = {"
b
b
b
b
b
"}
(4,1,1) = {"
a
c
c
c
a
"}
(5,1,1) = {"
c
c
c
c
c
"}
