//MAP CONVERTED BY dmm2tgm.py THIS HEADER COMMENT PREVENTS RECONVERSION, DO NOT REMOVE
"a" = (
/obj/structure/lattice/catwalk/mining,
/obj/structure/marker_beacon/dock_marker,
/turf/template_noop,
/area/lavaland/surface/outdoors/unexplored/danger)
"b" = (
/obj/structure/lattice/catwalk/mining,
/turf/template_noop,
/area/lavaland/surface/outdoors/unexplored/danger)
"c" = (
/turf/template_noop,
/area/lavaland/surface/outdoors/unexplored/danger)

(1,1,1) = {"
c
c
c
c
c
"}
(2,1,1) = {"
b
c
c
c
b
"}
(3,1,1) = {"
b
a
b
a
b
"}
(4,1,1) = {"
b
c
c
c
b
"}
(5,1,1) = {"
c
c
c
c
c
"}
