//MAP CONVERTED BY dmm2tgm.py THIS HEADER COMMENT PREVENTS RECONVERSION, DO NOT REMOVE
"a" = (
/turf/simulated/wall/mineral/wood/nonmetal,
/area/lavaland/surface/outdoors/unexplored/danger)
"b" = (
/turf/simulated/floor/wood/lavaland_air,
/area/lavaland/surface/outdoors/unexplored/danger)
"c" = (
/turf/template_noop,
/area/lavaland/surface/outdoors/unexplored/danger)
"v" = (
/obj/effect/landmark/damageturf,
/turf/simulated/floor/wood/lavaland_air,
/area/lavaland/surface/outdoors/unexplored/danger)

(1,1,1) = {"
c
a
v
a
c
"}
(2,1,1) = {"
c
c
b
c
c
"}
(3,1,1) = {"
c
c
b
c
c
"}
(4,1,1) = {"
c
c
v
c
c
"}
(5,1,1) = {"
c
a
b
a
c
"}
