//MAP CONVERTED BY dmm2tgm.py THIS HEADER COMMENT PREVENTS RECONVERSION, DO NOT REMOVE
"a" = (
/turf/simulated/floor/wood/lavaland_air,
/area/lavaland/surface/outdoors/unexplored/danger)
"b" = (
/obj/effect/landmark/damageturf,
/turf/simulated/floor/wood/lavaland_air,
/area/lavaland/surface/outdoors/unexplored/danger)
"c" = (
/turf/template_noop,
/area/lavaland/surface/outdoors/unexplored/danger)
"y" = (
/turf/simulated/wall/mineral/wood,
/area/lavaland/surface/outdoors/unexplored/danger)

(1,1,1) = {"
c
c
c
c
c
"}
(2,1,1) = {"
y
c
c
c
y
"}
(3,1,1) = {"
b
a
b
a
b
"}
(4,1,1) = {"
y
c
c
c
y
"}
(5,1,1) = {"
c
c
c
c
c
"}
