//MAP CONVERTED BY dmm2tgm.py THIS HEADER COMMENT PREVENTS RECONVERSION, DO NOT REMOVE
"a" = (
/turf/simulated/wall/mineral/wood/nonmetal,
/area/lavaland/surface/outdoors/unexplored/danger)
"b" = (
/turf/simulated/floor/wood/lavaland_air,
/area/lavaland/surface/outdoors/unexplored/danger)
"c" = (
/turf/template_noop,
/area/lavaland/surface/outdoors/unexplored/danger)
"v" = (
/turf/simulated/floor/wood/lavaland_air{
	icon_state = "wood-broken3"
	},
/area/lavaland/surface/outdoors/unexplored/danger)
"C" = (
/turf/simulated/floor/wood/lavaland_air{
	icon_state = "wood-broken7"
	},
/area/lavaland/surface/outdoors/unexplored/danger)

(1,1,1) = {"
c
a
C
a
c
"}
(2,1,1) = {"
c
c
b
c
c
"}
(3,1,1) = {"
c
c
b
c
c
"}
(4,1,1) = {"
c
c
v
c
c
"}
(5,1,1) = {"
c
a
b
a
c
"}
