//MAP CONVERTED BY dmm2tgm.py THIS HEADER COMMENT PREVENTS RECONVERSION, DO NOT REMOVE
"a" = (
/turf/template_noop,
/area/lavaland/surface/outdoors/unexplored/danger)
"A" = (
/obj/effect/mapping_helpers/no_lava,
/turf/simulated/floor/plating/asteroid/basalt/lava_land_surface,
/area/lavaland/surface/outdoors/unexplored/danger)
"E" = (
/turf/simulated/floor/plating/asteroid/basalt/lava_land_surface,
/area/lavaland/surface/outdoors/unexplored/danger)
"Q" = (
/obj/effect/mapping_helpers/no_lava,
/obj/effect/mapping_helpers/no_lava,
/turf/simulated/floor/plating/asteroid/basalt/lava_land_surface,
/area/lavaland/surface/outdoors/unexplored/danger)

(1,1,1) = {"
a
a
a
a
a
a
a
a
a
a
a
a
"}
(2,1,1) = {"
E
a
a
a
a
a
a
a
a
a
a
E
"}
(3,1,1) = {"
E
E
a
a
a
a
a
a
a
a
E
E
"}
(4,1,1) = {"
A
A
E
E
a
E
a
a
E
a
A
Q
"}
(5,1,1) = {"
A
Q
A
A
A
A
A
A
A
A
Q
Q
"}
(6,1,1) = {"
A
Q
A
A
A
A
A
A
A
A
Q
Q
"}
(7,1,1) = {"
A
Q
A
A
A
A
A
A
A
A
Q
Q
"}
(8,1,1) = {"
A
A
a
E
E
a
E
a
E
E
A
Q
"}
(9,1,1) = {"
E
E
a
a
a
a
a
a
a
a
E
E
"}
(10,1,1) = {"
E
a
a
a
a
a
a
a
a
a
a
E
"}
(11,1,1) = {"
a
a
a
a
a
a
a
a
a
a
a
a
"}
(12,1,1) = {"
a
a
a
a
a
a
a
a
a
a
a
a
"}
