//MAP CONVERTED BY dmm2tgm.py THIS HEADER COMMENT PREVENTS RECONVERSION, DO NOT REMOVE
"a" = (
/turf/template_noop,
/area/lavaland/surface/outdoors/unexplored/danger)
"h" = (
/obj/effect/mapping_helpers/no_lava,
/obj/structure/lightable/torch/lava_bridge,
/turf/simulated/floor/plating/asteroid/basalt/lava_land_surface,
/area/lavaland/surface/outdoors/unexplored/danger)
"A" = (
/obj/effect/mapping_helpers/no_lava,
/turf/simulated/floor/plating/asteroid/basalt/lava_land_surface,
/area/lavaland/surface/outdoors/unexplored/danger)
"Q" = (
/obj/effect/mapping_helpers/no_lava,
/obj/effect/mapping_helpers/no_lava,
/turf/simulated/floor/plating/asteroid/basalt/lava_land_surface,
/area/lavaland/surface/outdoors/unexplored/danger)

(1,1,1) = {"
a
a
a
a
a
a
a
a
a
a
a
a
a
a
"}
(2,1,1) = {"
a
a
A
a
a
a
a
a
a
a
a
A
a
a
"}
(3,1,1) = {"
Q
a
a
a
a
a
A
a
A
A
a
a
a
Q
"}
(4,1,1) = {"
Q
Q
A
A
A
h
A
A
A
h
Q
A
Q
Q
"}
(5,1,1) = {"
A
Q
A
Q
A
A
A
A
A
A
A
A
Q
Q
"}
(6,1,1) = {"
Q
Q
A
A
A
h
A
A
A
h
Q
A
Q
Q
"}
(7,1,1) = {"
Q
a
a
a
A
A
A
A
a
a
a
a
a
Q
"}
(8,1,1) = {"
a
A
a
A
a
a
a
a
a
a
A
a
a
a
"}
(9,1,1) = {"
a
a
a
a
a
a
a
a
A
a
a
a
a
a
"}
