"a" = (/turf/closed/mineral/volcanic/lava_land_surface,/area/ruin/unpowered)
"b" = (/turf/closed/wall/shuttle/smooth/nodiagonal,/area/ruin/unpowered)
"c" = (/turf/closed/wall/shuttle,/area/ruin/unpowered)
"d" = (/obj/structure/window/shuttle,/turf/open/floor/plating/asteroid/basalt/lava,/area/ruin/unpowered)
"e" = (/obj/structure/closet,/obj/item/clothing/mask/gas/mime,/obj/item/clothing/shoes/sneakers/mime,/obj/item/clothing/under/rank/mime,/obj/item/toy/crayon/spraycan/mimecan,/obj/item/toy/figure/mime,/obj/item/weapon/storage/backpack/mime,/turf/open/floor/mineral/silver,/area/ruin/unpowered)
"f" = (/obj/structure/closet/crate/internals,/obj/item/weapon/tank/internals/emergency_oxygen,/obj/item/weapon/tank/internals/emergency_oxygen,/turf/open/floor/mineral/silver,/area/ruin/unpowered)
"g" = (/obj/machinery/computer,/turf/open/floor/mineral/silver,/area/ruin/unpowered)
"h" = (/obj/structure/chair{dir = 8},/turf/open/floor/mineral/silver,/area/ruin/unpowered)
"i" = (/turf/open/floor/mineral/silver,/area/ruin/unpowered)
"j" = (/obj/structure/closet/crate,/obj/item/weapon/tank/internals/emergency_oxygen,/turf/open/floor/plating/asteroid/basalt/lava,/area/ruin/unpowered)
"k" = (/obj/structure/closet,/obj/item/clothing/mask/gas/mime,/obj/item/clothing/shoes/sneakers/mime,/obj/item/clothing/under/rank/mime,/obj/item/weapon/storage/backpack/mime,/turf/open/floor/plating/asteroid/basalt/lava,/area/ruin/unpowered)
"l" = (/obj/structure/closet/crate,/obj/item/weapon/storage/toolbox/syndicate,/turf/open/floor/plating/asteroid/basalt/lava,/area/ruin/unpowered)
"m" = (/obj/structure/table_frame,/turf/open/floor/plating/asteroid/basalt/lava,/area/ruin/unpowered)
"n" = (/obj/structure/table,/obj/item/weapon/pickaxe/drill/diamonddrill,/turf/open/floor/plating/asteroid/basalt/lava,/area/ruin/unpowered)
"o" = (/obj/machinery/door/airlock/silver,/turf/open/floor/mineral/silver,/area/ruin/unpowered)
"p" = (/obj/item/chair,/turf/open/floor/mineral/silver,/area/ruin/unpowered)
"q" = (/turf/open/floor/plating/asteroid/basalt/lava,/area/ruin/unpowered)
"r" = (/obj/machinery/door/airlock/glass_external,/obj/structure/fans/tiny/invisible,/turf/open/floor/mineral/silver,/area/ruin/unpowered)
"s" = (/obj/item/weapon/storage/bag/ore,/turf/open/floor/plating/asteroid/basalt/lava,/area/ruin/unpowered)
"t" = (/obj/structure/table,/obj/item/weapon/reagent_containers/food/snacks/customizable/sandwich{pixel_y = 6},/obj/item/weapon/reagent_containers/food/snacks/customizable/sandwich{pixel_y = 6},/obj/item/weapon/reagent_containers/food/snacks/cheesewedge,/turf/open/floor/plating/asteroid/basalt/lava,/area/ruin/unpowered)
"u" = (/obj/structure/girder,/turf/open/floor/plating/asteroid/basalt/lava,/area/ruin/unpowered)
"v" = (/obj/structure/closet/crate,/turf/open/floor/plating/asteroid/basalt/lava,/area/ruin/unpowered)
"w" = (/obj/effect/decal/cleanable/blood/splatter,/turf/open/floor/plating/asteroid/basalt/lava,/area/ruin/unpowered)
"x" = (/obj/structure/table,/obj/item/weapon/storage/bag/ore,/obj/item/device/mining_scanner,/obj/item/clothing/glasses/meson,/turf/open/floor/plating/asteroid/basalt/lava,/area/ruin/unpowered)
"y" = (/obj/effect/spawner/structure/window,/turf/open/floor/plating/asteroid/basalt/lava,/area/ruin/unpowered)
"z" = (/obj/item/weapon/shard,/obj/effect/decal/cleanable/blood/tracks,/turf/open/floor/plating/asteroid/basalt/lava,/area/ruin/unpowered)
"A" = (/obj/item/weapon/shard,/turf/open/floor/plating/asteroid/basalt/lava,/area/ruin/unpowered)
"B" = (/obj/structure/table,/obj/item/weapon/pickaxe,/obj/item/weapon/tank/internals/emergency_oxygen,/turf/open/floor/plating/asteroid/basalt/lava,/area/ruin/unpowered)
"C" = (/obj/effect/mob_spawn/human/corpse/damaged,/obj/effect/decal/cleanable/blood/splatter,/turf/open/floor/plating/asteroid/basalt/lava,/area/ruin/unpowered)
"D" = (/turf/open/chasm,/area/ruin/unpowered)
"E" = (/obj/effect/decal/cleanable/blood/tracks,/turf/open/floor/plating/asteroid/basalt/lava,/area/ruin/unpowered)
"F" = (/turf/closed/wall/r_wall,/area/ruin/unpowered)
"G" = (/obj/item/weapon/shard,/obj/effect/decal/cleanable/blood/splatter,/obj/effect/mob_spawn/human/corpse/damaged,/turf/open/floor/plating/asteroid/basalt/lava,/area/ruin/unpowered)
"H" = (/obj/item/weapon/pickaxe,/obj/effect/decal/cleanable/blood/splatter,/turf/open/floor/plating/asteroid/basalt/lava,/area/ruin/unpowered)
"I" = (/obj/item/weapon/pickaxe,/turf/open/floor/plating/asteroid/basalt/lava,/area/ruin/unpowered)

(1,1,1) = {"
aaaaaaaaaaaaaaa
abcccccdbaaaaaa
acefcghidjklmna
aciioiipdqqqqqa
abrccccdbsqqqta
uvqqqqqqqwqqqxa
qqqqqyyyyzAqqBa
qqqqCyDDDEqqqqa
uuqqEyDFDEqAqaa
aaqqEyDDDGqqqaa
aauqEyyyyyqquaa
aaaqEqqqqqqaaaa
aaqqHqaauqqIwaa
aauuaqaaaaaaaaa
aaaaaaaaaaaaaaa
"}
