"a" = (/turf/template_noop,/area/template_noop)
"b" = (/turf/closed/wall/shuttle/smooth/nodiagonal{baseturf = /turf/open/floor/plating/lava/smooth},/area/ruin/powered/golem_ship)
"c" = (/turf/template_noop,/area/template_noop/mapgen_protected)
"d" = (/obj/structure/closet/crate,/obj/item/weapon/pickaxe,/obj/item/weapon/pickaxe,/obj/item/weapon/pickaxe,/obj/item/weapon/storage/bag/ore,/obj/item/weapon/storage/bag/ore,/obj/item/device/mining_scanner,/obj/item/device/flashlight/lantern,/obj/item/weapon/card/id/mining,/turf/open/floor/plating{baseturf = /turf/open/floor/plating/lava/smooth},/area/ruin/powered/golem_ship)
"e" = (/obj/structure/closet/crate,/obj/item/weapon/pickaxe,/obj/item/weapon/pickaxe,/obj/item/weapon/storage/bag/ore,/obj/item/weapon/storage/bag/ore,/obj/item/device/mining_scanner,/obj/item/device/flashlight/lantern,/obj/item/weapon/card/id/mining,/turf/open/floor/plating{baseturf = /turf/open/floor/plating/lava/smooth},/area/ruin/powered/golem_ship)
"f" = (/obj/item/weapon/storage/toolbox/mechanical,/turf/open/floor/plating{baseturf = /turf/open/floor/plating/lava/smooth},/area/ruin/powered/golem_ship)
"g" = (/turf/open/floor/plating{baseturf = /turf/open/floor/plating/lava/smooth},/area/ruin/powered/golem_ship)
"h" = (/obj/structure/reagent_dispensers/watertank,/turf/open/floor/plating{baseturf = /turf/open/floor/plating/lava/smooth},/area/ruin/powered/golem_ship)
"i" = (/obj/structure/shuttle/engine/heater{icon_state = "heater"; dir = 4},/obj/structure/window/reinforced{dir = 8},/turf/open/floor/plating{baseturf = /turf/open/floor/plating/lava/smooth; initial_gas_mix = "o2=14;n2=23;TEMP=300"},/area/ruin/powered/golem_ship)
"j" = (/obj/structure/shuttle/engine/propulsion{icon_state = "propulsion"; dir = 8},/turf/open/floor/plating{baseturf = /turf/open/floor/plating/lava/smooth; initial_gas_mix = "o2=14;n2=23;TEMP=300"},/area/ruin/powered/golem_ship)
"k" = (/obj/machinery/door/airlock/shuttle,/obj/structure/fans/tiny/invisible,/turf/open/floor/plasteel/shuttle/purple{baseturf = /turf/open/floor/plating/lava/smooth},/area/ruin/powered/golem_ship)
"l" = (/obj/machinery/computer/arcade/battle,/turf/open/floor/plasteel/shuttle/purple{baseturf = /turf/open/floor/plating/lava/smooth},/area/ruin/powered/golem_ship)
"m" = (/turf/open/floor/plasteel/shuttle/purple{baseturf = /turf/open/floor/plating/lava/smooth},/area/ruin/powered/golem_ship)
"n" = (/obj/effect/mob_spawn/human/golem/adamantine,/turf/open/floor/plasteel/shuttle/purple{baseturf = /turf/open/floor/plating/lava/smooth},/area/ruin/powered/golem_ship)
"o" = (/obj/machinery/mineral/equipment_vendor/golem,/turf/open/floor/plasteel/shuttle/purple{baseturf = /turf/open/floor/plating/lava/smooth},/area/ruin/powered/golem_ship)
"p" = (/obj/item/weapon/resonator,/turf/open/floor/plasteel/shuttle/purple{baseturf = /turf/open/floor/plating/lava/smooth},/area/ruin/powered/golem_ship)
"q" = (/obj/machinery/mineral/ore_redemption,/turf/open/floor/plasteel/shuttle/purple{baseturf = /turf/open/floor/plating/lava/smooth},/area/ruin/powered/golem_ship)
"r" = (/obj/structure/statue/gold/rd,/obj/structure/window/reinforced{dir = 4; name = "shrine of the liberator"; pixel_x = 0},/turf/open/floor/plasteel/shuttle/purple{baseturf = /turf/open/floor/plating/lava/smooth},/area/ruin/powered/golem_ship)
"s" = (/obj/machinery/computer/shuttle,/turf/open/floor/plasteel/shuttle/purple{baseturf = /turf/open/floor/plating/lava/smooth},/area/ruin/powered/golem_ship)
"t" = (/obj/machinery/bluespace_beacon,/turf/open/floor/plasteel/shuttle/purple{baseturf = /turf/open/floor/plating/lava/smooth},/area/ruin/powered/golem_ship)
"u" = (/obj/structure/extinguisher_cabinet{pixel_y = 30},/turf/open/floor/plasteel/shuttle/purple{baseturf = /turf/open/floor/plating/lava/smooth},/area/ruin/powered/golem_ship)
"v" = (/obj/structure/table/wood,/obj/item/weapon/bedsheet/rd{desc = "Majestic."; layer = 3; name = "Royal Cape of the Liberator"; pixel_x = 5; pixel_y = 9},/obj/item/weapon/book/manual/research_and_development{name = "Sacred Text of the Liberator"; pixel_x = -4; pixel_y = 3},/obj/structure/window/reinforced{dir = 4; name = "shrine of the liberator"; pixel_x = 0},/turf/open/floor/plasteel/shuttle/purple{baseturf = /turf/open/floor/plating/lava/smooth},/area/ruin/powered/golem_ship)
"w" = (/obj/item/weapon/resonator/upgraded,/turf/open/floor/plasteel/shuttle/purple{baseturf = /turf/open/floor/plating/lava/smooth},/area/ruin/powered/golem_ship)
"x" = (/obj/machinery/autolathe,/turf/open/floor/plasteel/shuttle/purple{baseturf = /turf/open/floor/plating/lava/smooth},/area/ruin/powered/golem_ship)
"y" = (/obj/machinery/door/airlock/shuttle,/turf/open/floor/plasteel/shuttle/purple{baseturf = /turf/open/floor/plating/lava/smooth},/area/ruin/powered/golem_ship)
"z" = (/obj/structure/table/wood,/obj/machinery/reagentgrinder,/turf/open/floor/plasteel/shuttle/purple{baseturf = /turf/open/floor/plating/lava/smooth},/area/ruin/powered/golem_ship)
"A" = (/obj/machinery/computer/arcade/orion_trail,/turf/open/floor/plasteel/shuttle/purple{baseturf = /turf/open/floor/plating/lava/smooth},/area/ruin/powered/golem_ship)
"B" = (/obj/structure/extinguisher_cabinet{pixel_y = -30},/turf/open/floor/plasteel/shuttle/purple{baseturf = /turf/open/floor/plating/lava/smooth},/area/ruin/powered/golem_ship)
"C" = (/obj/structure/table/wood,/obj/item/weapon/surgical_drapes{pixel_x = 15},/obj/item/weapon/storage/firstaid/fire,/obj/item/weapon/storage/firstaid/fire,/turf/open/floor/plasteel/shuttle/purple{baseturf = /turf/open/floor/plating/lava/smooth},/area/ruin/powered/golem_ship)
"D" = (/obj/item/weapon/storage/firstaid/fire,/obj/structure/table/wood,/obj/item/weapon/storage/firstaid/fire,/turf/open/floor/plasteel/shuttle/purple{baseturf = /turf/open/floor/plating/lava/smooth},/area/ruin/powered/golem_ship)
"E" = (/obj/item/weapon/storage/firstaid/brute,/obj/structure/table/wood,/obj/item/weapon/storage/firstaid/brute,/obj/item/areaeditor/blueprints{desc = "Use to build new structures in the wastes."; name = "land claim"},/turf/open/floor/plasteel/shuttle/purple{baseturf = /turf/open/floor/plating/lava/smooth},/area/ruin/powered/golem_ship)
"F" = (/obj/item/weapon/storage/firstaid/brute,/obj/structure/table/wood,/obj/item/weapon/storage/firstaid/brute,/obj/item/weapon/disk/design_disk/golem_shell,/turf/open/floor/plasteel/shuttle/purple{baseturf = /turf/open/floor/plating/lava/smooth},/area/ruin/powered/golem_ship)
"G" = (/obj/structure/reagent_dispensers/fueltank,/turf/open/floor/plating{baseturf = /turf/open/floor/plating/lava/smooth},/area/ruin/powered/golem_ship)
"H" = (/obj/structure/ore_box,/turf/open/floor/plating{baseturf = /turf/open/floor/plating/lava/smooth},/area/ruin/powered/golem_ship)

(1,1,1) = {"
aaaaaaaaaaaaaaaaaaaaaa
aaaaaaaaaaaaaaaaaaaaaa
aaaaabbbbbbbbbbbbbbbca
aaaaabddddddeeefghijcc
aaaaabggggggggggghijcc
aabbbbkkbbbbkkbbbbbbcc
aablmmmmnnbmmmmmmoijcc
aabmmmmmppkmmmmmmmijcc
bbbkkbbbbbbmmmmmqbbbcc
brsmmmmmmmkmtmmmmkukcc
bvmmmmmmmmkmmmmmmkmkcc
bbbkkbbbbbbmmmmwxbbbcc
aabmmmmmppymmmmmmzijcc
aabAmmmmnnbBmmCDEFijcc
aabbbbkkbbbbkkbbbbbbcc
aaaaabgggggggggggGijcc
aaaaabHHHHHHHfgggGijcc
aaaaabbbbbbbbbbbbbbbca
aaaaaaaaaaaaaaaaaaaaaa
aaaaaaaaaaaaaaaaaaaaaa
"}
