//MAP CONVERTED BY dmm2tgm.py THIS HEADER COMMENT PREVENTS RECONVERSION, DO NOT REMOVE
"a" = (
/turf/simulated/floor/plating/asteroid/basalt/lava_land_surface_hard,
/area/template_noop)
"b" = (
/turf/simulated/mineral/ancient/lava_land_surface_hard,
/area/template_noop)
"d" = (
/turf/simulated/mineral/volcanic/lava_land_surface,
/area/template_noop)
"j" = (
/obj/effect/baseturf_helper/lava_land/surface,
/turf/simulated/floor/plating/asteroid/basalt/lava_land_surface_hard,
/area/template_noop)
"q" = (
/turf/template_noop,
/area/template_noop)

(1,1,1) = {"
q
q
q
b
b
b
b
b
b
q
q
q
q
q
q
q
q
q
q
q
q
q
q
q
q
q
q
q
q
q
q
q
q
"}
(2,1,1) = {"
q
b
b
b
b
b
b
b
b
b
b
q
q
q
q
q
q
q
q
q
q
q
q
q
q
q
q
q
q
q
q
q
q
"}
(3,1,1) = {"
q
b
b
a
a
a
a
b
b
b
b
q
q
q
q
q
q
q
q
q
q
q
q
q
q
q
q
q
q
q
q
q
q
"}
(4,1,1) = {"
b
b
b
a
a
a
a
a
a
b
b
b
b
q
q
q
q
q
q
q
q
b
b
b
b
b
b
b
b
q
q
q
q
"}
(5,1,1) = {"
b
b
a
a
a
a
a
a
a
a
b
b
b
q
q
q
q
q
q
q
q
b
b
b
b
b
b
b
b
b
q
q
q
"}
(6,1,1) = {"
b
b
a
a
a
a
a
a
a
a
a
b
b
b
q
q
q
q
q
d
d
d
b
a
a
a
a
a
b
b
b
q
q
"}
(7,1,1) = {"
b
b
a
a
a
a
a
a
a
a
a
a
b
b
b
b
b
q
d
d
d
a
a
a
a
a
a
a
a
b
b
q
q
"}
(8,1,1) = {"
b
b
a
a
a
a
a
a
a
a
a
a
a
a
b
b
b
b
b
d
a
a
a
a
a
a
a
a
a
b
b
b
q
"}
(9,1,1) = {"
b
b
a
a
a
a
a
a
a
a
a
a
a
a
a
b
b
b
b
a
a
a
a
a
a
a
a
a
a
a
b
b
q
"}
(10,1,1) = {"
b
b
a
a
a
a
a
a
a
a
a
a
a
a
a
a
a
a
a
a
a
a
a
a
a
a
a
a
a
a
a
b
q
"}
(11,1,1) = {"
q
b
d
a
a
a
a
a
a
a
a
a
a
a
a
a
a
a
a
a
a
a
a
a
a
a
a
a
a
a
a
b
b
"}
(12,1,1) = {"
q
d
d
a
a
a
a
a
a
a
a
a
a
a
a
a
a
a
a
a
a
a
a
a
a
a
a
a
a
a
a
b
b
"}
(13,1,1) = {"
q
d
d
d
b
a
a
a
a
a
a
a
a
a
a
a
a
a
a
a
a
a
a
a
a
a
a
a
a
a
a
b
b
"}
(14,1,1) = {"
q
q
d
b
b
a
a
a
a
a
a
a
a
a
a
a
a
a
a
a
a
a
a
a
a
a
a
a
a
a
a
b
b
"}
(15,1,1) = {"
q
q
q
b
b
b
a
a
a
a
a
b
b
a
a
a
a
a
a
a
a
a
a
a
a
a
a
a
a
a
a
b
b
"}
(16,1,1) = {"
q
q
q
b
b
b
b
b
b
a
b
b
b
a
a
a
a
a
a
a
a
b
b
b
a
a
a
a
a
a
a
b
b
"}
(17,1,1) = {"
q
q
q
q
q
b
b
b
b
b
b
b
a
a
a
a
j
a
a
a
b
b
b
b
b
a
a
a
a
a
b
b
b
"}
(18,1,1) = {"
q
q
q
q
q
b
b
b
b
b
a
a
a
a
a
a
a
a
b
b
b
b
b
b
b
a
a
a
a
a
b
b
q
"}
(19,1,1) = {"
q
q
q
b
b
b
b
a
a
b
a
a
a
a
a
a
a
b
b
b
q
q
q
b
b
b
a
a
a
a
b
b
q
"}
(20,1,1) = {"
q
q
q
b
b
a
a
a
a
a
a
a
a
a
a
a
a
b
b
q
q
q
q
b
b
b
a
a
a
a
d
b
q
"}
(21,1,1) = {"
q
q
b
b
b
a
a
a
a
a
a
a
a
a
a
a
a
d
q
q
q
q
b
b
b
a
a
a
a
a
d
d
q
"}
(22,1,1) = {"
q
q
b
b
a
a
a
a
a
a
a
a
a
a
a
a
d
d
q
q
q
b
b
b
b
a
a
a
a
a
d
d
q
"}
(23,1,1) = {"
q
q
b
b
a
a
a
a
a
a
a
a
a
a
a
a
d
d
q
q
d
b
b
b
a
a
a
a
a
a
b
d
q
"}
(24,1,1) = {"
q
q
b
b
a
a
a
a
a
a
a
a
a
a
a
b
b
q
q
d
d
d
a
a
a
a
a
a
a
a
b
b
q
"}
(25,1,1) = {"
q
q
b
b
a
a
a
a
a
a
a
a
a
a
a
b
b
q
q
d
d
a
a
a
a
a
a
a
a
a
b
b
q
"}
(26,1,1) = {"
q
q
b
b
a
a
a
a
a
a
a
a
a
a
a
b
b
b
q
b
b
a
a
a
a
a
a
a
a
b
b
q
q
"}
(27,1,1) = {"
q
q
b
b
a
a
a
a
a
a
b
b
a
a
a
a
b
b
b
b
b
a
a
a
a
a
a
a
a
b
b
q
q
"}
(28,1,1) = {"
q
q
b
b
a
a
a
a
a
b
b
b
b
a
a
a
a
b
b
b
b
a
a
a
a
a
a
a
b
b
b
q
q
"}
(29,1,1) = {"
q
q
q
b
a
a
a
a
d
b
b
b
b
a
a
a
a
a
b
b
b
a
a
a
a
a
a
a
b
b
q
q
q
"}
(30,1,1) = {"
q
q
q
b
b
a
a
d
d
d
q
b
b
a
a
a
a
a
b
b
b
b
b
b
a
a
b
b
b
q
q
q
q
"}
(31,1,1) = {"
q
q
q
b
b
b
b
d
d
q
q
b
b
b
a
a
a
b
b
q
q
b
b
b
b
b
b
b
q
q
q
q
q
"}
(32,1,1) = {"
q
q
q
q
b
b
b
b
q
q
q
q
b
b
b
b
b
b
b
q
q
q
q
b
b
b
b
q
q
q
q
q
q
"}
(33,1,1) = {"
q
q
q
q
q
q
q
q
q
q
q
q
q
q
b
b
b
b
q
q
q
q
q
q
q
q
q
q
q
q
q
q
q
"}
