//MAP CONVERTED BY dmm2tgm.py THIS HEADER COMMENT PREVENTS RECONVERSION, DO NOT REMOVE
"a" = (
/turf/simulated/mineral/ancient/lava_land_surface_hard,
/area/ruin/unpowered/cave1)
"b" = (
/turf/simulated/floor/plating/asteroid/basalt/lava_land_surface_hard,
/area/ruin/unpowered/cave1)
"d" = (
/turf/simulated/floor/plating/asteroid/basalt/lava_land_surface,
/area/ruin/unpowered/cave1)
"q" = (
/turf/template_noop,
/area/template_noop)
"K" = (
/obj/effect/baseturf_helper/lava_land/surface,
/turf/simulated/floor/plating/asteroid/basalt/lava_land_surface_hard,
/area/ruin/unpowered/cave1)
"L" = (
/turf/simulated/mineral/volcanic/lava_land_surface,
/area/ruin/unpowered/cave1)

(1,1,1) = {"
q
q
q
q
q
q
a
a
a
a
a
a
q
q
q
q
"}
(2,1,1) = {"
q
q
q
q
a
a
a
a
a
a
a
a
a
a
q
q
"}
(3,1,1) = {"
q
q
L
a
a
a
b
b
b
b
b
a
a
a
a
q
"}
(4,1,1) = {"
q
q
L
L
b
b
b
b
b
b
b
b
b
a
a
a
"}
(5,1,1) = {"
q
L
L
b
b
b
b
b
b
b
b
b
b
b
a
a
"}
(6,1,1) = {"
q
L
a
b
b
b
b
b
b
b
b
b
b
b
b
a
"}
(7,1,1) = {"
a
a
a
b
b
b
b
b
b
b
b
b
b
b
b
d
"}
(8,1,1) = {"
a
a
b
b
b
b
b
b
b
b
b
b
b
b
d
d
"}
(9,1,1) = {"
a
a
b
b
b
b
b
b
K
b
b
b
b
b
d
d
"}
(10,1,1) = {"
a
a
b
b
b
b
b
b
b
b
b
b
b
b
d
d
"}
(11,1,1) = {"
a
a
b
b
b
b
b
b
b
b
b
b
b
b
d
d
"}
(12,1,1) = {"
a
a
a
b
b
b
b
b
b
b
b
b
b
b
a
d
"}
(13,1,1) = {"
q
a
a
b
b
b
b
b
b
b
b
b
b
b
a
a
"}
(14,1,1) = {"
q
q
a
a
a
b
b
b
b
b
b
b
b
a
a
a
"}
(15,1,1) = {"
q
q
a
a
a
L
L
b
b
b
a
a
a
a
a
q
"}
(16,1,1) = {"
q
q
q
q
L
L
a
a
a
a
a
a
a
a
q
q
"}
(17,1,1) = {"
q
q
q
q
q
q
q
a
a
a
a
q
q
q
q
q
"}
