//MAP CONVERTED BY dmm2tgm.py THIS HEADER COMMENT PREVENTS RECONVERSION, DO NOT REMOVE
"a" = (
/turf/template_noop,
/area/template_noop)
"b" = (
/turf/simulated/floor/plating/asteroid/basalt/lava_land_surface,
/area/lavaland/surface/outdoors)
"c" = (
/obj/structure/sign/mining/survival{
	pixel_y = -32
	},
/turf/simulated/floor/plating/asteroid/basalt/lava_land_surface,
/area/lavaland/surface/outdoors)
"d" = (
/turf/simulated/wall/mineral/titanium/survival/pod,
/area/ruin/powered)
"e" = (
/obj/structure/sign/mining/survival{
	dir = 4;
	pixel_x = 32
	},
/turf/simulated/floor/plating/asteroid/basalt/lava_land_surface,
/area/lavaland/surface/outdoors)
"f" = (
/obj/structure/fans,
/turf/simulated/floor/pod/dark,
/area/ruin/powered)
"g" = (
/obj/machinery/smartfridge/survival_pod/empty,
/turf/simulated/floor/pod/dark,
/area/ruin/powered)
"h" = (
/obj/item/gps/computer,
/obj/structure/tubes,
/turf/simulated/floor/pod/dark,
/area/ruin/powered)
"i" = (
/obj/structure/sign/mining/survival{
	dir = 8;
	pixel_x = -32
	},
/turf/simulated/floor/plating/asteroid/basalt/lava_land_surface,
/area/lavaland/surface/outdoors)
"k" = (
/obj/machinery/sleeper/survival_pod,
/turf/simulated/floor/pod/dark,
/area/ruin/powered)
"l" = (
/obj/item/pickaxe,
/obj/effect/decal/cleanable/blood,
/turf/simulated/floor/pod/dark,
/area/ruin/powered)
"m" = (
/obj/structure/bed/pod,
/obj/item/bedsheet/black,
/obj/structure/tubes,
/obj/machinery/light/small{
	dir = 4
	},
/turf/simulated/floor/pod/dark,
/area/ruin/powered)
"n" = (
/obj/effect/decal/cleanable/blood,
/turf/simulated/floor/plating/asteroid/basalt/lava_land_surface,
/area/lavaland/surface/outdoors)
"o" = (
/obj/effect/decal/cleanable/blood,
/obj/effect/mob_spawn/corpse/goliath,
/turf/simulated/floor/plating/asteroid/basalt/lava_land_surface,
/area/lavaland/surface/outdoors)
"p" = (
/obj/structure/table/survival_pod,
/obj/item/kitchen/knife/combat/survival,
/turf/simulated/floor/pod/dark,
/area/ruin/powered)
"q" = (
/obj/effect/mob_spawn/human/corpse/miner/explorer{
	brute_damage = 150;
	oxy_damage = 50
	},
/obj/effect/decal/cleanable/blood,
/obj/effect/decal/cleanable/blood/drip,
/obj/effect/decal/cleanable/blood/tracks/mapped,
/turf/simulated/floor/pod/dark,
/area/ruin/powered)
"r" = (
/obj/structure/tubes,
/obj/item/crowbar,
/obj/effect/decal/cleanable/blood/drip,
/obj/effect/baseturf_helper/lava/mapping_lava,
/turf/simulated/floor/pod/dark,
/area/ruin/powered)
"s" = (
/obj/effect/decal/cleanable/blood/tracks/mapped,
/turf/simulated/floor/plating/asteroid/basalt/lava_land_surface,
/area/lavaland/surface/outdoors)
"t" = (
/obj/machinery/door/airlock/survival_pod/glass,
/obj/effect/decal/cleanable/blood/tracks/mapped,
/obj/structure/fans/tiny,
/turf/simulated/floor/pod/dark,
/area/ruin/powered)
"v" = (
/obj/effect/decal/cleanable/blood/drip,
/obj/effect/decal/cleanable/blood,
/turf/simulated/floor/plating/asteroid/basalt/lava_land_surface,
/area/lavaland/surface/outdoors)
"w" = (
/obj/structure/sign/mining/survival{
	pixel_y = 32
	},
/turf/simulated/floor/plating/asteroid/basalt/lava_land_surface,
/area/lavaland/surface/outdoors)
"x" = (
/obj/structure/sign/mining{
	pixel_y = 32
	},
/turf/simulated/floor/plating/asteroid/basalt/lava_land_surface,
/area/lavaland/surface/outdoors)
"y" = (
/obj/effect/decal/cleanable/blood/tracks/mapped{
	dir = 4
	},
/turf/simulated/floor/plating/asteroid/basalt/lava_land_surface,
/area/lavaland/surface/outdoors)
"L" = (
/obj/effect/decal/cleanable/blood/drip,
/turf/simulated/floor/plating/asteroid/basalt/lava_land_surface,
/area/lavaland/surface/outdoors)

(1,1,1) = {"
a
a
a
b
b
b
b
b
a
a
a
"}
(2,1,1) = {"
a
a
b
b
e
b
e
b
b
a
a
"}
(3,1,1) = {"
a
a
b
d
d
d
d
d
b
a
a
"}
(4,1,1) = {"
a
b
c
d
f
k
p
d
w
b
b
"}
(5,1,1) = {"
a
b
b
d
g
l
q
t
v
b
b
"}
(6,1,1) = {"
b
b
c
d
h
m
r
d
x
b
b
"}
(7,1,1) = {"
a
b
b
d
d
d
d
d
y
L
L
"}
(8,1,1) = {"
a
a
b
b
i
b
i
L
L
b
b
"}
(9,1,1) = {"
a
a
b
b
L
n
s
b
a
a
a
"}
(10,1,1) = {"
a
a
a
a
a
o
L
b
a
a
a
"}
