//MAP CONVERTED BY dmm2tgm.py THIS HEADER COMMENT PREVENTS RECONVERSION, DO NOT REMOVE
"aa" = (
/turf/template_noop,
/area/template_noop)
"ab" = (
/turf/simulated/wall/mineral/titanium/nodiagonal,
/area/shuttle/freegolem)
"ac" = (
/obj/structure/fans/tiny,
/obj/machinery/door/airlock/titanium,
/turf/simulated/floor/plating,
/area/shuttle/freegolem)
"ad" = (
/obj/structure/closet/crate/golemgear,
/turf/simulated/floor/plating,
/area/shuttle/freegolem)
"af" = (
/turf/simulated/floor/plating,
/area/shuttle/freegolem)
"ag" = (
/obj/structure/chair/comfy/purp{
	dir = 8;
	icon_state = "comfychair"
	},
/obj/item/bedsheet/rd/royal_cape{
	layer = 3;
	pixel_x = 5;
	pixel_y = 9
	},
/turf/simulated/floor/mineral/titanium/purple,
/area/shuttle/freegolem)
"ah" = (
/obj/structure/shuttle/engine/heater{
	icon_state = "heater";
	dir = 4
	},
/obj/structure/window/reinforced{
	dir = 8
	},
/turf/simulated/floor/plating,
/area/shuttle/freegolem)
"ai" = (
/obj/structure/shuttle/engine/propulsion{
	dir = 4;
	icon_state = "burst_l"
	},
/turf/simulated/floor/plating,
/area/shuttle/freegolem)
"aj" = (
/obj/item/storage/toolbox/mechanical,
/obj/item/reagent_containers/spray/cleaner,
/obj/structure/table,
/turf/simulated/floor/mineral/titanium/purple,
/area/shuttle/freegolem)
"al" = (
/obj/machinery/door/airlock/titanium,
/turf/simulated/floor/mineral/titanium/purple,
/area/shuttle/freegolem)
"am" = (
/obj/machinery/vending/hydronutrients,
/turf/simulated/floor/mineral/titanium/purple,
/area/shuttle/freegolem)
"an" = (
/obj/machinery/vending/hydroseeds,
/turf/simulated/floor/mineral/titanium/purple,
/area/shuttle/freegolem)
"ao" = (
/obj/machinery/light{
	dir = 1;
	on = 1
	},
/turf/simulated/floor/mineral/titanium/purple,
/area/shuttle/freegolem)
"ap" = (
/turf/simulated/floor/mineral/titanium/purple,
/area/shuttle/freegolem)
"aq" = (
/obj/machinery/mineral/equipment_vendor/golem,
/turf/simulated/floor/plating,
/area/shuttle/freegolem)
"ar" = (
/obj/machinery/door/airlock/titanium,
/obj/structure/fans/tiny,
/turf/simulated/floor/mineral/titanium/purple,
/area/shuttle/freegolem)
"as" = (
/obj/structure/window/reinforced{
	dir = 4;
	pixel_x = 0
	},
/obj/structure/window/reinforced,
/obj/machinery/constructable_frame/machine_frame,
/turf/simulated/floor/mineral/titanium/purple,
/area/shuttle/freegolem)
"au" = (
/obj/machinery/mineral/ore_redemption/golem,
/turf/simulated/floor/mineral/titanium/purple,
/area/shuttle/freegolem)
"av" = (
/obj/effect/spawner/window/shuttle,
/turf/simulated/floor/plating,
/area/shuttle/freegolem)
"ax" = (
/obj/structure/computerframe,
/turf/simulated/floor/mineral/titanium/purple,
/area/shuttle/freegolem)
"ay" = (
/obj/structure/table/wood,
/obj/item/resonator,
/turf/simulated/floor/mineral/titanium/purple,
/area/shuttle/freegolem)
"az" = (
/obj/structure/table/wood,
/obj/item/storage/firstaid/fire,
/obj/item/storage/firstaid/fire,
/obj/item/storage/firstaid/fire,
/turf/simulated/floor/mineral/titanium/purple,
/area/shuttle/freegolem)
"aA" = (
/turf/simulated/floor/plating/asteroid/basalt/lava_land_surface,
/area/ruin/powered/golem_ship)
"aB" = (
/obj/machinery/door/airlock/titanium,
/obj/structure/fans/tiny,
/obj/docking_port/stationary{
	area_type = /area/ruin/powered/golem_ship;
	dir = 8;
	dwidth = 8;
	height = 20;
	id = "freegolem_lavaland";
	name = "Lavaland Surface";
	turf_type = /turf/simulated/floor/plating/asteroid/basalt/lava_land_surface;
	width = 16
	},
/obj/docking_port/mobile{
	dir = 8;
	dwidth = 8;
	height = 20;
	id = "freegolem";
	name = "Free Golem Ship";
	width = 16
	},
/turf/simulated/floor/mineral/titanium/purple,
/area/shuttle/freegolem)
"aC" = (
/obj/structure/shuttle/engine/heater{
	icon_state = "heater";
	dir = 4
	},
/obj/structure/window/reinforced{
	dir = 8
	},
/obj/structure/window/reinforced,
/turf/simulated/floor/plating,
/area/shuttle/freegolem)
"aE" = (
/obj/structure/extinguisher_cabinet{
	pixel_y = -30
	},
/obj/machinery/light,
/turf/simulated/floor/mineral/titanium/purple,
/area/shuttle/freegolem)
"aF" = (
/obj/structure/fans/tiny,
/obj/machinery/door/airlock/titanium,
/turf/simulated/floor/mineral/titanium/purple,
/area/shuttle/freegolem)
"aG" = (
/obj/structure/shuttle/engine/propulsion{
	dir = 4;
	icon_state = "burst_l"
	},
/obj/structure/window/reinforced,
/turf/simulated/floor/plating,
/area/shuttle/freegolem)
"aH" = (
/obj/machinery/autolathe,
/turf/simulated/floor/mineral/titanium/purple,
/area/shuttle/freegolem)
"aI" = (
/obj/structure/table/wood,
/obj/machinery/reagentgrinder,
/turf/simulated/floor/mineral/titanium/purple,
/area/shuttle/freegolem)
"aJ" = (
/obj/machinery/vending/coffee/free,
/turf/simulated/floor/mineral/titanium/purple,
/area/shuttle/freegolem)
"aK" = (
/obj/machinery/vending/snack/free,
/turf/simulated/floor/mineral/titanium/purple,
/area/shuttle/freegolem)
"aL" = (
/obj/machinery/light,
/turf/simulated/floor/mineral/titanium/purple,
/area/shuttle/freegolem)
"aM" = (
/obj/structure/table/wood,
/obj/item/storage/firstaid/brute,
/obj/item/storage/firstaid/brute,
/obj/item/storage/firstaid/brute,
/turf/simulated/floor/mineral/titanium/purple,
/area/shuttle/freegolem)
"aN" = (
/obj/structure/extinguisher_cabinet{
	pixel_y = 30
	},
/obj/machinery/light{
	dir = 1
	},
/turf/simulated/floor/mineral/titanium/purple,
/area/shuttle/freegolem)
"aO" = (
/obj/structure/table/wood,
/obj/item/storage/firstaid/adv,
/obj/item/storage/firstaid/adv,
/turf/simulated/floor/mineral/titanium/purple,
/area/shuttle/freegolem)
"aP" = (
/obj/machinery/computer/shuttle/golem_ship/recall,
/turf/simulated/floor/plating/asteroid/basalt/lava_land_surface,
/area/ruin/powered/golem_ship)
"aQ" = (
/obj/structure/table/wood,
/obj/item/disk/design_disk/golem_shell,
/obj/item/areaeditor/golem,
/turf/simulated/floor/mineral/titanium/purple,
/area/shuttle/freegolem)
"aR" = (
/obj/machinery/light/small{
	dir = 1
	},
/turf/simulated/floor/plating,
/area/shuttle/freegolem)
"aT" = (
/obj/structure/table,
/obj/item/stack/sheet/wood{
	amount = 50
	},
/obj/item/stack/sheet/wood{
	amount = 50
	},
/turf/simulated/floor/plating,
/area/shuttle/freegolem)
"aV" = (
/obj/structure/table/wood,
/obj/item/resonator/upgraded,
/turf/simulated/floor/mineral/titanium/purple,
/area/shuttle/freegolem)
"aY" = (
/obj/structure/window/reinforced{
	dir = 4;
	pixel_x = 0
	},
/obj/machinery/recycler,
/turf/simulated/floor/mineral/titanium/purple,
/area/shuttle/freegolem)
"aZ" = (
/obj/structure/shuttle/engine/heater{
	icon_state = "heater";
	dir = 4
	},
/obj/structure/window/reinforced{
	dir = 8
	},
/obj/structure/window/reinforced{
	dir = 1
	},
/turf/simulated/floor/plating,
/area/shuttle/freegolem)
"ba" = (
/obj/structure/shuttle/engine/propulsion{
	dir = 4;
	icon_state = "burst_l"
	},
/obj/structure/window/reinforced{
	dir = 1
	},
/turf/simulated/floor/plating,
/area/shuttle/freegolem)
"bb" = (
/obj/structure/sign/biohazard,
/turf/simulated/wall/mineral/titanium/nodiagonal,
/area/shuttle/freegolem)
"bf" = (
/obj/structure/reagent_dispensers/watertank/high,
/turf/simulated/floor/mineral/titanium/purple,
/area/shuttle/freegolem)
"bg" = (
/obj/item/storage/toolbox/mechanical,
/obj/item/reagent_containers/spray/cleaner,
/obj/structure/table/wood,
/obj/structure/table,
/turf/simulated/floor/plating,
/area/shuttle/freegolem)
"cD" = (
/obj/machinery/light{
	dir = 1
	},
/turf/simulated/floor/mineral/titanium/purple,
/area/shuttle/freegolem)
"dL" = (
/obj/effect/mob_spawn/human/golem/adamantine,
/obj/structure/chair/comfy/purp{
	icon_state = "comfychair";
	dir = 1
	},
/turf/simulated/floor/mineral/titanium/purple,
/area/shuttle/freegolem)
"rJ" = (
/obj/structure/table/wood,
/obj/item/card/id/golem,
/turf/simulated/floor/mineral/titanium/purple,
/area/shuttle/freegolem)
"rX" = (
/obj/structure/table/wood,
/obj/item/book/manual/research_and_development{
	name = "Sacred Text of the Liberator";
	pixel_x = -4;
	pixel_y = 3
	},
/turf/simulated/floor/mineral/titanium/purple,
/area/shuttle/freegolem)
"yC" = (
/obj/machinery/constructable_frame/machine_frame,
/turf/simulated/floor/light,
/area/shuttle/freegolem)
"yK" = (
/obj/structure/statue/gold/rd{
	name = "statue of the Liberator"
	},
/turf/simulated/floor/mineral/titanium/purple,
/area/shuttle/freegolem)
"BM" = (
/obj/structure/table/wood,
/turf/simulated/floor/mineral/titanium/purple,
/area/shuttle/freegolem)
"CS" = (
/obj/structure/window/reinforced{
	dir = 8
	},
/obj/structure/window/reinforced,
/obj/structure/computerframe,
/turf/simulated/floor/mineral/titanium/purple,
/area/shuttle/freegolem)
"DA" = (
/obj/structure/chair/comfy/purp,
/turf/simulated/floor/mineral/titanium/purple,
/area/shuttle/freegolem)
"Lh" = (
/obj/machinery/constructable_frame/machine_frame,
/turf/simulated/floor/light{
	color = ""
	},
/area/shuttle/freegolem)
"MS" = (
/obj/effect/mob_spawn/human/golem/adamantine,
/obj/structure/chair/comfy/purp,
/turf/simulated/floor/mineral/titanium/purple,
/area/shuttle/freegolem)
"OK" = (
/obj/structure/closet/secure_closet/personal,
/turf/simulated/floor/mineral/titanium/purple,
/area/shuttle/freegolem)
"Xn" = (
/obj/machinery/constructable_frame/machine_frame,
/turf/simulated/floor/mineral/titanium/purple,
/area/shuttle/freegolem)

(1,1,1) = {"
ab
av
av
ab
aa
aa
aa
aa
aa
aa
aa
aa
ab
av
av
ab
"}
(2,1,1) = {"
av
ax
ap
av
aa
aa
aa
aa
aa
aa
aa
aa
av
ap
yC
av
"}
(3,1,1) = {"
av
ag
aL
ab
ab
ar
ab
ab
ab
ab
ar
ab
ab
cD
yC
av
"}
(4,1,1) = {"
av
ap
ap
ab
ap
ap
aV
ay
ay
ay
ap
aJ
ab
ap
yC
av
"}
(5,1,1) = {"
ab
ap
ap
ab
ap
ap
ap
ap
ap
ap
ap
aK
ab
ap
Lh
ab
"}
(6,1,1) = {"
ab
ap
aL
ab
ao
ap
ap
ap
ap
ap
ap
aL
bb
cD
bf
ab
"}
(7,1,1) = {"
ab
ap
ap
al
ap
ap
ap
ap
ap
ap
ap
ap
al
ap
an
ab
"}
(8,1,1) = {"
ab
ap
ap
al
ap
ap
ap
ap
ap
ap
ap
ap
al
ap
am
ab
"}
(9,1,1) = {"
ab
ab
ab
ab
ao
ap
aM
az
aO
aQ
ap
aL
ab
ab
ab
ab
"}
(10,1,1) = {"
ab
Xn
ap
CS
ap
ap
au
ap
aq
aH
ap
ap
ab
af
aT
ab
"}
(11,1,1) = {"
ab
yK
DA
rX
ap
ap
ap
ap
ap
ap
ap
ap
ab
af
ad
ab
"}
(12,1,1) = {"
ab
Xn
ap
as
ap
ap
ap
ap
ap
ap
ap
ap
ab
af
ad
ab
"}
(13,1,1) = {"
ab
aj
aL
ab
cD
ap
MS
rJ
rJ
dL
ap
aL
ab
aR
ad
ab
"}
(14,1,1) = {"
ab
ap
ap
al
ap
ap
ap
BM
BM
ap
ap
ap
al
af
ad
ab
"}
(15,1,1) = {"
ab
ap
ap
al
ap
ap
ap
BM
BM
ap
ap
ap
al
af
bg
ab
"}
(16,1,1) = {"
ac
ap
aL
ab
ao
ap
MS
rJ
rJ
dL
ap
aL
ab
aR
af
ac
"}
(17,1,1) = {"
ac
ap
ap
ab
ap
ap
ap
ap
ap
ap
ap
ap
ab
af
af
ac
"}
(18,1,1) = {"
ab
ap
ap
ab
ap
ap
ap
ap
ap
ap
ap
ap
ab
af
ad
ab
"}
(19,1,1) = {"
ab
OK
OK
ab
aC
aI
ab
aN
aE
ab
aY
aZ
ab
af
ad
ab
"}
(20,1,1) = {"
ab
ah
ah
ab
aG
ab
ab
aB
aF
ab
ab
ba
ab
ah
ah
ab
"}
(21,1,1) = {"
ab
ai
ai
ab
aa
aa
aA
aA
aA
aP
aa
aa
ab
ai
ai
ab
"}
