"aa" = (/turf/template_noop,/area/template_noop)
"ab" = (/obj/structure/weightmachine/stacklifter,/turf/simulated/floor/beach/sand,/area/ruin/powered/beach)
"ac" = (/obj/structure/weightmachine/weightlifter,/turf/simulated/floor/beach/sand,/area/ruin/powered/beach)
"ad" = (/obj/structure/flora/ausbushes/leafybush,/turf/simulated/floor/beach/sand,/area/ruin/powered/beach)
"ae" = (/obj/structure/table,/obj/item/storage/toolbox/mechanical,/obj/item/stack/cable_coil,/obj/item/storage/box/lights/mixed,/turf/simulated/floor/plating,/area/ruin/powered/beach)
"af" = (/obj/structure/table,/obj/item/clothing/mask/gas,/obj/machinery/light/small{dir = 1},/obj/item/clothing/glasses/sunglasses/big,/obj/item/clothing/glasses/sunglasses/big,/obj/item/clothing/glasses/sunglasses/big,/turf/simulated/floor/plating,/area/ruin/powered/beach)
"ag" = (/obj/structure/reagent_dispensers/fueltank,/turf/simulated/floor/plating,/area/ruin/powered/beach)
"ah" = (/obj/effect/mob_spawn/human/bartender/alive,/turf/simulated/floor/plating,/area/ruin/powered/beach)
"ai" = (/obj/machinery/portable_atmospherics/canister/oxygen,/turf/simulated/floor/plating,/area/ruin/powered/beach)
"aj" = (/turf/simulated/wall/mineral/sandstone,/area/ruin/powered/beach)
"ak" = (/obj/structure/toilet,/turf/simulated/floor/beach/sand,/area/ruin/powered/beach)
"al" = (/obj/structure/urinal{pixel_y = 32},/turf/simulated/floor/plating,/area/ruin/powered/beach)
"am" = (/obj/structure/urinal{pixel_y = 32},/turf/simulated/floor/beach/sand,/area/ruin/powered/beach)
"an" = (/obj/item/flashlight/lantern,/obj/machinery/light/small{dir = 1},/turf/simulated/floor/plating,/area/ruin/powered/beach)
"ao" = (/obj/structure/sink{dir = 4; pixel_x = 11},/obj/structure/mirror{pixel_x = 28},/turf/simulated/floor/beach/sand,/area/ruin/powered/beach)
"ap" = (/obj/structure/flora/ausbushes/sparsegrass,/turf/simulated/floor/beach/sand,/area/ruin/powered/beach)
"aq" = (/obj/structure/flora/ausbushes/sunnybush,/turf/simulated/floor/beach/sand,/area/ruin/powered/beach)
"ar" = (/obj/machinery/disco{anchored = 1},/turf/simulated/floor/light/colour_cycle,/area/ruin/powered/beach)
"as" = (/turf/simulated/floor/plating,/area/ruin/powered/beach)
"at" = (/obj/item/tank/oxygen,/turf/simulated/floor/plating,/area/ruin/powered/beach)
"au" = (/obj/structure/lattice,/turf/simulated/floor/pod/light,/area/ruin/powered/beach)
"av" = (/obj/machinery/door/airlock/sandstone{name = "Lavatory"},/turf/simulated/floor/plating,/area/ruin/powered/beach)
"aw" = (/obj/machinery/door/airlock/sandstone{name = "Bar Storage"},/turf/simulated/floor/wood,/area/ruin/powered/beach)
"ax" = (/obj/structure/extinguisher_cabinet,/turf/simulated/wall/mineral/sandstone,/area/ruin/powered/beach)
"ay" = (/obj/machinery/door/airlock/sandstone{name = "Restroom"},/turf/simulated/floor/beach/sand,/area/ruin/powered/beach)
"az" = (/obj/item/clothing/accessory/necklace/dope,/obj/item/reagent_containers/spray/spraytan,/turf/simulated/floor/beach/sand,/area/ruin/powered/beach)
"aA" = (/obj/item/reagent_containers/spray/spraytan,/turf/simulated/floor/beach/sand,/area/ruin/powered/beach)
"aB" = (/obj/item/reagent_containers/spray/spraytan,/turf/simulated/floor/plating/asteroid{baseturf = /turf/simulated/floor/beach/sand},/area/ruin/powered/beach)
"aC" = (/turf/simulated/floor/wood,/area/ruin/powered/beach)
"aD" = (/obj/structure/table,/obj/machinery/light{dir = 1},/obj/machinery/chem_dispenser/soda,/turf/simulated/floor/wood,/area/ruin/powered/beach)
"aE" = (/obj/structure/table,/obj/machinery/reagentgrinder,/turf/simulated/floor/wood,/area/ruin/powered/beach)
"aF" = (/obj/machinery/vending/boozeomat{emagged = 1; req_access_txt = "0"},/turf/simulated/floor/wood,/area/ruin/powered/beach)
"aH" = (/obj/structure/table,/obj/machinery/light{dir = 1},/obj/item/reagent_containers/food/drinks/shaker,/obj/item/reagent_containers/glass/rag,/turf/simulated/floor/wood,/area/ruin/powered/beach)
"aI" = (/obj/structure/table,/obj/machinery/microwave,/turf/simulated/floor/wood,/area/ruin/powered/beach)
"aJ" = (/obj/structure/closet/crate,/obj/item/tank/emergency_oxygen,/obj/item/trash/candy,/obj/item/toy/owl,/turf/simulated/floor/plating/asteroid{baseturf = /turf/simulated/floor/beach/sand},/area/ruin/powered/beach)
"aM" = (/obj/structure/reagent_dispensers/beerkeg,/turf/simulated/floor/wood,/area/ruin/powered/beach)
"aN" = (/obj/machinery/vending/cigarette,/turf/simulated/floor/plating/asteroid{baseturf = /turf/simulated/floor/beach/sand},/area/ruin/powered/beach)
"aP" = (/obj/structure/table/wood,/turf/simulated/floor/wood,/area/ruin/powered/beach)
"aQ" = (/obj/structure/table/wood,/obj/item/flashlight/lamp,/turf/simulated/floor/wood,/area/ruin/powered/beach)
"aR" = (/obj/structure/table/wood,/obj/item/reagent_containers/food/drinks/bottle/tequila,/turf/simulated/floor/wood,/area/ruin/powered/beach)
"aS" = (/obj/machinery/processor,/turf/simulated/floor/wood,/area/ruin/powered/beach)
"aT" = (/obj/machinery/vending/cola,/turf/simulated/floor/plating/asteroid{baseturf = /turf/simulated/floor/beach/sand},/area/ruin/powered/beach)
"aU" = (/obj/effect/overlay/palmtree_l,/turf/simulated/floor/beach/sand,/area/ruin/powered/beach)
"aV" = (/obj/effect/mob_spawn/human/beach/alive,/turf/simulated/floor/beach/sand,/area/ruin/powered/beach)
"aW" = (/obj/structure/chair/stool,/turf/simulated/floor/plating/asteroid{baseturf = /turf/simulated/floor/beach/sand},/area/ruin/powered/beach)
"aX" = (/obj/structure/closet/secure_closet/freezer/meat/open,/turf/simulated/floor/wood,/area/ruin/powered/beach)
"aY" = (/obj/machinery/vending/snack,/turf/simulated/floor/plating/asteroid{baseturf = /turf/simulated/floor/beach/sand},/area/ruin/powered/beach)
"aZ" = (/obj/effect/overlay/coconut,/turf/simulated/floor/beach/sand,/area/ruin/powered/beach)
"bc" = (/obj/machinery/door/airlock/sandstone{name = "Bar Access"},/turf/simulated/floor/wood,/area/ruin/powered/beach)
"bd" = (/obj/structure/closet/secure_closet/freezer/kitchen{req_access = null},/turf/simulated/floor/wood,/area/ruin/powered/beach)
"bg" = (/obj/structure/sign/barsign,/turf/simulated/wall/mineral/sandstone,/area/ruin/powered/beach)
"bx" = (/obj/structure/flora/rock,/turf/simulated/floor/beach/sand,/area/ruin/powered/beach)
"bz" = (/mob/living/simple_animal/crab,/turf/simulated/floor/beach/sand,/area/ruin/powered/beach)
"bA" = (/obj/structure/window/reinforced{dir = 1},/obj/structure/window/reinforced{dir = 8},/obj/item/bikehorn/airhorn,/obj/structure/table/wood,/obj/item/storage/firstaid/regular,/obj/item/storage/firstaid/brute,/turf/simulated/floor/wood,/area/ruin/powered/beach)
"bB" = (/obj/structure/window/reinforced{dir = 4},/obj/structure/window/reinforced{dir = 1; layer = 2.9},/obj/structure/chair/stool,/turf/simulated/floor/wood,/area/ruin/powered/beach)
"bE" = (/turf/simulated/floor/beach/sand,/area/ruin/powered/beach)
"bF" = (/obj/item/beach_ball,/turf/simulated/floor/beach/sand,/area/ruin/powered/beach)
"bG" = (/obj/structure/window/reinforced{dir = 8},/obj/structure/window/reinforced,/obj/item/megaphone,/turf/simulated/floor/wood,/area/ruin/powered/beach)
"bH" = (/obj/structure/window/reinforced{dir = 4},/obj/effect/mob_spawn/human/beach/alive/lifeguard,/turf/simulated/floor/wood,/area/ruin/powered/beach)
"bJ" = (/obj/structure/chair,/turf/simulated/floor/beach/sand,/area/ruin/powered/beach)
"bK" = (/obj/item/storage/backpack/duffel,/turf/simulated/floor/beach/sand,/area/ruin/powered/beach)
"bM" = (/turf/simulated/floor/plasteel/stairs/old,/area/ruin/powered/beach)
"bN" = (/obj/structure/flora/ausbushes/reedbush,/turf/simulated/floor/beach/sand,/area/ruin/powered/beach)
"bO" = (/obj/item/camera,/turf/simulated/floor/beach/sand,/area/ruin/powered/beach)
"bP" = (/obj/item/reagent_containers/food/drinks/cans/beer,/turf/simulated/floor/beach/sand,/area/ruin/powered/beach)
"bQ" = (/obj/structure/flora/ausbushes/reedbush,/turf/simulated/floor/beach/coastline_t,/area/ruin/powered/beach)
"bR" = (/turf/simulated/floor/beach/coastline_t,/area/ruin/powered/beach)
"bS" = (/obj/structure/flora/ausbushes/sparsegrass,/turf/simulated/floor/beach/coastline_t,/area/ruin/powered/beach)
"bT" = (/turf/simulated/floor/beach/coastline_b,/area/ruin/powered/beach)
"bU" = (/turf/simulated/floor/beach/water,/area/ruin/powered/beach)
"bV" = (/obj/structure/flora/ausbushes/stalkybush,/turf/simulated/floor/beach/water,/area/ruin/powered/beach)
"bW" = (/turf/simulated/wall/r_wall,/area/ruin/powered/beach)
"cd" = (/obj/machinery/light/small{dir = 1},/turf/simulated/wall/mineral/sandstone,/area/ruin/powered/beach)
"ce" = (/obj/machinery/light{dir = 1},/turf/simulated/floor/beach/sand,/area/ruin/powered/beach)
"cj" = (/obj/machinery/light{dir = 1},/turf/simulated/floor/plating/asteroid{baseturf = /turf/simulated/floor/beach/sand},/area/ruin/powered/beach)
"cs" = (/obj/effect/overlay/palmtree_l,/obj/machinery/light{dir = 4},/turf/simulated/floor/beach/sand,/area/ruin/powered/beach)
"ct" = (/obj/machinery/light,/turf/simulated/floor/beach/water,/area/ruin/powered/beach)
"cR" = (/obj/structure/table/wood,/obj/item/tank/oxygen,/obj/item/pickaxe,/obj/item/clothing/mask/gas,/turf/simulated/floor/pod,/area/ruin/powered/beach)
"gg" = (/obj/structure/table,/obj/item/storage/box/drinkingglasses,/obj/item/storage/box/drinkingglasses,/obj/item/storage/box/beakers,/obj/item/storage/box/donkpockets,/turf/simulated/floor/plating,/area/ruin/powered/beach)
"hY" = (/obj/structure/table,/obj/machinery/chem_dispenser/beer,/turf/simulated/floor/wood,/area/ruin/powered/beach)
"lF" = (/obj/machinery/light{dir = 4},/turf/simulated/floor/pod{oxygen = 14; nitrogen = 23; temperature = 300},/area/ruin/powered/beach)
"lM" = (/obj/structure/dresser,/turf/simulated/floor/pod,/area/ruin/powered/beach)
"mh" = (/obj/effect/spawner/window,/turf/simulated/floor/plating,/area/ruin/powered/beach)
"pg" = (/obj/machinery/shower{dir = 4},/turf/simulated/floor/pod/light,/area/ruin/powered/beach)
"pI" = (/obj/machinery/door/airlock/hatch{name = "Lava Beach Club"},/obj/structure/fans/tiny,/turf/simulated/floor/pod,/area/ruin/powered/beach)
"qa" = (/obj/machinery/light/small{dir = 4},/turf/simulated/floor/pod,/area/ruin/powered/beach)
"qT" = (/obj/machinery/shower{dir = 8},/turf/simulated/floor/pod/light,/area/ruin/powered/beach)
"zw" = (/obj/structure/closet/athletic_mixed,/turf/simulated/floor/pod,/area/ruin/powered/beach)
"Bl" = (/obj/machinery/light{dir = 8},/turf/simulated/floor/beach/sand,/area/ruin/powered/beach)
"Ec" = (/obj/machinery/door/airlock/sandstone{name = "Beach Access"},/turf/simulated/floor/pod,/area/ruin/powered/beach)
"Ga" = (/turf/simulated/floor/plating/asteroid{baseturf = /turf/simulated/floor/beach/sand},/area/ruin/powered/beach)
"Gc" = (/turf/simulated/floor/pod/light,/area/ruin/powered/beach)
"HC" = (/obj/structure/rack,/obj/item/clothing/shoes/sandal,/obj/item/clothing/shoes/sandal,/turf/simulated/floor/pod,/area/ruin/powered/beach)
"QS" = (/obj/machinery/light{dir = 4},/turf/simulated/floor/beach/sand,/area/ruin/powered/beach)
"TP" = (/obj/machinery/light{dir = 8},/turf/simulated/floor/pod{oxygen = 14; nitrogen = 23; temperature = 300},/area/ruin/powered/beach)
"VO" = (/turf/simulated/floor/pod,/area/ruin/powered/beach)
"Xp" = (/obj/machinery/light/small{light_power = 3; dir = 8},/turf/simulated/floor/pod,/area/ruin/powered/beach)

(1,1,1) = {"
aaaaaaaaaaaaaaaaaaaaaaaaaaaaaaaaaaaaaaaaaaaaaaaaaaaaaaaaaaaa
aaaaaaaaaaaabWbWbWbWbWbWbWbWbWbWbWbWbWbWbWbWbWbWaaaaaaaaaaaa
aaaaaaaabWbWbWadbWaeafagahaicdakajalamanaobWapbWbWbWaaaaaaaa
aaaaaabWbWaqbEbEbWggasasasatajbEavasasbEbEbWbEbEaqbWbWaaaaaa
aaaabWbWadbEapbEbWbWajawajaxajajajajajajaybWbEapbEapbWbWaaaa
aaaabWapbEbEazbEceGaajaCaDhYaFaEaHaIajaJGacebEbEbEbEadbWaaaa
aabWbWbEbEbEbEbEbEGaajaCaCaCaCaCaCaMajaNGabEbEbEbEbEbEbWbWaa
aabWapbEabbEabbEbEGaajaPaQaPaRajaCaSajaTGabEbEaUbEaqbEapbWaa
aabWBlbEbEaVbEbEbEGaGaaWaWaWaWajaCaXajaYGabEbEaAaZaVbEQSbWaa
lFbWbEbEacbEacbEbEGaGaGaGaGaGabcaCbdajGaGabEbEbEbEbEbEapbWTP
aabWbEbEbEbEbEbEbEGaGaGaarGaGaajbgajajGaGabEbEbEbEbEbEbEbWaa
bWbWbWbWBlbEbEbEbEGaGaGaGaGaGacjGaGacjGaGabEbEbzbEQSbWbWbWbW
bWzwHCmhbEbEbEbEbEaBGaGaGaGaGaGaGaGaGaGaGabEbEbEbEbEmhzwHCbW
bWXpVOmhbEbEaUbEbEbEbEbEbEbEbEbEbEbEbEbEbEbEbEbEbEbEmhVOqabW
pIGcGcmhBlbEaZbEbEbEbEbEbEbEbEbEbEbEbEbEbEbEbEbEbEQSmhGcGcpI
bWpgGcEcbEbEbEbEbEbEbEbEbxapbEbEbEaZbEbEbEbEbEbEbEbEEcGcqTbW
pIGcGcmhBlbEbEbEbEapbEapbEbEbEbEaUbEbEbEbEbEbEbEbEQSmhGcGcpI
bWXpVOmhbEbzbEbEapbxbEbEbEbEbEbEbEbEbEbAbBbEbEaZbEbEmhVOqabW
bWcRlMmhbEbEbEbEbEbEbEbEbEbEaAbEbEbFQSbGbHbEbEbEbEbEmhlMcRbW
bWbWbWbWBlbJbEbJbEbJbEbJbKbJbEbJbEbEbEaubMbEbJbEbEcsbWbWbWbW
aabWadapbNbEbEaAbObEbEbEbEbEbEbEbEbzbEbEbEbPbEbEbEbEapbNbWaa
lFbWbQbRbRbSbRbRbRbRbRbRbRbRbRbRbRbRbRbRbRbRbRbRbSbRbRbRbWTP
aabWbTbTbTbTbTbTbTbTbTbTbTbTbTbTbTbTbTbTbTbTbTbTbTbTbTbTbWaa
aabWbWbUbUbUbUbUbUbUbUbUbUbUbUbUbUbUbUbUbUbUbUbUbUbUbUbWbWaa
aaaabWctbUbUbUbUbUbUbUbUbUbUbUbUbVbUbUbUbUbUbUbUbUbUctbWaaaa
aaaabWbWbUbUbUbUbUbVbUbUbUbUbUbUbUbUbUbUbUbUbUbUbUbUbWbWaaaa
aaaaaabWbWbUctbUbUbUbUbUbUbUbUbUbUbUbUbUbUbVbUctbUbWbWaaaaaa
aaaaaaaabWbWbWbUbUbUbUctbUbUbUbUbUctbUbUbUbUbUbWbWbWaaaaaaaa
aaaaaaaaaaaabWbWbWbWbWbWbWbWbWbWbWbWbWbWbWbWbWbWaaaaaaaaaaaa
aaaaaaaaaaaaaaaaaaaaaaaaaaaaaaaaaaaaaaaaaaaaaaaaaaaaaaaaaaaa
"}
