//MAP CONVERTED BY dmm2tgm.py THIS HEADER COMMENT PREVENTS RECONVERSION, DO NOT REMOVE
"a" = (
/turf/simulated/mineral/volcanic/lava_land_surface,
/area/lavaland/surface/outdoors)
"b" = (
/turf/simulated/floor/plating/asteroid/basalt/lava_land_surface,
/area/lavaland/surface/outdoors)
"m" = (
/turf/simulated/floor/chasm/straight_down/lava_land_surface,
/area/lavaland/surface/outdoors)
"q" = (
/turf/template_noop,
/area/template_noop)
"M" = (
/obj/effect/mapping_helpers/no_lava,
/turf/simulated/floor/plating/asteroid/basalt/lava_land_surface,
/area/lavaland/surface/outdoors)

(1,1,1) = {"
q
q
a
q
a
b
a
q
a
q
"}
(2,1,1) = {"
a
a
q
a
a
b
a
a
a
q
"}
(3,1,1) = {"
a
b
a
a
b
b
a
b
a
a
"}
(4,1,1) = {"
a
a
a
a
b
M
a
a
a
q
"}
(5,1,1) = {"
q
a
b
a
b
M
b
a
q
a
"}
(6,1,1) = {"
q
a
b
b
M
m
M
a
a
a
"}
(7,1,1) = {"
a
q
a
b
M
m
M
a
b
a
"}
(8,1,1) = {"
a
b
a
a
M
m
M
b
a
a
"}
(9,1,1) = {"
q
a
q
a
M
m
M
b
a
q
"}
(10,1,1) = {"
a
q
a
b
M
m
M
b
a
q
"}
(11,1,1) = {"
a
b
a
b
M
m
M
a
b
a
"}
(12,1,1) = {"
q
a
b
M
m
m
M
b
a
a
"}
(13,1,1) = {"
q
a
a
M
m
m
M
b
b
a
"}
(14,1,1) = {"
a
q
a
M
m
m
M
M
b
q
"}
(15,1,1) = {"
a
b
a
M
m
m
m
M
b
b
"}
(16,1,1) = {"
q
a
b
M
m
m
m
M
a
b
"}
(17,1,1) = {"
b
b
M
M
m
m
M
b
a
a
"}
(18,1,1) = {"
a
a
M
m
m
m
M
b
b
a
"}
(19,1,1) = {"
q
a
M
m
m
m
m
M
b
a
"}
(20,1,1) = {"
a
a
b
M
m
m
m
M
b
b
"}
(21,1,1) = {"
a
b
b
M
m
m
m
M
b
a
"}
(22,1,1) = {"
b
b
b
M
m
m
m
M
b
q
"}
(23,1,1) = {"
b
a
M
m
m
m
m
M
a
a
"}
(24,1,1) = {"
a
a
M
m
m
m
m
M
b
a
"}
(25,1,1) = {"
q
a
M
m
m
m
M
b
b
a
"}
(26,1,1) = {"
a
b
M
m
m
m
M
b
b
b
"}
(27,1,1) = {"
b
b
M
m
m
m
M
b
a
a
"}
(28,1,1) = {"
q
b
M
m
m
m
M
b
a
q
"}
(29,1,1) = {"
b
M
m
m
m
m
m
M
a
b
"}
(30,1,1) = {"
b
M
m
m
m
m
m
M
b
q
"}
(31,1,1) = {"
a
b
M
m
m
m
M
b
b
a
"}
(32,1,1) = {"
b
b
M
m
m
m
M
b
b
a
"}
(33,1,1) = {"
a
b
b
M
m
m
M
b
a
b
"}
(34,1,1) = {"
a
a
b
M
m
m
M
b
a
q
"}
(35,1,1) = {"
q
a
b
M
m
m
m
M
b
a
"}
(36,1,1) = {"
q
b
M
m
m
m
m
M
b
a
"}
(37,1,1) = {"
a
b
M
m
m
m
m
M
b
b
"}
(38,1,1) = {"
b
a
b
M
m
m
M
b
a
a
"}
(39,1,1) = {"
q
a
b
M
m
m
M
a
a
q
"}
(40,1,1) = {"
q
a
b
M
m
m
M
b
b
a
"}
(41,1,1) = {"
a
b
a
M
m
m
M
b
a
a
"}
(42,1,1) = {"
q
a
a
b
M
m
M
b
a
a
"}
(43,1,1) = {"
q
a
b
b
M
m
M
b
a
q
"}
(44,1,1) = {"
a
q
a
a
M
m
M
b
b
a
"}
(45,1,1) = {"
a
a
q
a
M
m
M
a
b
a
"}
(46,1,1) = {"
a
b
a
a
b
M
b
a
a
q
"}
(47,1,1) = {"
a
q
a
b
b
M
b
b
a
q
"}
(48,1,1) = {"
q
a
a
a
a
b
b
a
a
q
"}
(49,1,1) = {"
q
a
b
a
a
b
a
a
b
a
"}
(50,1,1) = {"
q
a
a
q
a
b
a
q
a
q
"}
