//MAP CONVERTED BY dmm2tgm.py THIS HEADER COMMENT PREVENTS RECONVERSION, DO NOT REMOVE
"a" = (
/turf/template_noop,
/area/template_noop)
"b" = (
/obj/structure/bed,
/obj/item/bedsheet/centcom,
/turf/simulated/floor/wood/cold,
/area/ruin/unpowered/misc_lavaruin)
"g" = (
/turf/simulated/floor/wood/cold,
/area/ruin/unpowered/misc_lavaruin)
"k" = (
/turf/simulated/wall/indestructible,
/area/ruin/unpowered/misc_lavaruin)
"l" = (
/obj/structure/table/wood,
/obj/item/paper/fluff/stations/lavaland/sloth/note,
/obj/item/flashlight/lamp,
/turf/simulated/floor/wood/cold,
/area/ruin/unpowered/misc_lavaruin)
"v" = (
/obj/structure/chair/wood,
/turf/simulated/floor/wood/cold,
/area/ruin/unpowered/misc_lavaruin)
"w" = (
/obj/effect/spawner/random_spawners/dirt_frequent,
/turf/simulated/floor/wood/cold,
/area/ruin/unpowered/misc_lavaruin)
"z" = (
/turf/simulated/floor/sepia{
	slowdown = 10
	},
/area/ruin/unpowered/misc_lavaruin)
"A" = (
/obj/machinery/door/airlock/wood/glass,
/turf/simulated/floor/wood/cold,
/area/ruin/unpowered/misc_lavaruin)
"C" = (
/obj/machinery/computer/security/wooden_tv{
	network = list("SS13","Research  Outpost","Mining  Outpost")
	},
/turf/simulated/floor/wood/cold,
/area/ruin/unpowered/misc_lavaruin)
"D" = (
/turf/simulated/floor/carpet/green,
/area/ruin/unpowered/misc_lavaruin)
"F" = (
/obj/structure/table/wood,
/obj/item/reagent_containers/food/drinks/cans/beer{
	pixel_x = -9;
	pixel_y = 11
	},
/obj/item/reagent_containers/food/drinks/cans/beer{
	pixel_x = 10;
	pixel_y = -1
	},
/turf/simulated/floor/wood/cold,
/area/ruin/unpowered/misc_lavaruin)
"G" = (
/obj/structure/table/wood,
/obj/item/flashlight/lamp,
/obj/item/reagent_containers/food/snacks/grown/citrus/orange,
/turf/simulated/floor/wood/cold,
/area/ruin/unpowered/misc_lavaruin)
"M" = (
/obj/machinery/vending/cola/free,
/turf/simulated/floor/wood/cold,
/area/ruin/unpowered/misc_lavaruin)
"O" = (
/obj/structure/chair/comfy/beige{
	dir = 1
	},
/turf/simulated/floor/wood/cold,
/area/ruin/unpowered/misc_lavaruin)
"P" = (
/obj/effect/mapping_helpers/no_lava,
/turf/simulated/floor/plating/asteroid/basalt/lava_land_surface,
/area/lavaland/surface/outdoors)
"T" = (
/turf/simulated/floor/plating/lava/smooth/lava_land_surface,
/area/ruin/unpowered/misc_lavaruin)
"W" = (
/obj/machinery/vending/snack/free,
/turf/simulated/floor/wood/cold,
/area/ruin/unpowered/misc_lavaruin)
"X" = (
/obj/structure/chair/wood{
	dir = 1
	},
/turf/simulated/floor/wood/cold,
/area/ruin/unpowered/misc_lavaruin)

(1,1,1) = {"
a
a
a
a
a
a
a
a
a
a
a
a
a
a
a
a
a
a
a
a
a
a
a
a
a
a
a
a
a
"}
(2,1,1) = {"
a
T
T
T
T
T
T
T
T
T
T
T
T
T
T
T
T
T
T
T
T
T
T
T
T
T
T
T
a
"}
(3,1,1) = {"
a
T
k
k
k
k
k
k
k
k
k
k
k
k
k
k
k
k
k
k
k
k
k
k
k
k
k
T
a
"}
(4,1,1) = {"
a
T
k
z
z
z
z
k
z
z
z
k
z
z
z
z
z
z
z
z
z
z
k
M
g
l
k
T
P
"}
(5,1,1) = {"
a
T
k
z
k
z
k
k
k
z
k
k
k
k
k
k
k
k
k
k
k
z
A
g
g
D
A
P
P
"}
(6,1,1) = {"
a
T
k
z
k
z
z
z
z
z
z
z
z
z
z
k
z
z
z
z
k
z
k
v
F
X
k
T
P
"}
(7,1,1) = {"
a
T
k
z
k
z
k
k
k
k
k
k
k
z
k
k
k
k
k
z
k
z
k
k
k
k
k
T
a
"}
(8,1,1) = {"
a
T
k
z
k
z
k
z
z
z
z
k
z
z
z
z
z
z
k
z
k
z
k
T
T
T
T
T
a
"}
(9,1,1) = {"
a
T
k
z
k
z
k
z
k
k
k
k
k
k
k
k
k
z
k
z
z
z
k
T
a
a
a
a
a
"}
(10,1,1) = {"
a
T
k
z
k
z
k
z
z
z
z
z
z
z
z
z
k
z
k
z
k
z
k
T
a
a
a
a
a
"}
(11,1,1) = {"
a
T
k
z
k
k
k
z
k
z
k
k
k
k
k
z
k
z
k
k
k
z
k
T
a
a
a
a
a
"}
(12,1,1) = {"
a
T
k
z
z
z
k
z
k
z
k
C
g
O
k
z
z
z
k
z
k
z
k
T
a
a
a
a
a
"}
(13,1,1) = {"
a
T
k
z
k
z
k
z
k
z
A
D
w
G
k
z
k
z
k
z
k
z
k
T
a
a
a
a
a
"}
(14,1,1) = {"
a
T
k
k
k
z
k
z
k
k
k
W
g
b
k
z
k
k
k
z
k
z
k
T
a
a
a
a
a
"}
(15,1,1) = {"
a
T
k
z
z
z
k
z
k
z
k
k
k
k
k
z
k
z
k
z
k
z
k
T
a
a
a
a
a
"}
(16,1,1) = {"
a
T
k
z
k
z
k
z
k
z
z
z
z
z
z
z
k
z
k
z
k
z
k
T
a
a
a
a
a
"}
(17,1,1) = {"
a
T
k
z
k
k
k
z
k
k
k
k
k
k
k
k
k
z
k
z
k
z
k
T
a
a
a
a
a
"}
(18,1,1) = {"
a
T
k
z
k
z
k
z
z
k
z
z
z
z
z
z
z
z
k
z
k
z
k
T
a
a
a
a
a
"}
(19,1,1) = {"
a
T
k
z
k
z
k
k
k
k
k
z
k
k
k
k
k
k
k
z
k
z
k
T
a
a
a
a
a
"}
(20,1,1) = {"
a
T
k
z
k
z
z
z
z
z
z
z
z
z
z
z
z
z
z
z
k
z
k
T
a
a
a
a
a
"}
(21,1,1) = {"
a
T
k
z
k
k
k
k
z
k
k
k
k
k
k
k
z
k
k
k
k
z
k
T
a
a
a
a
a
"}
(22,1,1) = {"
a
T
k
z
z
z
z
z
z
z
z
k
z
z
z
z
z
z
z
z
z
z
k
T
a
a
a
a
a
"}
(23,1,1) = {"
a
T
k
k
k
k
k
k
k
k
k
k
k
k
k
k
k
k
k
k
k
k
k
T
a
a
a
a
a
"}
(24,1,1) = {"
a
T
T
T
T
T
T
T
T
T
T
T
T
T
T
T
T
T
T
T
T
T
T
T
a
a
a
a
a
"}
(25,1,1) = {"
a
a
a
a
a
a
a
a
a
a
a
a
a
a
a
a
a
a
a
a
a
a
a
a
a
a
a
a
a
"}
