//MAP CONVERTED BY dmm2tgm.py THIS HEADER COMMENT PREVENTS RECONVERSION, DO NOT REMOVE
"a" = (
/turf/simulated/mineral/volcanic/lava_land_surface,
/area/lavaland/surface/outdoors)
"c" = (
/turf/simulated/floor/lava/mapping_lava,
/area/lavaland/surface/outdoors)
"d" = (
/obj/effect/baseturf_helper/lava/mapping_lava,
/turf/simulated/floor/plasteel/freezer,
/area/ruin/powered/gluttony)
"e" = (
/turf/simulated/floor/lava,
/area/ruin/powered/gluttony)
"f" = (
/obj/item/dnainjector/eatmut,
/turf/simulated/floor/plasteel/freezer,
/area/ruin/powered/gluttony)
"g" = (
/obj/effect/gluttony,
/turf/simulated/floor/plasteel/freezer,
/area/ruin/powered/gluttony)
"h" = (
/obj/item/veilrender/vealrender,
/turf/simulated/floor/plasteel/freezer,
/area/ruin/powered/gluttony)
"i" = (
/turf/simulated/floor/plasteel/freezer,
/area/ruin/powered/gluttony)
"j" = (
/obj/item/trash/plate,
/turf/simulated/floor/plasteel/freezer,
/area/ruin/powered/gluttony)
"l" = (
/obj/item/trash/candy,
/turf/simulated/floor/plasteel/freezer,
/area/ruin/powered/gluttony)
"m" = (
/obj/item/trash/raisins,
/turf/simulated/floor/plasteel/freezer,
/area/ruin/powered/gluttony)
"n" = (
/obj/item/trash/pistachios,
/turf/simulated/floor/plasteel/freezer,
/area/ruin/powered/gluttony)
"o" = (
/obj/item/trash/popcorn,
/turf/simulated/floor/plasteel/freezer,
/area/ruin/powered/gluttony)
"p" = (
/obj/item/trash/semki,
/turf/simulated/floor/plasteel/freezer,
/area/ruin/powered/gluttony)
"q" = (
/obj/item/trash/syndi_cakes,
/turf/simulated/floor/plasteel/freezer,
/area/ruin/powered/gluttony)
"r" = (
/obj/effect/gluttony,
/obj/machinery/light/small{
	dir = 1
	},
/turf/simulated/floor/plasteel/freezer,
/area/ruin/powered/gluttony)
"t" = (
/obj/machinery/light/small{
	dir = 1
	},
/turf/simulated/floor/plasteel/freezer,
/area/ruin/powered/gluttony)
"u" = (
/turf/simulated/floor/plating/asteroid/basalt/lava_land_surface,
/area/lavaland/surface/outdoors)
"v" = (
/obj/machinery/light/small,
/turf/simulated/floor/plasteel/freezer,
/area/ruin/powered/gluttony)
"z" = (
/obj/item/trash/plate,
/obj/machinery/light/small{
	dir = 8
	},
/turf/simulated/floor/plasteel/freezer,
/area/ruin/powered/gluttony)
"A" = (
/obj/machinery/light/small{
	dir = 4
	},
/turf/simulated/floor/plasteel/freezer,
/area/ruin/powered/gluttony)
"R" = (
/turf/simulated/wall/indestructible/uranium,
/area/ruin/powered/gluttony)
"S" = (
/obj/machinery/door/airlock/uranium,
/obj/structure/fans/tiny/invisible,
/turf/simulated/floor/plasteel/freezer,
/area/ruin/powered/gluttony)

(1,1,1) = {"
a
a
a
u
u
a
a
u
a
u
u
u
u
u
u
u
a
a
a
a
"}
(2,1,1) = {"
a
a
a
u
u
u
u
u
u
u
u
u
u
u
u
u
a
a
a
a
"}
(3,1,1) = {"
u
a
a
a
u
u
u
c
c
c
u
c
c
c
u
u
a
a
a
a
"}
(4,1,1) = {"
u
a
a
a
u
u
u
c
R
R
S
R
R
c
u
a
a
a
a
a
"}
(5,1,1) = {"
u
u
a
a
a
u
u
c
R
h
i
o
R
c
u
a
a
a
a
a
"}
(6,1,1) = {"
a
a
a
a
a
u
u
c
R
i
i
v
R
c
u
u
u
u
u
a
"}
(7,1,1) = {"
a
u
u
u
u
u
u
c
R
i
l
i
R
c
u
u
u
u
u
a
"}
(8,1,1) = {"
a
u
c
c
c
c
c
c
R
t
i
m
R
c
c
c
c
c
c
u
"}
(9,1,1) = {"
u
u
c
R
R
R
R
R
R
g
m
v
R
R
R
R
R
R
c
u
"}
(10,1,1) = {"
a
u
c
R
e
R
r
g
g
g
g
i
p
i
z
l
i
R
c
u
"}
(11,1,1) = {"
a
u
c
R
f
g
g
g
g
g
n
d
i
i
i
i
i
S
u
u
"}
(12,1,1) = {"
a
u
c
R
e
R
r
g
g
g
i
g
i
l
A
i
q
R
c
u
"}
(13,1,1) = {"
a
u
c
R
R
R
R
R
R
g
i
v
R
R
R
R
R
R
c
u
"}
(14,1,1) = {"
a
u
c
c
c
c
c
c
R
r
i
i
R
c
c
c
c
c
c
u
"}
(15,1,1) = {"
a
u
u
u
u
u
u
c
R
i
g
i
R
c
u
u
u
u
u
u
"}
(16,1,1) = {"
u
u
u
a
u
u
u
c
R
j
i
v
R
c
u
u
u
a
a
a
"}
(17,1,1) = {"
u
u
u
a
u
u
u
c
R
i
n
i
R
c
u
u
u
a
a
a
"}
(18,1,1) = {"
a
a
a
a
u
u
u
c
R
R
S
R
R
c
u
u
u
a
a
a
"}
(19,1,1) = {"
a
a
a
a
a
a
a
c
c
c
u
c
c
c
u
u
a
a
a
a
"}
(20,1,1) = {"
a
a
a
a
a
a
a
u
u
u
u
u
u
u
a
a
u
a
a
a
"}
