//MAP CONVERTED BY dmm2tgm.py THIS HEADER COMMENT PREVENTS RECONVERSION, DO NOT REMOVE
"a" = (
/turf/template_noop,
/area/template_noop)
"b" = (
/obj/effect/mapping_helpers/no_lava,
/turf/simulated/floor/plating/asteroid/basalt/lava_land_surface,
/area/lavaland/surface/outdoors)
"c" = (
/obj/effect/mapping_helpers/no_lava,
/obj/effect/mapping_helpers/no_lava,
/turf/simulated/wall/indestructible/boss,
/area/lavaland/surface/outdoors)
"d" = (
/obj/structure/flora/ash/rock/style_random,
/obj/effect/mapping_helpers/no_lava,
/turf/simulated/floor/plating/asteroid/basalt/lava_land_surface,
/area/lavaland/surface/outdoors)
"e" = (
/obj/effect/mapping_helpers/no_lava,
/turf/simulated/mineral/random/high_chance/volcanic,
/area/lavaland/surface/outdoors)
"f" = (
/obj/structure/stone_tile/block/cracked{
	dir = 1
	},
/obj/structure/stone_tile/block,
/obj/effect/mob_spawn/corpse/watcher/goliath_chewed,
/obj/effect/mapping_helpers/no_lava,
/obj/effect/mapping_helpers/no_lava,
/turf/simulated/floor/plating/asteroid/basalt/lava_land_surface,
/area/lavaland/surface/outdoors)
"g" = (
/obj/structure/stone_tile{
	dir = 1
	},
/obj/item/food/egg/watcher,
/obj/effect/mapping_helpers/no_lava,
/obj/effect/mapping_helpers/no_lava,
/turf/simulated/floor/plating/asteroid/basalt/lava_land_surface,
/area/lavaland/surface/outdoors)
"h" = (
/obj/structure/flora/ash/cap_shroom,
/obj/effect/mapping_helpers/no_lava,
/obj/effect/mapping_helpers/no_lava,
/turf/simulated/floor/plating/asteroid/basalt/lava_land_surface,
/area/lavaland/surface/outdoors)
"i" = (
/obj/effect/mapping_helpers/no_lava,
/obj/effect/mapping_helpers/bombable_wall,
/turf/simulated/wall/indestructible/boss,
/area/lavaland/surface/outdoors)
"j" = (
/obj/effect/mob_spawn/corpse/watcher/crushed,
/obj/effect/mapping_helpers/no_lava,
/turf/simulated/floor/plating/asteroid/basalt/lava_land_surface,
/area/lavaland/surface/outdoors)
"k" = (
/obj/structure/stone_tile/cracked,
/obj/effect/mapping_helpers/no_lava,
/turf/simulated/floor/plating/asteroid/basalt/lava_land_surface,
/area/lavaland/surface/outdoors)
"l" = (
/obj/structure/stone_tile/slab,
/obj/effect/mapping_helpers/no_lava,
/turf/simulated/floor/plating/asteroid/basalt/lava_land_surface,
/area/lavaland/surface/outdoors)
"m" = (
/obj/structure/stone_tile/slab/cracked,
/obj/effect/mob_spawn/corpse/goliath/pierced,
/obj/effect/mapping_helpers/no_lava,
/turf/simulated/floor/plating/asteroid/basalt/lava_land_surface,
/area/lavaland/surface/outdoors)
"o" = (
/obj/effect/mapping_helpers/no_lava,
/turf/simulated/mineral/random/volcanic,
/area/lavaland/surface/outdoors)
"p" = (
/obj/structure/stone_tile/block/cracked{
	dir = 1
	},
/obj/effect/mapping_helpers/no_lava,
/obj/effect/mapping_helpers/no_lava,
/turf/simulated/floor/plating/asteroid/basalt/lava_land_surface,
/area/lavaland/surface/outdoors)
"q" = (
/obj/structure/flora/ash/leaf_shroom,
/obj/effect/mapping_helpers/no_lava,
/obj/effect/mapping_helpers/no_lava,
/turf/simulated/floor/plating/asteroid/basalt/lava_land_surface,
/area/lavaland/surface/outdoors)
"r" = (
/obj/effect/mapping_helpers/no_lava,
/obj/effect/mapping_helpers/no_lava,
/turf/simulated/floor/plating/asteroid/basalt/lava_land_surface,
/area/lavaland/surface/outdoors)
"t" = (
/obj/structure/flora/ash/cacti,
/obj/effect/mapping_helpers/no_lava,
/turf/simulated/floor/plating/asteroid/basalt/lava_land_surface,
/area/lavaland/surface/outdoors)
"v" = (
/obj/structure/stone_tile/surrounding/cracked,
/obj/structure/stone_tile/center/cracked,
/obj/effect/mapping_helpers/no_lava,
/obj/effect/mapping_helpers/no_lava,
/turf/simulated/floor/plating/asteroid/basalt/lava_land_surface,
/area/lavaland/surface/outdoors)
"w" = (
/turf/simulated/floor/lava/mapping_lava,
/area/lavaland/surface/outdoors)
"A" = (
/obj/structure/flora/ash/leaf_shroom,
/obj/effect/mapping_helpers/no_lava,
/turf/simulated/floor/plating/asteroid/basalt/lava_land_surface,
/area/lavaland/surface/outdoors)
"F" = (
/obj/structure/flora/ash/rock/style_random,
/obj/effect/mapping_helpers/no_lava,
/obj/effect/mapping_helpers/no_lava,
/turf/simulated/floor/plating/asteroid/basalt/lava_land_surface,
/area/lavaland/surface/outdoors)
"J" = (
/obj/effect/mapping_helpers/no_lava,
/turf/simulated/wall/indestructible/boss,
/area/lavaland/surface/outdoors)
"M" = (
/obj/effect/mapping_helpers/no_lava,
/obj/structure/stone_tile{
	dir = 1
	},
/turf/simulated/floor/plating/asteroid/basalt/lava_land_surface,
/area/lavaland/surface/outdoors)
"Q" = (
/turf/simulated/mineral/random/volcanic,
/area/lavaland/surface/outdoors)
"Z" = (
/obj/effect/mapping_helpers/no_lava,
/obj/structure/stone_tile/slab/cracked,
/turf/simulated/floor/plating/asteroid/basalt/lava_land_surface,
/area/lavaland/surface/outdoors)

(1,1,1) = {"
a
a
a
e
e
e
M
e
o
a
a
"}
(2,1,1) = {"
a
o
o
c
c
J
i
J
o
o
a
"}
(3,1,1) = {"
a
o
J
c
h
d
b
J
w
o
o
"}
(4,1,1) = {"
a
o
J
v
f
k
b
w
w
w
Q
"}
(5,1,1) = {"
a
o
J
p
g
l
b
t
w
w
w
"}
(6,1,1) = {"
o
o
J
q
r
m
b
b
J
w
w
"}
(7,1,1) = {"
a
o
J
c
F
k
b
A
J
o
o
"}
(8,1,1) = {"
a
o
o
c
c
J
i
J
J
o
o
"}
(9,1,1) = {"
a
a
o
o
o
J
Z
J
o
o
a
"}
(10,1,1) = {"
a
a
a
a
a
o
j
o
a
a
a
"}
