"aa" = (/turf/template_noop,/area/lavaland/surface/outdoors)
"ab" = (/turf/open/floor/plating/lava/smooth/lava_land_surface,/area/lavaland/surface/outdoors)
"ac" = (/turf/closed/mineral/volcanic,/area/lavaland/surface/outdoors)
"ad" = (/turf/closed/wall/r_wall,/area/ruin/unpowered)
"ae" = (/obj/structure/bed,/obj/item/weapon/bedsheet/red,/turf/open/floor/pod,/area/ruin/unpowered)
"af" = (/obj/structure/bed,/obj/item/weapon/bedsheet/red,/obj/effect/mob_spawn/human/corpse/russian,/turf/open/floor/pod,/area/ruin/unpowered)
"ag" = (/obj/effect/mob_spawn/human/corpse/russian,/turf/open/floor/pod,/area/ruin/unpowered)
"ah" = (/obj/machinery/light{dir = 1},/turf/open/floor/pod,/area/ruin/unpowered)
"ai" = (/turf/open/floor/pod,/area/ruin/unpowered)
"aj" = (/obj/structure/table,/obj/item/weapon/razor,/turf/open/floor/pod,/area/ruin/unpowered)
"ak" = (/obj/structure/table,/obj/item/weapon/wirerod,/turf/open/floor/pod,/area/ruin/unpowered)
"al" = (/obj/structure/table,/obj/item/weapon/surgicaldrill,/turf/open/floor/pod,/area/ruin/unpowered)
"am" = (/obj/machinery/light{icon_state = "tube1"; dir = 8},/turf/open/floor/pod,/area/ruin/unpowered)
"an" = (/obj/effect/decal/cleanable/blood/splatter,/turf/open/floor/pod,/area/ruin/unpowered)
"ao" = (/obj/structure/bed,/turf/open/floor/pod,/area/ruin/unpowered)
"ap" = (/obj/effect/decal/cleanable/blood/drip,/turf/open/floor/pod,/area/ruin/unpowered)
"aq" = (/obj/item/ammo_casing/a357,/obj/effect/decal/cleanable/blood/drip,/obj/effect/decal/cleanable/blood/tracks,/turf/open/floor/pod,/area/ruin/unpowered)
"ar" = (/obj/item/chair,/obj/effect/decal/cleanable/blood,/obj/effect/mob_spawn/human/corpse/damaged,/turf/open/floor/pod,/area/ruin/unpowered)
"as" = (/obj/structure/bed,/obj/item/weapon/bedsheet/brown,/turf/open/floor/pod,/area/ruin/unpowered)
"at" = (/obj/machinery/door/airlock/hatch,/turf/open/floor/pod,/area/ruin/unpowered)
"au" = (/obj/item/weapon/restraints/handcuffs,/turf/open/floor/pod,/area/ruin/unpowered)
"av" = (/obj/effect/mob_spawn/human/corpse/russian,/obj/effect/decal/cleanable/blood/old,/turf/open/floor/pod,/area/ruin/unpowered)
"aw" = (/obj/structure/table/reinforced,/obj/item/weapon/reagent_containers/food/snacks/burger/bearger,/obj/item/weapon/reagent_containers/food/snacks/burger/bearger,/obj/item/weapon/reagent_containers/food/snacks/burger/bearger,/turf/open/floor/pod,/area/ruin/unpowered)
"ax" = (/obj/structure/table/reinforced,/obj/item/weapon/reagent_containers/food/snacks/bearsteak,/obj/item/weapon/reagent_containers/food/snacks/bearsteak,/turf/open/floor/pod,/area/ruin/unpowered)
"ay" = (/obj/machinery/light{dir = 4},/turf/open/floor/pod,/area/ruin/unpowered)
"az" = (/obj/structure/table,/obj/item/weapon/circular_saw,/turf/open/floor/pod,/area/ruin/unpowered)
"aA" = (/obj/structure/table,/obj/item/weapon/kitchen/knife/butcher,/turf/open/floor/pod,/area/ruin/unpowered)
"aB" = (/obj/structure/table,/obj/item/weapon/kitchen/knife/combat,/turf/open/floor/pod,/area/ruin/unpowered)
"aC" = (/obj/structure/table/reinforced,/obj/item/clothing/gloves/space_ninja,/turf/open/floor/pod,/area/ruin/unpowered)
"aD" = (/obj/structure/table/reinforced,/obj/item/clothing/shoes/space_ninja,/turf/open/floor/pod,/area/ruin/unpowered)
"aE" = (/obj/machinery/porta_turret/syndicate,/turf/open/floor/pod,/area/ruin/unpowered)
"aF" = (/obj/machinery/light{dir = 4},/obj/effect/decal/cleanable/blood/splatter,/turf/open/floor/pod,/area/ruin/unpowered)
"aG" = (/obj/effect/decal/cleanable/blood/splatter,/turf/closed/wall/r_wall,/area/ruin/unpowered)
"aH" = (/obj/machinery/light{icon_state = "tube1"; dir = 8},/obj/structure/table/reinforced,/obj/item/clothing/head/helmet/space/space_ninja,/obj/item/clothing/mask/gas/space_ninja{icon_state = "s-ninjak"},/turf/open/floor/pod,/area/ruin/unpowered)
"aI" = (/obj/machinery/door/airlock/hatch{locked = 1},/turf/open/floor/pod,/area/ruin/unpowered)
"aJ" = (/obj/effect/mob_spawn/human/corpse/damaged,/obj/effect/decal/cleanable/blood/splatter,/turf/open/floor/pod,/area/ruin/unpowered)
"aK" = (/obj/machinery/door/airlock/hatch{locked = 1},/obj/effect/decal/cleanable/blood/splatter,/turf/open/floor/pod,/area/ruin/unpowered)
"aL" = (/obj/effect/mob_spawn/human/corpse/nanotrasensoldier,/turf/open/floor/pod,/area/ruin/unpowered)
"aM" = (/obj/item/ammo_casing/a357,/turf/open/floor/pod,/area/ruin/unpowered)
"aN" = (/obj/structure/table/reinforced,/obj/item/clothing/suit/space/space_ninja{icon_state = "s-ninjak"},/turf/open/floor/pod,/area/ruin/unpowered)
"aO" = (/obj/structure/table/reinforced,/turf/open/floor/pod,/area/ruin/unpowered)
"aP" = (/obj/structure/table/wood,/obj/item/weapon/reagent_containers/food/drinks/bottle/vodka,/obj/item/weapon/reagent_containers/food/drinks/bottle/vodka/badminka{pixel_x = 6; pixel_y = 3},/obj/item/weapon/reagent_containers/food/drinks/bottle/vodka/badminka{pixel_x = -9; pixel_y = -4},/turf/open/floor/pod,/area/ruin/unpowered)
"aQ" = (/obj/machinery/light{dir = 4},/obj/item/ammo_casing/a357{pixel_x = -5; pixel_y = 8},/obj/item/ammo_casing/a357,/turf/open/floor/pod,/area/ruin/unpowered)
"aR" = (/obj/structure/table/reinforced,/obj/item/weapon/reagent_containers/food/snacks/meat/slab/bear,/obj/item/weapon/reagent_containers/food/snacks/meat/slab/bear,/obj/item/weapon/reagent_containers/food/snacks/meat/slab/bear,/obj/item/weapon/reagent_containers/food/snacks/pie/bearypie,/turf/open/floor/pod,/area/ruin/unpowered)
"aS" = (/obj/structure/table/reinforced,/obj/item/clothing/head/bearpelt,/turf/open/floor/pod,/area/ruin/unpowered)
"aT" = (/obj/structure/table/reinforced,/obj/item/weapon/reagent_containers/food/snacks/meat/steak/bear,/obj/item/weapon/reagent_containers/food/snacks/meat/steak/bear,/obj/item/weapon/reagent_containers/food/snacks/pie/bearypie,/turf/open/floor/pod,/area/ruin/unpowered)
"aU" = (/obj/structure/table/wood,/obj/item/weapon/reagent_containers/food/drinks/bottle/vodka/badminka,/obj/item/weapon/gun/projectile/revolver,/turf/open/floor/pod,/area/ruin/unpowered)
"aV" = (/obj/structure/chair{dir = 8; name = "chair"},/obj/effect/mob_spawn/human/corpse/russian/ranged/officer,/obj/effect/decal/cleanable/blood/old,/turf/open/floor/pod,/area/ruin/unpowered)
"aW" = (/obj/effect/decal/cleanable/blood/old,/turf/open/floor/pod,/area/ruin/unpowered)
"aX" = (/obj/structure/table,/obj/item/clothing/mask/gas/sexyclown,/turf/open/floor/pod,/area/ruin/unpowered)
"aY" = (/obj/structure/table,/obj/item/clothing/mask/gas/explorer,/turf/open/floor/pod,/area/ruin/unpowered)
"aZ" = (/obj/item/weapon/cigbutt/cigarbutt,/turf/open/floor/pod,/area/ruin/unpowered)
"ba" = (/obj/structure/table,/obj/item/clothing/mask/gas/syndicate,/turf/open/floor/pod,/area/ruin/unpowered)
"bb" = (/obj/item/chair{dir = 4},/turf/open/floor/pod,/area/ruin/unpowered)
"bc" = (/obj/structure/table,/turf/open/floor/pod,/area/ruin/unpowered)
"bd" = (/obj/item/chair,/turf/open/floor/pod,/area/ruin/unpowered)
"be" = (/obj/structure/table_frame,/turf/open/floor/pod,/area/ruin/unpowered)
"bf" = (/obj/structure/table,/obj/item/weapon/crowbar/red,/turf/open/floor/pod,/area/ruin/unpowered)
"bg" = (/obj/item/stack/rods,/turf/open/floor/pod,/area/ruin/unpowered)
"bh" = (/obj/item/weapon/broken_bottle,/turf/open/floor/pod,/area/ruin/unpowered)
"bi" = (/obj/item/stack/sheet/metal,/turf/open/floor/pod,/area/ruin/unpowered)
"bj" = (/obj/item/weapon/wrench,/turf/open/floor/pod,/area/ruin/unpowered)
"bk" = (/obj/structure/table,/obj/item/clothing/mask/facehugger/toy,/turf/open/floor/pod,/area/ruin/unpowered)
"bl" = (/obj/machinery/light,/turf/open/floor/pod,/area/ruin/unpowered)
"bm" = (/obj/structure/table_frame,/obj/item/stack/rods,/turf/open/floor/pod,/area/ruin/unpowered)
"bn" = (/obj/structure/table,/obj/item/weapon/stock_parts/matter_bin/bluespace,/turf/open/floor/pod,/area/ruin/unpowered)
"bo" = (/obj/structure/table,/obj/item/clothing/head/helmet/skull,/turf/open/floor/pod,/area/ruin/unpowered)
"bp" = (/obj/machinery/keycard_auth{pixel_y = -7},/turf/closed/wall/r_wall,/area/ruin/unpowered)
"bq" = (/obj/machinery/space_heater,/turf/open/floor/pod,/area/ruin/unpowered)
"br" = (/obj/effect/decal/cleanable/blood/drip,/obj/effect/mob_spawn/human/corpse/nanotrasensoldier,/turf/open/floor/pod,/area/ruin/unpowered)
"bs" = (/obj/machinery/suit_storage_unit/standard_unit,/turf/open/floor/pod,/area/ruin/unpowered)
"bt" = (/obj/machinery/shower{dir = 4},/turf/open/floor/pod,/area/ruin/unpowered)
"bu" = (/obj/machinery/shower{dir = 8},/turf/open/floor/pod,/area/ruin/unpowered)
"bv" = (/turf/open/floor/plating,/area/ruin/unpowered)
"bw" = (/turf/open/floor/plating{icon_state = "platingdmg1"},/area/ruin/unpowered)
"bx" = (/obj/machinery/door/poddoor,/turf/open/floor/pod,/area/ruin/unpowered)
"by" = (/obj/structure/barricade/sandbags,/turf/open/floor/pod,/area/lavaland/surface/outdoors)
"bz" = (/turf/open/floor/plating{icon_state = "platingdmg3"},/area/lavaland/surface/outdoors)
"bA" = (/turf/open/floor/pod,/area/lavaland/surface/outdoors)
"bB" = (/obj/effect/mob_spawn/human/corpse/russian,/obj/effect/decal/cleanable/blood/old,/turf/open/floor/pod,/area/lavaland/surface/outdoors)

(1,1,1) = {"
aaaaaaaaaaaaaaaaaaaaaaaaaaaaaaaaaaaaaaaaaaaaaaaaaaaaaaaaaaaaaaaaaaaaaa
aaaaaaaaaaaaaaaaaaaaababacabababacacabababababababaaaaaaaaaaaaaaaaaaaa
aaaaaaaaaaaaaaaaaaaaabacacacababacacababacacababababaaaaaaaaaaaaaaaaaa
aaaaaaaaaaaaaaabacacababababababababababacacacacacabaaaaaaaaaaaaaaaaaa
aaaaaaaaaaaaaaababababadadadadadadadadadadadadadababaaaaaaaaaaaaaaaaaa
aaaaaaaaaaaaaaababababadaeafaeadagahaiadajakaladababaaaaaaaaaaaaaaaaaa
aaaaaaaaaaaaaaabacacabadamaiaiadaiaiaiadaianaiadacabaaaaaaaaaaaaaaaaaa
aaaaaaaaaaaaaaacacababadaoaiaeadaiaiaiadapaqaradacabaaaaaaaaaaaaaaaaaa
aaaaaaaaaaaaabababababadasaiaiataiaiaiataiapauadababaaaaaaaaaaaaaaaaaa
aaaaaaaaaaaaabadadadadadadadadadaiavaiadaiaiaiadababaaaaaaaaaaaaaaaaaa
aaaaaaaaaaababadadadadadawaxaxadamaiayadazaAaBadababaaaaaaaaaaaaaaaaaa
aaaaaaaaaaababadadaCaDadaEaiaFaGaiaiaiadadadadadababacaaaaaaaaaaaaaaaa
aaaaaaaaaaababadadaHaiaIaiaJanaKaiaLaiadaiaiaMadababacaaaaaaaaaaaaaaaa
aaaaaaaaaaababadadaNaOadaEaiaFaGaiaiaiataiaPaQadabacacaaaaaaaaaaaaaaaa
aaaaaaaaaaababadadadadadaRaSaTadavaiaiadaiaUaVadabababaaaaaaaaaaaaaaaa
aaaaaaaaaaababadadadadadadadadadadatadadadadadadadababaaaaaaaaaaaaaaaa
aaaaaaaaaaaaababababadaiaiahaiaiaiaWaiaiaiahaXaYadababaaaaaaaaaaaaaaaa
aaaaaaaaaaaaaaabacabadaiaiaiaiaiavaiaiaZaiaiaibaadababaaaaaaaaaaaaaaaa
aaaaaaaaaaaaaaacacabadaibbbcbdbebcbfbgbhaiaiaiaiadabacaaaaaaaaaaaaaaaa
aaaaaaaaaaaaaaabababadaiaiaiaZbibjaibiaiaiaiaibkadabacaaaaaaaaaaaaaaaa
aaaaaaaaaaaaaaaaababadaiaiblaibcaiaibmaiaiblbnboadababaaaaaaaaaaaaaaaa
aaaaaaaaaaaaaaaaacabadadadadadadadatbpadadadadadadababaaaaaaaaaaaaaaaa
aaaaaaaaaaaaaaaaacabababababadbqahbrapbsadababababababaaaaaaaaaaaaaaaa
aaaaaaaaaaaaaaaaacaaababababadbsaiapblaiadabacabacacabaaaaaaaaaaaaaaaa
aaaaaaaaaaaaaaaaaaaaacacababadadadatadadadabacababaaaaaaaaaaaaaaaaaaaa
aaaaaaaaaaaaaaaaaaaaacabababadbtaiavahbuadabacababaaaaaaaaaaaaaaaaaaaa
aaaaaaaaaaaaaaaaaaaaababababadbvaiaiaibuadababababaaaaaaaaaaaaaaaaaaaa
aaaaaaaaaaaaaaaaaaaaababacacadbwadbxadadadacacababaaaaaaaaaaaaaaaaaaaa
aaaaaaaaaaaaaaaaaaacacacacbybzbzbAbAbBbAbAbyacacacacaaaaaaaaaaaaaaaaaa
aaaaaaaaaaaaaaaaaaaaaaaaaabybAbAbBbAbAbAbAbyaaaaaaaaaaaaaaaaaaaaaaaaaa
aaaaaaaaaaaaaaaaaaaaaaaaaabybAbAbAbAbAbAbAbyaaaaaaaaaaaaaaaaaaaaaaaaaa
aaaaaaaaaaaaaaaaaaaaaaaaaabybybybybybybybybyaaaaaaaaaaaaaaaaaaaaaaaaaa
aaaaaaaaaaaaaaaaaaaaaaaaaaaaaaaaaaaaaaaaaaaaaaaaaaaaaaaaaaaaaaaaaaaaaa
aaaaaaaaaaaaaaaaaaaaaaaaaaaaaaaaaaaaaaaaaaaaaaaaaaaaaaaaaaaaaaaaaaaaaa
aaaaaaaaaaaaaaaaaaaaaaaaaaaaaaaaaaaaaaaaaaaaaaaaaaaaaaaaaaaaaaaaaaaaaa
"}
