"a" = (/turf/template_noop,/area/template_noop)
"b" = (/turf/simulated/wall/mineral/titanium,/area/ruin/powered/golem_ship)
"c" = (/obj/structure/fans/tiny,/obj/machinery/door/airlock/shuttle,/turf/simulated/floor/plating,/area/ruin/powered/golem_ship)
"d" = (/obj/structure/closet/crate/golemgear,/turf/simulated/floor/plating,/area/ruin/powered/golem_ship)
"e" = (/obj/item/storage/toolbox/mechanical,/obj/item/reagent_containers/spray/cleaner,/turf/simulated/floor/plating,/area/ruin/powered/golem_ship)
"f" = (/turf/simulated/floor/plating,/area/ruin/powered/golem_ship)
"g" = (/obj/structure/reagent_dispensers/watertank/high,/turf/simulated/floor/plating,/area/ruin/powered/golem_ship)
"h" = (/obj/structure/shuttle/engine/heater{icon_state = "heater"; dir = 4},/obj/structure/window/reinforced{dir = 8},/turf/simulated/shuttle/plating,/area/ruin/powered/golem_ship)
"i" = (/obj/structure/shuttle/engine/propulsion{dir = 4; icon_state = "burst_l"},/turf/simulated/shuttle/plating,/area/ruin/powered/golem_ship)
"j" = (/obj/machinery/light/small,/turf/simulated/floor/plating,/area/ruin/powered/golem_ship)
"k" = (/obj/structure/reagent_dispensers/watertank,/turf/simulated/floor/plating,/area/ruin/powered/golem_ship)
"l" = (/obj/machinery/door/airlock/shuttle,/turf/simulated/floor/mineral/titanium/purple,/area/ruin/powered/golem_ship)
"m" = (/obj/machinery/vending/hydronutrients,/turf/simulated/floor/mineral/titanium/purple,/area/ruin/powered/golem_ship)
"n" = (/obj/machinery/vending/hydroseeds,/turf/simulated/floor/mineral/titanium/purple,/area/ruin/powered/golem_ship)
"o" = (/obj/machinery/light{dir = 1; on = 1},/turf/simulated/floor/mineral/titanium/purple,/area/ruin/powered/golem_ship)
"p" = (/turf/simulated/floor/mineral/titanium/purple,/area/ruin/powered/golem_ship)
"q" = (/obj/machinery/light{dir = 1; on = 1},/obj/effect/mob_spawn/human/golem/adamantine,/turf/simulated/floor/mineral/titanium/purple,/area/ruin/powered/golem_ship)
"r" = (/obj/effect/mob_spawn/human/golem/adamantine,/turf/simulated/floor/mineral/titanium/purple,/area/ruin/powered/golem_ship)
"s" = (/obj/machinery/vending/coffee/free,/turf/simulated/floor/mineral/titanium/purple,/area/ruin/powered/golem_ship)
"t" = (/obj/machinery/mineral/equipment_vendor/golem,/turf/simulated/floor/mineral/titanium/purple,/area/ruin/powered/golem_ship)
"u" = (/obj/machinery/door/airlock/shuttle,/obj/structure/fans/tiny,/turf/simulated/floor/mineral/titanium/purple,/area/ruin/powered/golem_ship)
"v" = (/obj/item/resonator,/turf/simulated/floor/mineral/titanium/purple,/area/ruin/powered/golem_ship)
"w" = (/obj/machinery/door/airlock/shuttle,/turf/simulated/shuttle/floor{icon_state = "floor5"},/area/ruin/powered/golem_ship)
"x" = (/obj/machinery/light{dir = 8},/turf/simulated/floor/mineral/titanium/purple,/area/ruin/powered/golem_ship)
"y" = (/obj/machinery/mineral/ore_redemption/golem,/turf/simulated/floor/mineral/titanium/purple,/area/ruin/powered/golem_ship)
"z" = (/obj/structure/window/full/shuttle{icon_state = "16"},/obj/structure/grille,/turf/simulated/shuttle/plating,/area/ruin/powered/golem_ship)
"A" = (/obj/structure/statue/gold/rd{name = "statue of the Liberator"},/obj/structure/window/reinforced{dir = 4; pixel_x = 0},/turf/simulated/shuttle/floor{icon_state = "floor5"},/area/ruin/powered/golem_ship)
"B" = (/obj/structure/computerframe,/turf/simulated/floor/mineral/titanium/purple,/area/ruin/powered/golem_ship)
"C" = (/obj/machinery/light{dir = 1},/turf/simulated/floor/mineral/titanium/purple,/area/ruin/powered/golem_ship)
"D" = (/obj/structure/extinguisher_cabinet{pixel_y = 30},/turf/simulated/floor/mineral/titanium/purple,/area/ruin/powered/golem_ship)
"E" = (/obj/structure/window/full/shuttle{icon_state = "15"},/obj/structure/grille,/turf/simulated/shuttle/plating,/area/ruin/powered/golem_ship)
"F" = (/obj/structure/window/reinforced{dir = 4; pixel_x = 0},/obj/structure/table/wood,/obj/item/bedsheet/rd/royal_cape{layer = 3; pixel_x = 5; pixel_y = 9},/obj/item/book/manual/research_and_development{name = "Sacred Text of the Liberator"; pixel_x = -4; pixel_y = 3},/turf/simulated/shuttle/floor{icon_state = "floor5"},/area/ruin/powered/golem_ship)
"G" = (/obj/machinery/light,/obj/structure/chair/comfy/purp{icon_state = "comfychair"; dir = 1},/turf/simulated/floor/mineral/titanium/purple,/area/ruin/powered/golem_ship)
"H" = (/obj/machinery/light/small,/obj/structure/extinguisher_cabinet{pixel_y = -30},/turf/simulated/floor/mineral/titanium/purple,/area/ruin/powered/golem_ship)
"I" = (/obj/structure/fans/tiny,/obj/machinery/door/airlock/shuttle,/turf/simulated/floor/mineral/titanium/purple,/area/ruin/powered/golem_ship)
"J" = (/turf/simulated/wall/mineral/titanium/interior,/area/ruin/powered/golem_ship)
"K" = (/obj/item/resonator/upgraded,/turf/simulated/floor/mineral/titanium/purple,/area/ruin/powered/golem_ship)
"L" = (/obj/machinery/autolathe,/turf/simulated/floor/mineral/titanium/purple,/area/ruin/powered/golem_ship)
"M" = (/obj/structure/table/wood,/obj/machinery/reagentgrinder,/turf/simulated/floor/mineral/titanium/purple,/area/ruin/powered/golem_ship)
"N" = (/obj/machinery/computer/arcade/orion_trail,/turf/simulated/floor/mineral/titanium/purple,/area/ruin/powered/golem_ship)
"O" = (/obj/machinery/computer/arcade/battle,/turf/simulated/floor/mineral/titanium/purple,/area/ruin/powered/golem_ship)
"P" = (/obj/machinery/light,/turf/simulated/floor/mineral/titanium/purple,/area/ruin/powered/golem_ship)
"Q" = (/obj/machinery/light,/obj/effect/mob_spawn/human/golem/adamantine,/turf/simulated/floor/mineral/titanium/purple,/area/ruin/powered/golem_ship)
"R" = (/obj/machinery/vending/snack/free,/turf/simulated/floor/mineral/titanium/purple,/area/ruin/powered/golem_ship)
"S" = (/obj/structure/table/wood,/obj/item/storage/firstaid/brute,/obj/item/storage/firstaid/brute,/obj/item/storage/firstaid/brute,/turf/simulated/floor/mineral/titanium/purple,/area/ruin/powered/golem_ship)
"T" = (/obj/structure/table/wood,/obj/item/storage/firstaid/fire,/obj/item/storage/firstaid/fire,/obj/item/storage/firstaid/fire,/obj/machinery/light,/turf/simulated/floor/mineral/titanium/purple,/area/ruin/powered/golem_ship)
"U" = (/obj/structure/table/wood,/obj/item/storage/firstaid/adv,/obj/item/storage/firstaid/adv,/turf/simulated/floor/mineral/titanium/purple,/area/ruin/powered/golem_ship)
"V" = (/obj/structure/table/wood,/obj/item/areaeditor/golem,/obj/item/disk/design_disk/golem_shell,/turf/simulated/floor/mineral/titanium/purple,/area/ruin/powered/golem_ship)
"W" = (/obj/machinery/light/small{dir = 1},/turf/simulated/floor/plating,/area/ruin/powered/golem_ship)
"X" = (/obj/structure/reagent_dispensers/fueltank,/turf/simulated/floor/plating,/area/ruin/powered/golem_ship)
"Y" = (/obj/structure/ore_box,/turf/simulated/floor/plating,/area/ruin/powered/golem_ship)
"Z" = (/turf/simulated/wall/mineral/titanium/nodiagonal,/area/ruin/powered/golem_ship)

(1,1,1) = {"
aaaaabbbbbbbbbbccbbb
aaaaabddddddddeffghi
aaaaabffjffjfffjfkhi
aabbbbllbbbbllbbbbbb
aabmnoppqrbspppopthi
aaupppppvvlppppppphi
bbbwwbbbbbbxpppppyZZ
zABppppCpplpppppppDu
EFGppppppplpppppppHI
bbbllJbbbbbxppppKLZZ
aaupppppvvlppppppMhi
aabNOPppQrbRppSTUVhi
aabbbbllbbbbllbbbbbb
aaaaabffWffWfffWfXhi
aaaaabYYYYYYYYeffXhi
aaaaabbbbbbbbbbccbbb
"}
