//MAP CONVERTED BY dmm2tgm.py THIS HEADER COMMENT PREVENTS RECONVERSION, DO NOT REMOVE
"a" = (
/turf/simulated/mineral/volcanic/lava_land_surface,
/area/lavaland/surface/outdoors)
"b" = (
/turf/simulated/floor/plating/asteroid/basalt/lava_land_surface,
/area/lavaland/surface/outdoors)
"m" = (
/turf/simulated/floor/chasm/straight_down/lava_land_surface,
/area/lavaland/surface/outdoors)
"q" = (
/turf/template_noop,
/area/template_noop)

(1,1,1) = {"
q
a
a
a
q
q
q
q
q
q
q
q
q
q
q
q
q
q
q
q
q
q
q
a
a
b
b
b
a
a
a
b
b
b
b
q
q
q
q
q
q
q
q
q
q
q
q
q
q
q
"}
(2,1,1) = {"
a
a
a
a
a
a
a
q
q
a
q
q
q
q
q
q
q
q
a
q
q
q
a
a
b
b
m
b
b
b
m
m
b
a
a
a
a
q
q
a
q
q
q
q
q
q
q
q
q
q
"}
(3,1,1) = {"
a
a
b
b
a
a
a
a
a
a
a
q
a
q
q
q
q
q
q
a
a
q
q
a
a
b
m
m
b
m
m
b
a
a
a
a
a
a
a
q
q
q
q
q
q
q
q
q
q
q
"}
(4,1,1) = {"
q
a
a
m
m
a
a
b
a
a
a
a
a
q
a
q
q
b
b
b
a
a
a
a
a
a
a
m
m
m
b
a
a
a
b
a
a
a
a
a
q
a
q
q
q
q
q
q
q
q
"}
(5,1,1) = {"
q
a
a
b
m
m
m
b
b
b
b
a
a
a
a
a
b
b
b
b
b
a
a
a
b
b
m
m
m
m
m
m
m
b
b
b
b
b
a
a
a
a
a
q
q
a
q
q
q
q
"}
(6,1,1) = {"
a
q
a
a
a
m
m
m
m
m
b
b
b
a
a
a
a
b
b
b
b
a
b
b
m
m
m
m
a
a
m
m
m
m
m
b
b
b
b
b
a
a
a
a
a
q
q
q
q
q
"}
(7,1,1) = {"
q
q
q
a
a
b
a
b
m
m
m
m
m
b
b
a
a
b
b
b
b
a
m
m
m
m
m
a
a
a
b
m
m
m
m
m
m
b
b
a
a
a
a
a
a
a
a
a
a
q
"}
(8,1,1) = {"
q
q
q
q
a
a
a
a
b
m
m
m
m
m
m
b
a
a
b
b
b
m
m
m
m
a
b
a
a
b
b
b
b
m
m
m
m
m
m
b
a
b
a
a
a
a
a
a
q
q
"}
(9,1,1) = {"
q
q
q
a
q
a
a
a
a
a
b
b
m
m
m
m
m
m
b
b
m
m
m
b
b
a
a
a
b
b
b
b
b
b
b
b
m
m
m
m
m
m
b
b
b
b
a
a
a
q
"}
(10,1,1) = {"
q
q
q
q
q
q
a
a
a
a
a
a
b
b
m
m
m
m
m
m
m
b
b
a
a
a
a
a
a
b
b
b
b
b
a
a
b
b
b
m
m
m
m
m
m
b
a
a
a
q
"}
(11,1,1) = {"
q
q
q
q
q
q
q
q
q
a
a
a
b
a
b
a
a
b
m
m
m
m
a
a
a
a
q
a
q
q
q
b
b
a
a
a
b
b
a
b
b
b
b
m
m
m
m
b
a
a
"}
(12,1,1) = {"
q
q
q
q
q
q
q
q
q
a
q
a
a
a
a
a
b
m
m
b
b
m
m
m
a
a
q
q
q
q
q
q
a
a
a
a
a
a
a
a
a
a
a
a
a
a
a
a
a
a
"}
(13,1,1) = {"
q
q
q
q
q
q
q
q
q
q
q
q
a
a
a
b
b
m
b
b
a
a
a
b
b
a
a
q
q
q
q
q
a
q
q
a
q
a
q
q
a
a
a
a
a
a
q
q
a
a
"}
(14,1,1) = {"
q
q
q
q
q
q
q
q
q
q
q
q
q
q
a
a
a
q
a
a
a
q
a
a
a
q
q
q
q
q
q
q
q
q
q
q
q
q
q
q
q
q
q
q
q
q
q
q
q
q
"}
