//MAP CONVERTED BY dmm2tgm.py THIS HEADER COMMENT PREVENTS RECONVERSION, DO NOT REMOVE
"a" = (
/turf/simulated/mineral/random/volcanic/hard,
/area/lavaland/surface/outdoors)
"b" = (
/obj/structure/mirror{
	desc = "This mirror has been shattered. It looks like the bad luck energies spilling from it are taking immediate effect on your surroundings!";
	icon_state = "mirror_broke";
	pixel_x = -28;
	broken = 1
	},
/obj/item/stack/sheet/animalhide/human,
/turf/simulated/floor/wood,
/area/ruin/unpowered/misc_lavaruin)
"c" = (
/obj/effect/decal/cleanable/blood/tracks,
/obj/effect/decal/cleanable/blood,
/turf/simulated/floor/wood{
	icon_state = "wood-broken7";
	tag = "icon-wood-broken7"
	},
/area/ruin/unpowered/misc_lavaruin)
"f" = (
/turf/simulated/floor/plating/asteroid/basalt/lava_land_surface,
/area/lavaland/surface/outdoors)
"h" = (
/obj/item/reagent_containers/food/snacks/meat/human,
/obj/item/candle,
/obj/item/storage/box/matches,
/obj/effect/decal/cleanable/cobweb2,
/obj/structure/table/wood,
/turf/simulated/floor/wood,
/area/ruin/unpowered/misc_lavaruin)
"i" = (
/obj/effect/decal/cleanable/blood,
/turf/simulated/floor/wood{
	icon_state = "wood-broken";
	tag = "icon-wood-broken"
	},
/area/ruin/unpowered/misc_lavaruin)
"k" = (
/obj/structure/mirror{
	desc = "This mirror has been shattered. It looks like the bad luck energies spilling from it are taking immediate effect on your surroundings!";
	icon_state = "mirror_broke";
	pixel_x = 28;
	broken = 1
	},
/obj/structure/kitchenspike,
/obj/effect/decal/cleanable/blood{
	layer = 2.5
	},
/obj/item/reagent_containers/food/snacks/meat/human,
/turf/simulated/floor/wood{
	broken = 1;
	icon_state = "wood-broken"
	},
/area/ruin/unpowered/misc_lavaruin)
"l" = (
/turf/simulated/mineral/random/volcanic/hard/double,
/area/lavaland/surface/outdoors)
"n" = (
/obj/item/clothing/suit/bloated_human,
/obj/item/clothing/head/human_head,
/obj/effect/decal/cleanable/blood,
/obj/effect/decal/cleanable/cobweb2,
/turf/simulated/floor/wood,
/area/ruin/unpowered/misc_lavaruin)
"o" = (
/obj/structure/fans/tiny/invisible,
/obj/effect/decal/cleanable/blood/tracks,
/obj/structure/mineral_door/wood,
/turf/simulated/floor/wood,
/area/ruin/unpowered/misc_lavaruin)
"p" = (
/turf/simulated/floor/wood{
	icon_state = "wood-broken7"
	},
/area/ruin/unpowered/misc_lavaruin)
"t" = (
/obj/structure/mirror{
	desc = "This mirror has been shattered. It looks like the bad luck energies spilling from it are taking immediate effect on your surroundings!";
	icon_state = "mirror_broke";
	pixel_x = -28;
	broken = 1
	},
/turf/simulated/floor/wood{
	icon_state = "wood-broken3";
	tag = "icon-wood-broken3"
	},
/area/ruin/unpowered/misc_lavaruin)
"u" = (
/obj/structure/mirror{
	desc = "This mirror has been shattered. It looks like the bad luck energies spilling from it are taking immediate effect on your surroundings!";
	icon_state = "mirror_broke";
	pixel_x = 28;
	broken = 1
	},
/obj/item/flashlight/lantern,
/obj/effect/decal/cleanable/cobweb2,
/obj/structure/table/wood,
/turf/simulated/floor/wood,
/area/ruin/unpowered/misc_lavaruin)
"x" = (
/obj/structure/railing/wooden/endr,
/turf/simulated/floor/plating/asteroid/basalt/lava_land_surface,
/area/lavaland/surface/outdoors)
"y" = (
/obj/effect/mapping_helpers/no_lava,
/turf/simulated/floor/plating/asteroid/basalt/lava_land_surface,
/area/lavaland/surface/outdoors)
"z" = (
/obj/effect/decal/cleanable/blood/tracks,
/obj/effect/baseturf_helper/lava_land/surface,
/turf/simulated/floor/wood,
/area/ruin/unpowered/misc_lavaruin)
"B" = (
/turf/simulated/floor/wood{
	icon_state = "wood-broken5";
	tag = "icon-wood-broken5"
	},
/area/ruin/unpowered/misc_lavaruin)
"C" = (
/obj/effect/decal/cleanable/blood/tracks,
/turf/simulated/floor/wood{
	icon_state = "wood-broken6";
	tag = "icon-wood-broken6"
	},
/area/ruin/unpowered/misc_lavaruin)
"F" = (
/obj/item/clothing/gloves/ring/gold,
/obj/item/clothing/head/fluff/goldtophat,
/obj/item/clothing/shoes/fluff/noble_boot,
/obj/item/clothing/under/noble_clothes,
/obj/item/clothing/glasses/monocle,
/obj/item/clothing/suit/victcoat,
/obj/structure/closet/cabinet,
/turf/simulated/floor/wood,
/area/ruin/unpowered/misc_lavaruin)
"G" = (
/obj/structure/mineral_door/wood,
/turf/simulated/floor/wood,
/area/ruin/unpowered/misc_lavaruin)
"H" = (
/obj/effect/decal/cleanable/blood,
/turf/simulated/floor/wood,
/area/ruin/unpowered/misc_lavaruin)
"J" = (
/obj/effect/decal/cleanable/blood/tracks,
/obj/effect/mapping_helpers/no_lava,
/turf/simulated/floor/plating/asteroid/basalt/lava_land_surface,
/area/lavaland/surface/outdoors)
"M" = (
/obj/structure/railing/wooden,
/turf/simulated/floor/plating/asteroid/basalt/lava_land_surface,
/area/lavaland/surface/outdoors)
"N" = (
/obj/structure/chair/wood{
	dir = 4
	},
/turf/simulated/floor/wood{
	icon_state = "wood-broken5"
	},
/area/ruin/unpowered/misc_lavaruin)
"Q" = (
/turf/simulated/wall/mineral/wood,
/area/ruin/unpowered/misc_lavaruin)
"R" = (
/obj/item/kitchen/knife/envy,
/obj/effect/decal/cleanable/blood/splatter,
/obj/structure/mirror{
	desc = "This mirror has been shattered. It looks like the bad luck energies spilling from it are taking immediate effect on your surroundings!";
	icon_state = "mirror_broke";
	pixel_x = 28;
	broken = 1
	},
/turf/simulated/floor/wood{
	icon_state = "wood-broken3"
	},
/area/ruin/unpowered/misc_lavaruin)
"T" = (
/obj/effect/decal/cleanable/blood,
/obj/structure/mirror{
	desc = "This mirror has been shattered. It looks like the bad luck energies spilling from it are taking immediate effect on your surroundings!";
	icon_state = "mirror_broke";
	pixel_x = -28;
	broken = 1
	},
/obj/effect/decal/cleanable/cobweb,
/turf/simulated/floor/wood,
/area/ruin/unpowered/misc_lavaruin)
"V" = (
/obj/structure/bookcase,
/obj/effect/decal/cleanable/cobweb,
/obj/item/book/manual/chef_recipes,
/turf/simulated/floor/wood{
	icon_state = "wood-broken6";
	tag = "icon-wood-broken6"
	},
/area/ruin/unpowered/misc_lavaruin)
"W" = (
/obj/structure/railing/wooden/endl,
/turf/simulated/floor/plating/asteroid/basalt/lava_land_surface,
/area/lavaland/surface/outdoors)
"X" = (
/obj/effect/mob_spawn/human/corpse,
/turf/simulated/floor/plating/asteroid/basalt/lava_land_surface,
/area/lavaland/surface/outdoors)

(1,1,1) = {"
f
f
a
a
a
a
a
a
f
f
"}
(2,1,1) = {"
a
a
l
l
l
a
a
a
a
f
"}
(3,1,1) = {"
a
a
l
Q
Q
Q
Q
Q
x
f
"}
(4,1,1) = {"
a
l
Q
Q
T
t
b
Q
W
y
"}
(5,1,1) = {"
a
l
Q
n
c
z
C
o
J
y
"}
(6,1,1) = {"
a
l
Q
Q
u
H
k
Q
x
f
"}
(7,1,1) = {"
a
a
l
Q
Q
G
Q
Q
M
f
"}
(8,1,1) = {"
f
a
l
Q
V
H
F
Q
M
f
"}
(9,1,1) = {"
f
a
l
Q
N
B
i
Q
M
f
"}
(10,1,1) = {"
f
a
l
Q
h
H
p
Q
M
f
"}
(11,1,1) = {"
f
a
a
Q
Q
R
Q
Q
M
f
"}
(12,1,1) = {"
f
f
a
l
Q
Q
Q
X
W
a
"}
(13,1,1) = {"
f
f
a
a
a
a
a
a
a
a
"}
(14,1,1) = {"
f
f
f
a
a
a
a
a
a
f
"}
