//MAP CONVERTED BY dmm2tgm.py THIS HEADER COMMENT PREVENTS RECONVERSION, DO NOT REMOVE
"a" = (
/turf/template_noop,
/area/template_noop)
"b" = (
/obj/structure/alien/weeds,
/obj/structure/alien/resin/wall,
/turf/simulated/floor/plating/asteroid/basalt/lava_land_surface,
/area/ruin/unpowered/aliennest)
"c" = (
/obj/structure/alien/weeds,
/obj/effect/baseturf_helper/lava_land/surface,
/turf/simulated/floor/plating/asteroid/basalt/lava_land_surface,
/area/ruin/unpowered/aliennest)
"d" = (
/obj/structure/alien/resin/wall,
/obj/structure/alien/weeds,
/turf/simulated/floor/plating/asteroid/basalt/lava_land_surface,
/area/ruin/unpowered/aliennest)
"e" = (
/obj/structure/alien/weeds,
/obj/structure/alien/egg/burst,
/turf/simulated/floor/plating/asteroid/basalt/lava_land_surface,
/area/ruin/unpowered/aliennest)
"f" = (
/obj/structure/alien/weeds,
/obj/structure/alien/weeds,
/turf/simulated/floor/plating/asteroid/basalt/lava_land_surface,
/area/ruin/unpowered/aliennest)
"g" = (
/obj/structure/alien/weeds,
/turf/simulated/floor/plating/asteroid/basalt/lava_land_surface,
/area/ruin/unpowered/aliennest)
"i" = (
/obj/structure/alien/weeds,
/obj/structure/bed/nest,
/turf/simulated/floor/plating/asteroid/basalt/lava_land_surface,
/area/ruin/unpowered/aliennest)
"j" = (
/obj/structure/alien/weeds,
/mob/living/simple_animal/hostile/alien,
/turf/simulated/floor/plating/asteroid/basalt/lava_land_surface,
/area/ruin/unpowered/aliennest)
"l" = (
/obj/structure/alien/weeds/node,
/turf/simulated/floor/plating/asteroid/basalt/lava_land_surface,
/area/ruin/unpowered/aliennest)
"o" = (
/obj/structure/alien/weeds,
/obj/structure/bed/nest,
/obj/effect/decal/cleanable/blood/gibs,
/obj/item/gun/projectile/automatic/pistol,
/turf/simulated/floor/plating/asteroid/basalt/lava_land_surface,
/area/ruin/unpowered/aliennest)
"r" = (
/obj/structure/alien/weeds,
/obj/structure/alien/resin/wall,
/obj/structure/alien/resin/wall,
/turf/simulated/floor/plating/asteroid/basalt/lava_land_surface,
/area/ruin/unpowered/aliennest)
"t" = (
/obj/structure/alien/weeds,
/mob/living/simple_animal/hostile/alien/sentinel,
/turf/simulated/floor/plating/asteroid/basalt/lava_land_surface,
/area/ruin/unpowered/aliennest)
"u" = (
/obj/structure/alien/weeds,
/obj/effect/decal/cleanable/blood/gibs,
/turf/simulated/floor/plating/asteroid/basalt/lava_land_surface,
/area/ruin/unpowered/aliennest)
"v" = (
/obj/structure/alien/weeds/node,
/obj/effect/decal/cleanable/blood,
/turf/simulated/floor/plating/asteroid/basalt/lava_land_surface,
/area/ruin/unpowered/aliennest)
"w" = (
/obj/structure/alien/weeds,
/obj/structure/bed/nest,
/obj/structure/alien/resin/wall,
/turf/simulated/floor/plating/asteroid/basalt/lava_land_surface,
/area/ruin/unpowered/aliennest)
"y" = (
/obj/structure/alien/weeds/node,
/obj/structure/alien/resin/wall,
/turf/simulated/floor/plating/asteroid/basalt/lava_land_surface,
/area/ruin/unpowered/aliennest)
"z" = (
/obj/structure/alien/weeds,
/obj/structure/bed/nest,
/obj/effect/decal/cleanable/blood/gibs,
/obj/item/clothing/under/rank/security/officer,
/obj/item/clothing/suit/armor/vest,
/obj/item/melee/baton/loaded,
/obj/item/clothing/head/helmet,
/turf/simulated/floor/plating/asteroid/basalt/lava_land_surface,
/area/ruin/unpowered/aliennest)
"B" = (
/obj/structure/alien/weeds,
/obj/structure/alien/egg/burst,
/obj/effect/decal/cleanable/blood/gibs,
/turf/simulated/floor/plating/asteroid/basalt/lava_land_surface,
/area/ruin/unpowered/aliennest)
"C" = (
/obj/structure/alien/weeds,
/obj/structure/alien/egg/burst,
/obj/effect/decal/cleanable/blood,
/turf/simulated/floor/plating/asteroid/basalt/lava_land_surface,
/area/ruin/unpowered/aliennest)
"E" = (
/obj/structure/alien/weeds,
/mob/living/simple_animal/hostile/alien/drone{
	plants_off = 1
	},
/turf/simulated/floor/plating/asteroid/basalt/lava_land_surface,
/area/ruin/unpowered/aliennest)
"F" = (
/obj/structure/alien/weeds,
/mob/living/simple_animal/hostile/alien/queen/large{
	desc = "A gigantic alien who is in charge of the hive and all of its loyal servants.";
	name = "alien queen";
	pixel_x = -16;
	plants_off = 1
	},
/turf/simulated/floor/plating/asteroid/basalt/lava_land_surface,
/area/ruin/unpowered/aliennest)
"G" = (
/turf/simulated/floor/plating/lava/smooth/lava_land_surface,
/area/lavaland/surface/outdoors)
"H" = (
/obj/structure/alien/weeds,
/obj/effect/decal/cleanable/blood,
/turf/simulated/floor/plating/asteroid/basalt/lava_land_surface,
/area/ruin/unpowered/aliennest)
"I" = (
/obj/structure/alien/weeds,
/obj/structure/bed/nest,
/obj/effect/decal/cleanable/blood/gibs,
/obj/effect/decal/cleanable/blood,
/obj/item/clothing/under/syndicate,
/obj/item/clothing/glasses/night,
/turf/simulated/floor/plating/asteroid/basalt/lava_land_surface,
/area/ruin/unpowered/aliennest)
"K" = (
/obj/structure/alien/weeds/node,
/mob/living/simple_animal/hostile/alien,
/turf/simulated/floor/plating/asteroid/basalt/lava_land_surface,
/area/ruin/unpowered/aliennest)
"L" = (
/obj/structure/alien/weeds/node,
/mob/living/simple_animal/hostile/alien/drone{
	plants_off = 1
	},
/turf/simulated/floor/plating/asteroid/basalt/lava_land_surface,
/area/ruin/unpowered/aliennest)
"M" = (
/obj/structure/alien/weeds,
/obj/structure/bed/nest,
/obj/effect/decal/cleanable/blood/gibs,
/obj/item/tank/internals/emergency_oxygen,
/obj/item/clothing/suit/space/syndicate/orange,
/obj/item/clothing/mask/gas,
/obj/item/clothing/head/helmet/space/syndicate/orange,
/turf/simulated/floor/plating/asteroid/basalt/lava_land_surface,
/area/ruin/unpowered/aliennest)
"O" = (
/obj/structure/alien/weeds/node,
/turf/template_noop,
/area/ruin/unpowered/aliennest)
"Q" = (
/obj/structure/alien/weeds,
/obj/effect/decal/cleanable/blood,
/mob/living/simple_animal/hostile/alien/drone{
	plants_off = 1
	},
/turf/simulated/floor/plating/asteroid/basalt/lava_land_surface,
/area/ruin/unpowered/aliennest)
"R" = (
/obj/structure/alien/weeds,
/turf/template_noop,
/area/ruin/unpowered/aliennest)

(1,1,1) = {"
a
a
a
G
G
G
G
G
G
G
G
G
G
a
a
a
a
a
a
a
a
a
a
a
a
a
a
a
a
a
"}
(2,1,1) = {"
a
a
a
G
b
b
b
b
b
b
b
b
G
G
a
a
a
a
a
a
a
a
a
a
a
a
a
a
a
a
"}
(3,1,1) = {"
a
a
G
G
b
g
e
e
b
g
g
b
b
G
a
a
a
a
a
a
a
a
a
a
a
a
a
a
a
a
"}
(4,1,1) = {"
a
a
G
b
b
g
g
g
g
E
g
e
b
G
a
a
a
a
a
a
a
a
a
a
a
a
a
a
a
a
"}
(5,1,1) = {"
a
a
G
b
g
g
y
b
b
b
y
b
b
G
a
a
a
a
a
a
a
a
a
a
a
a
a
a
a
a
"}
(6,1,1) = {"
a
a
G
b
g
g
w
g
F
u
I
b
b
G
a
a
a
a
a
a
a
a
a
a
a
a
a
a
a
a
"}
(7,1,1) = {"
a
a
G
b
e
t
g
g
g
H
u
g
b
G
a
a
a
a
a
a
a
a
a
a
a
a
a
a
a
a
"}
(8,1,1) = {"
a
a
G
b
i
u
b
g
l
g
t
e
b
G
a
a
a
a
a
a
a
a
a
a
a
a
a
a
a
a
"}
(9,1,1) = {"
a
a
G
b
o
v
g
b
g
g
e
b
b
G
a
a
a
a
a
a
a
a
a
a
a
a
a
a
a
a
"}
(10,1,1) = {"
a
a
G
b
g
u
b
g
g
g
y
e
b
G
a
a
a
a
a
a
a
a
a
a
a
a
a
a
a
a
"}
(11,1,1) = {"
a
a
G
b
b
g
t
g
g
t
g
g
b
G
a
a
a
a
a
a
a
a
a
a
a
b
b
b
b
a
"}
(12,1,1) = {"
a
a
G
G
b
e
g
g
g
g
g
g
b
G
a
a
a
a
a
a
a
a
a
a
b
b
M
i
b
b
"}
(13,1,1) = {"
a
a
a
G
b
b
g
g
l
g
g
b
b
G
a
a
a
a
a
a
a
a
a
b
b
e
u
Q
g
b
"}
(14,1,1) = {"
a
a
a
G
G
b
b
g
g
g
b
b
G
G
a
a
a
a
a
a
a
a
a
b
i
g
l
g
e
b
"}
(15,1,1) = {"
a
a
a
a
G
G
b
b
b
b
b
G
G
a
a
a
a
a
a
a
a
b
b
b
g
g
g
i
b
b
"}
(16,1,1) = {"
a
a
a
a
a
G
b
l
l
b
G
G
a
a
a
a
a
a
a
a
b
b
g
j
g
e
b
b
b
a
"}
(17,1,1) = {"
a
a
a
a
a
a
b
E
g
b
b
G
b
b
b
b
b
b
b
b
b
g
g
b
b
b
b
a
a
a
"}
(18,1,1) = {"
a
a
a
a
a
a
b
g
g
E
b
b
b
g
g
g
g
g
g
b
b
g
b
b
a
a
a
a
a
a
"}
(19,1,1) = {"
a
a
a
a
a
a
b
b
g
g
g
b
g
g
c
g
g
g
l
g
g
g
b
a
a
a
a
a
a
a
"}
(20,1,1) = {"
b
b
b
b
a
a
a
b
b
g
l
g
g
g
b
b
b
b
g
g
g
b
b
a
a
a
a
a
a
a
"}
(21,1,1) = {"
b
e
i
b
b
b
b
b
b
g
g
g
g
b
b
a
a
b
b
g
g
b
a
a
a
a
a
a
a
a
"}
(22,1,1) = {"
d
f
j
g
b
b
g
g
g
g
g
g
b
b
a
a
a
b
g
g
g
b
a
a
a
a
a
a
a
a
"}
(23,1,1) = {"
d
g
e
l
g
g
g
b
b
g
b
b
b
a
a
a
a
b
g
g
b
b
a
a
a
a
a
a
a
a
"}
(24,1,1) = {"
b
b
i
i
b
b
b
b
b
g
b
a
a
a
a
a
a
b
g
g
b
a
a
a
a
a
a
a
a
a
"}
(25,1,1) = {"
a
b
b
b
b
a
a
a
b
E
b
b
a
a
a
a
a
b
g
L
b
b
b
a
a
a
a
a
a
b
"}
(26,1,1) = {"
a
a
a
a
a
a
a
a
b
g
g
b
a
a
a
a
a
b
g
g
g
g
b
b
b
a
a
a
b
b
"}
(27,1,1) = {"
a
a
a
a
a
a
b
b
b
g
g
b
b
a
a
a
a
b
b
g
g
g
g
g
b
b
b
b
y
g
"}
(28,1,1) = {"
a
a
a
a
a
b
b
B
g
g
l
e
b
a
a
a
b
b
g
g
b
b
g
g
g
b
O
R
g
g
"}
(29,1,1) = {"
a
a
a
a
a
b
z
C
j
g
e
i
b
a
a
a
b
g
g
b
b
b
b
g
l
b
O
R
g
g
"}
(30,1,1) = {"
a
a
a
a
a
b
i
u
g
i
i
b
b
a
a
a
b
g
b
b
a
a
b
b
b
b
b
y
g
g
"}
(31,1,1) = {"
a
a
a
a
a
b
b
b
g
b
b
b
a
a
a
a
b
g
b
b
a
a
a
a
a
a
a
b
g
g
"}
(32,1,1) = {"
a
a
a
a
a
a
a
b
g
b
a
a
a
a
a
a
b
g
g
b
a
a
a
a
a
a
a
b
g
g
"}
(33,1,1) = {"
a
a
a
a
a
a
a
b
g
b
a
a
a
a
a
a
b
b
l
b
a
a
a
a
a
a
b
b
g
a
"}
(34,1,1) = {"
a
a
a
a
a
a
a
b
l
b
a
a
a
a
a
a
a
b
g
b
a
a
a
a
a
a
b
a
a
a
"}
(35,1,1) = {"
a
a
a
a
a
a
a
b
g
b
a
a
a
a
a
a
a
b
g
b
a
a
a
a
a
a
a
a
a
a
"}
(36,1,1) = {"
a
a
a
a
a
a
a
b
g
b
a
a
a
a
a
a
b
b
g
b
a
a
a
a
a
a
a
a
a
a
"}
(37,1,1) = {"
a
a
a
a
a
a
a
b
g
b
a
a
a
a
a
b
b
g
g
b
a
a
a
a
a
a
a
a
a
a
"}
(38,1,1) = {"
a
a
a
a
a
a
b
b
g
b
b
b
b
b
b
b
g
g
b
b
a
a
a
a
a
a
a
a
a
a
"}
(39,1,1) = {"
a
a
a
a
a
b
b
g
g
e
b
b
g
g
K
g
g
b
b
a
a
a
a
a
a
a
a
a
a
a
"}
(40,1,1) = {"
a
a
a
a
a
b
i
E
g
g
g
g
g
b
b
b
b
b
a
a
a
a
a
a
a
a
a
a
a
a
"}
(41,1,1) = {"
a
a
a
a
b
b
e
g
l
g
e
b
b
b
a
a
a
a
a
a
a
a
a
a
a
a
a
a
a
a
"}
(42,1,1) = {"
a
a
a
a
b
e
g
g
i
i
b
b
a
a
a
a
a
a
a
a
a
a
a
a
a
a
a
a
a
a
"}
(43,1,1) = {"
a
a
a
a
r
b
b
b
b
b
b
a
a
a
a
a
a
a
a
a
a
a
a
a
a
a
a
a
a
a
"}
