//MAP CONVERTED BY dmm2tgm.py THIS HEADER COMMENT PREVENTS RECONVERSION, DO NOT REMOVE
"a" = (
/turf/template_noop,
/area/template_noop)
"c" = (
/obj/structure/lattice,
/turf/simulated/floor/plating/asteroid/basalt/lava_land_surface,
/area/lavaland/surface/outdoors)
"d" = (
/turf/simulated/wall,
/area/ruin/powered/pizza_party)
"e" = (
/obj/effect/decal/cleanable/dirt,
/turf/simulated/floor/plating/lavaland_air,
/area/ruin/powered/pizza_party)
"f" = (
/obj/structure/table/wood,
/obj/item/storage/box/cups,
/turf/simulated/floor/wood/lavaland_air,
/area/ruin/powered/pizza_party)
"g" = (
/obj/structure/reagent_dispensers/water_cooler/pizzaparty,
/obj/effect/decal/cleanable/dirt,
/turf/simulated/floor/wood/lavaland_air,
/area/ruin/powered/pizza_party)
"h" = (
/obj/effect/decal/cleanable/dirt,
/turf/simulated/floor/wood/lavaland_air,
/area/ruin/powered/pizza_party)
"i" = (
/obj/effect/decal/cleanable/dirt,
/obj/effect/decal/cleanable/dirt,
/turf/simulated/floor/wood/lavaland_air,
/area/ruin/powered/pizza_party)
"j" = (
/obj/item/food/sliced/mushroom_pizza,
/obj/effect/decal/cleanable/dirt,
/turf/simulated/floor/plating/lavaland_air,
/area/ruin/powered/pizza_party)
"k" = (
/obj/structure/table/wood,
/obj/effect/spawner/random/pizzaparty,
/obj/effect/decal/cleanable/dirt,
/turf/simulated/floor/wood/lavaland_air,
/area/ruin/powered/pizza_party)
"l" = (
/obj/machinery/light{
	dir = 4
	},
/obj/structure/table/wood,
/obj/effect/spawner/random/pizzaparty,
/obj/effect/decal/cleanable/dirt,
/obj/effect/decal/cleanable/cobweb2,
/turf/simulated/floor/wood/lavaland_air,
/area/ruin/powered/pizza_party)
"m" = (
/obj/item/chair/wood/wings,
/obj/effect/decal/cleanable/dirt,
/turf/simulated/floor/plating/lavaland_air,
/area/ruin/powered/pizza_party)
"n" = (
/obj/structure/glowshroom,
/obj/effect/decal/cleanable/dirt,
/turf/simulated/floor/wood/lavaland_air,
/area/ruin/powered/pizza_party)
"o" = (
/obj/item/trash/plate,
/obj/effect/decal/cleanable/dirt,
/turf/simulated/floor/wood/lavaland_air,
/area/ruin/powered/pizza_party)
"p" = (
/obj/effect/decal/remains/human,
/obj/effect/decal/cleanable/dirt,
/turf/simulated/floor/wood/lavaland_air,
/area/ruin/powered/pizza_party)
"q" = (
/obj/item/chair/wood/wings,
/obj/effect/decal/cleanable/dirt,
/turf/simulated/floor/wood/lavaland_air,
/area/ruin/powered/pizza_party)
"r" = (
/obj/structure/chair/wood/wings,
/obj/effect/decal/remains/human,
/obj/item/clothing/head/festive{
	desc = "A festive party hat with the name 'timmy' scribbled on the front.";
	name = "party hat"
	},
/turf/simulated/floor/wood/lavaland_air,
/area/ruin/powered/pizza_party)
"s" = (
/turf/simulated/floor/wood/lavaland_air,
/area/ruin/powered/pizza_party)
"t" = (
/obj/structure/chair/wood/wings,
/obj/effect/decal/remains/human,
/turf/simulated/floor/wood/lavaland_air,
/area/ruin/powered/pizza_party)
"u" = (
/obj/structure/glowshroom,
/turf/simulated/floor/wood/lavaland_air,
/area/ruin/powered/pizza_party)
"v" = (
/obj/structure/lattice,
/obj/item/chair/wood/wings,
/turf/simulated/floor/plating/asteroid/basalt/lava_land_surface,
/area/lavaland/surface/outdoors)
"w" = (
/obj/item/kitchen/utensil/fork,
/obj/effect/decal/cleanable/dirt,
/turf/simulated/floor/wood/lavaland_air,
/area/ruin/powered/pizza_party)
"x" = (
/obj/structure/table/wood,
/obj/effect/spawner/random/pizzaparty,
/turf/simulated/floor/wood/lavaland_air,
/area/ruin/powered/pizza_party)
"y" = (
/obj/structure/table/wood,
/obj/item/trash/plate,
/turf/simulated/floor/wood/lavaland_air,
/area/ruin/powered/pizza_party)
"z" = (
/obj/structure/table/wood,
/obj/structure/glowshroom,
/obj/item/a_gift,
/turf/simulated/floor/wood/lavaland_air,
/area/ruin/powered/pizza_party)
"A" = (
/obj/structure/table/wood,
/obj/item/trash/plate,
/obj/item/kitchen/utensil/fork,
/turf/simulated/floor/wood/lavaland_air,
/area/ruin/powered/pizza_party)
"B" = (
/obj/effect/baseturf_helper/lava/mapping_lava,
/turf/simulated/floor/wood/lavaland_air,
/area/ruin/powered/pizza_party)
"C" = (
/obj/structure/chair/wood/wings{
	dir = 4
	},
/obj/effect/decal/cleanable/dirt,
/turf/simulated/floor/plating/lavaland_air,
/area/ruin/powered/pizza_party)
"D" = (
/obj/structure/table/wood,
/obj/item/food/sliced/margherita_pizza,
/obj/item/trash/plate,
/turf/simulated/floor/wood/lavaland_air,
/area/ruin/powered/pizza_party)
"E" = (
/obj/structure/table/wood,
/obj/item/food/sliced/meat_pizza,
/turf/simulated/floor/wood/lavaland_air,
/area/ruin/powered/pizza_party)
"F" = (
/obj/structure/table/wood,
/obj/item/food/sliceable/birthdaycake,
/turf/simulated/floor/wood/lavaland_air,
/area/ruin/powered/pizza_party)
"G" = (
/obj/structure/table/wood,
/turf/simulated/floor/wood/lavaland_air,
/area/ruin/powered/pizza_party)
"H" = (
/obj/item/chair/wood/wings,
/turf/simulated/floor/wood/lavaland_air,
/area/ruin/powered/pizza_party)
"I" = (
/obj/item/kitchen/utensil/fork,
/obj/effect/decal/cleanable/dirt,
/turf/simulated/floor/plating/lavaland_air,
/area/ruin/powered/pizza_party)
"J" = (
/obj/structure/glowshroom,
/obj/effect/decal/cleanable/dirt,
/turf/simulated/floor/plating/lavaland_air,
/area/ruin/powered/pizza_party)
"K" = (
/obj/structure/chair/wood/wings{
	dir = 1
	},
/obj/effect/decal/remains/human,
/obj/effect/decal/cleanable/dirt,
/turf/simulated/floor/wood/lavaland_air,
/area/ruin/powered/pizza_party)
"L" = (
/obj/effect/decal/cleanable/dirt,
/obj/effect/decal/cleanable/dirt,
/turf/simulated/floor/plating/lavaland_air,
/area/ruin/powered/pizza_party)
"M" = (
/obj/effect/decal/cleanable/dirt,
/obj/item/a_gift,
/turf/simulated/floor/wood/lavaland_air,
/area/ruin/powered/pizza_party)
"N" = (
/obj/structure/lattice,
/obj/effect/decal/cleanable/dirt,
/turf/simulated/floor/plating/asteroid/basalt/lava_land_surface,
/area/lavaland/surface/outdoors)
"O" = (
/obj/item/kitchen/knife,
/obj/effect/decal/cleanable/dirt,
/turf/simulated/floor/wood/lavaland_air,
/area/ruin/powered/pizza_party)
"P" = (
/obj/machinery/light{
	dir = 4
	},
/obj/effect/decal/cleanable/dirt,
/turf/simulated/floor/wood/lavaland_air,
/area/ruin/powered/pizza_party)
"Q" = (
/turf/simulated/floor/plating/lavaland_air,
/area/ruin/powered/pizza_party)
"Y" = (
/turf/simulated/floor/plating/asteroid/basalt/lava_land_surface,
/area/lavaland/surface/outdoors)

(1,1,1) = {"
a
a
Y
Y
a
a
Y
Y
Y
Y
Y
Y
Y
Y
a
a
a
a
"}
(2,1,1) = {"
Y
Y
Y
Y
Y
Y
Y
Y
Y
Y
c
c
Y
Y
Y
Y
a
a
"}
(3,1,1) = {"
Y
Y
Y
Y
Y
Y
Y
Y
c
c
e
e
c
c
Y
Y
Y
a
"}
(4,1,1) = {"
Y
Y
Y
Y
d
Y
c
c
e
h
h
e
Q
e
d
Y
Y
a
"}
(5,1,1) = {"
a
Y
Y
Y
d
Y
m
e
w
h
w
h
h
e
d
Y
Y
Y
"}
(6,1,1) = {"
a
Y
Y
Y
d
f
n
h
h
c
e
M
e
c
Y
Y
Y
Y
"}
(7,1,1) = {"
Y
Y
Y
Y
d
g
o
h
h
C
J
h
d
Y
Y
Y
Y
Y
"}
(8,1,1) = {"
Y
Y
Y
Y
e
h
p
q
x
D
K
M
d
Y
Y
Y
Y
Y
"}
(9,1,1) = {"
Y
Y
Y
c
e
i
h
r
y
E
h
h
c
Y
Y
Y
Y
Y
"}
(10,1,1) = {"
Y
Y
Y
c
e
j
h
s
z
F
q
N
c
Y
Y
Y
Y
Y
"}
(11,1,1) = {"
Y
Y
Y
Y
e
e
h
t
A
G
q
h
c
Y
Y
Y
Y
Y
"}
(12,1,1) = {"
Y
Y
Y
Y
d
k
h
s
B
H
h
O
d
Y
Y
Y
Y
Y
"}
(13,1,1) = {"
Y
Y
Y
Y
d
k
h
u
s
s
o
n
d
Y
Y
Y
Y
a
"}
(14,1,1) = {"
Y
Y
Y
Y
d
l
i
h
e
I
L
P
d
Y
Y
Y
Y
a
"}
(15,1,1) = {"
Y
Y
Y
Y
d
d
e
e
N
e
e
d
d
Y
Y
Y
Y
a
"}
(16,1,1) = {"
a
Y
Y
Y
Y
Y
c
v
Y
c
Y
Y
Y
Y
Y
Y
Y
a
"}
(17,1,1) = {"
a
Y
Y
Y
Y
Y
Y
Y
Y
Y
Y
Y
Y
Y
Y
a
a
a
"}
(18,1,1) = {"
a
a
a
a
Y
Y
Y
Y
Y
Y
Y
Y
a
a
a
a
a
a
"}
