//MAP CONVERTED BY dmm2tgm.py THIS HEADER COMMENT PREVENTS RECONVERSION, DO NOT REMOVE
"a" = (
/turf/template_noop,
/area/template_noop)
"b" = (
/turf/simulated/floor/plating/asteroid/basalt/lava_land_surface,
/area/lavaland/surface/outdoors/unexplored)
"d" = (
/obj/structure/clockwork/wall_gear,
/turf/simulated/floor/plating/asteroid/basalt/lava_land_surface,
/area/lavaland/surface/outdoors/unexplored)
"f" = (
/turf/simulated/mineral/volcanic/lava_land_surface,
/area/lavaland/surface/outdoors/unexplored)
"h" = (
/turf/simulated/floor/clockwork{
	oxygen = 14;
	nitrogen = 23;
	temperature = 300
	},
/area/lavaland/surface/outdoors/unexplored)
"i" = (
/obj/structure/grille/ratvar/broken,
/turf/simulated/floor/plating/asteroid/basalt/lava_land_surface,
/area/lavaland/surface/outdoors/unexplored)
"j" = (
/turf/simulated/wall/clockwork,
/area/lavaland/surface/outdoors/unexplored)
"l" = (
/turf/simulated/floor/plating/lava/smooth/lava_land_surface,
/area/lavaland/surface/outdoors/unexplored)
"q" = (
/obj/structure/lattice/catwalk/clockwork,
/turf/simulated/floor/plating/lava/smooth/lava_land_surface,
/area/lavaland/surface/outdoors/unexplored)
"r" = (
/obj/structure/lattice/clockwork,
/turf/simulated/floor/plating/asteroid/basalt/lava_land_surface,
/area/lavaland/surface/outdoors/unexplored)
"u" = (
/obj/structure/grille/ratvar,
/turf/simulated/floor/clockwork{
	oxygen = 14;
	nitrogen = 23;
	temperature = 300
	},
/area/lavaland/surface/outdoors/unexplored)
"w" = (
/obj/structure/grille/ratvar/broken,
/turf/simulated/floor/clockwork{
	oxygen = 14;
	nitrogen = 23;
	temperature = 300
	},
/area/lavaland/surface/outdoors/unexplored)
"z" = (
/obj/structure/clockwork/wall_gear,
/turf/simulated/floor/clockwork{
	oxygen = 14;
	nitrogen = 23;
	temperature = 300
	},
/area/lavaland/surface/outdoors/unexplored)
"D" = (
/obj/structure/grille/ratvar,
/turf/simulated/floor/plating/asteroid/basalt/lava_land_surface,
/area/lavaland/surface/outdoors/unexplored)
"F" = (
/obj/structure/dead_ratvar,
/turf/simulated/floor/clockwork{
	oxygen = 14;
	nitrogen = 23;
	temperature = 300
	},
/area/lavaland/surface/outdoors/unexplored)

(1,1,1) = {"
a
a
a
a
a
a
a
a
a
a
a
a
a
b
h
h
b
a
a
a
a
a
a
a
"}
(2,1,1) = {"
a
a
a
a
a
a
a
b
b
a
h
b
r
b
j
z
b
b
b
a
a
a
a
a
"}
(3,1,1) = {"
a
a
a
a
a
a
f
b
l
b
r
b
h
w
j
j
b
l
b
b
a
a
a
a
"}
(4,1,1) = {"
a
a
a
a
a
a
f
l
l
r
b
b
l
j
j
j
h
l
b
h
b
r
a
a
"}
(5,1,1) = {"
a
a
a
a
a
b
l
l
h
h
b
l
l
l
j
l
b
l
l
D
h
r
a
a
"}
(6,1,1) = {"
a
a
a
h
b
h
b
l
l
b
l
l
l
l
w
l
l
l
b
b
h
f
a
a
"}
(7,1,1) = {"
a
a
b
b
b
l
l
l
l
h
b
l
l
l
l
l
l
l
l
b
f
f
b
a
"}
(8,1,1) = {"
a
h
h
b
b
b
l
l
l
l
b
h
r
l
l
b
l
l
l
l
f
b
a
a
"}
(9,1,1) = {"
a
b
b
b
b
l
l
l
l
b
h
b
h
w
h
b
b
l
l
b
b
b
b
a
"}
(10,1,1) = {"
b
h
l
l
l
l
l
l
b
b
h
r
F
b
h
h
b
l
l
l
b
l
l
a
"}
(11,1,1) = {"
b
i
j
j
l
l
l
l
l
b
h
h
h
h
h
r
l
l
l
l
l
l
b
a
"}
(12,1,1) = {"
d
j
j
j
h
l
l
b
l
q
r
h
h
h
b
q
l
b
l
l
b
h
b
a
"}
(13,1,1) = {"
h
h
b
l
l
l
b
h
h
r
h
h
h
h
h
h
h
l
l
l
l
b
b
a
"}
(14,1,1) = {"
b
b
b
b
l
l
l
b
h
h
h
h
h
h
h
h
b
b
l
l
b
b
h
b
"}
(15,1,1) = {"
b
b
b
l
l
l
l
h
h
h
h
h
h
h
h
h
h
l
l
l
l
b
b
a
"}
(16,1,1) = {"
f
l
l
l
l
l
l
q
b
h
h
h
h
h
h
h
b
l
l
l
l
f
f
a
"}
(17,1,1) = {"
b
b
b
l
l
l
b
l
q
r
h
h
h
h
h
b
h
r
l
r
l
l
b
a
"}
(18,1,1) = {"
b
h
l
l
l
b
b
h
b
h
h
h
h
h
r
h
b
h
r
h
b
b
b
b
"}
(19,1,1) = {"
b
b
l
l
l
l
h
b
h
h
h
h
h
h
h
r
j
h
b
h
r
h
b
b
"}
(20,1,1) = {"
b
l
l
l
l
b
b
h
h
b
h
h
h
h
b
b
l
l
l
b
b
r
b
b
"}
(21,1,1) = {"
b
b
l
l
l
l
l
r
h
r
h
h
h
h
h
l
l
l
l
l
l
j
j
r
"}
(22,1,1) = {"
b
b
b
l
l
b
h
h
b
b
h
h
h
h
h
b
b
l
l
l
h
j
j
j
"}
(23,1,1) = {"
b
h
b
b
b
h
l
b
j
u
r
h
h
r
h
b
l
l
l
b
b
w
r
b
"}
(24,1,1) = {"
a
a
b
b
l
l
l
j
j
q
h
h
b
h
z
j
j
l
l
b
l
l
b
a
"}
(25,1,1) = {"
a
a
a
l
l
l
l
j
l
l
b
h
r
z
h
l
l
l
l
l
l
a
a
a
"}
(26,1,1) = {"
a
a
a
b
b
l
l
l
l
l
l
b
q
b
h
l
l
l
b
b
b
a
a
a
"}
(27,1,1) = {"
a
a
a
b
h
b
l
l
l
l
l
l
l
l
l
l
l
l
l
b
a
a
a
a
"}
(28,1,1) = {"
a
a
a
a
b
b
l
b
l
l
l
l
l
l
l
l
b
l
f
a
a
a
a
a
"}
(29,1,1) = {"
a
a
a
a
b
b
f
b
b
l
b
l
l
l
l
b
b
l
b
a
a
a
a
a
"}
(30,1,1) = {"
a
a
a
a
a
b
b
b
l
l
b
b
l
b
l
f
b
a
a
a
a
a
a
a
"}
(31,1,1) = {"
a
a
a
a
a
a
a
b
l
b
a
b
l
b
f
f
a
a
a
a
a
a
a
a
"}
(32,1,1) = {"
a
a
a
a
a
a
a
a
a
a
a
a
a
a
b
a
a
a
a
a
a
a
a
a
"}
