//MAP CONVERTED BY dmm2tgm.py THIS HEADER COMMENT PREVENTS RECONVERSION, DO NOT REMOVE
"a" = (
/turf/simulated/floor/plating/asteroid/basalt/lava_land_surface,
/area/space)
"l" = (
/turf/space,
/area/space)
"u" = (
/turf/simulated/floor/plasteel{
	dir = 1;
	icon_state = "darkfull"
	},
/area/space)
"B" = (
/turf/simulated/floor/lava/mapping_lava,
/area/space)

(1,1,1) = {"
a
a
a
a
a
a
a
a
a
a
a
a
a
a
a
a
a
a
a
a
a
a
a
a
a
a
a
a
a
a
a
a
a
a
a
a
a
a
a
a
"}
(2,1,1) = {"
a
a
a
a
a
a
a
a
a
a
a
a
a
a
a
a
a
a
a
a
a
a
a
a
a
a
a
a
a
a
a
a
a
a
a
a
a
a
a
a
"}
(3,1,1) = {"
a
a
a
a
a
a
a
a
a
a
a
a
a
a
a
a
a
a
a
a
a
a
a
a
a
a
a
a
a
a
a
a
a
a
a
a
a
a
a
a
"}
(4,1,1) = {"
a
a
a
a
a
a
a
a
a
a
a
a
a
a
a
a
a
a
a
a
a
a
a
a
a
a
a
a
a
a
a
a
a
a
a
a
a
a
a
a
"}
(5,1,1) = {"
a
a
a
a
a
a
a
a
a
a
a
a
a
a
a
a
a
a
a
a
a
a
a
a
a
a
a
a
a
a
a
a
a
a
a
a
a
a
a
a
"}
(6,1,1) = {"
a
a
a
a
a
a
a
a
a
a
a
a
a
a
a
a
a
a
a
a
a
a
a
a
a
a
a
a
a
a
a
a
a
a
a
a
a
a
a
a
"}
(7,1,1) = {"
a
a
a
a
a
a
a
a
a
a
a
a
a
a
a
a
a
a
a
a
a
a
a
a
a
a
a
a
a
a
a
a
a
a
a
a
a
a
a
a
"}
(8,1,1) = {"
a
a
a
a
a
a
a
u
u
u
u
u
u
u
u
u
u
u
u
u
u
u
u
u
u
u
u
u
u
u
u
u
u
a
a
a
a
a
a
a
"}
(9,1,1) = {"
a
a
a
a
a
a
a
u
u
u
u
u
u
u
u
u
u
u
u
u
u
u
u
u
u
u
u
u
u
u
u
u
u
a
a
a
a
a
a
a
"}
(10,1,1) = {"
a
a
a
a
a
a
a
u
u
u
u
u
u
u
u
u
u
u
u
u
u
u
u
u
u
u
u
u
u
u
u
u
u
a
a
a
a
a
a
a
"}
(11,1,1) = {"
a
a
a
a
a
a
a
u
u
u
u
u
u
u
u
u
u
u
u
u
u
u
u
u
u
u
u
u
u
u
u
u
u
a
a
a
a
a
a
a
"}
(12,1,1) = {"
a
a
a
a
a
a
a
u
u
u
u
u
u
u
u
u
u
u
u
u
u
u
u
u
u
u
u
u
u
u
u
u
u
a
a
a
a
a
a
a
"}
(13,1,1) = {"
a
a
a
a
a
a
a
u
u
u
u
u
u
u
u
u
u
u
u
u
u
u
u
u
u
u
u
u
u
u
u
u
u
a
a
a
a
a
a
a
"}
(14,1,1) = {"
a
a
a
a
a
a
a
u
u
u
u
u
u
u
u
u
u
u
u
u
u
u
u
u
u
u
u
u
u
u
u
u
u
a
a
a
a
a
a
a
"}
(15,1,1) = {"
a
a
a
a
a
a
a
u
u
u
u
u
u
u
u
u
u
u
u
u
u
u
u
u
u
u
u
u
u
u
u
u
u
a
a
a
a
a
a
a
"}
(16,1,1) = {"
a
a
a
a
a
a
a
u
u
u
u
u
u
u
u
u
u
u
u
u
u
u
u
u
u
u
u
u
u
u
u
u
u
a
a
a
a
a
a
a
"}
(17,1,1) = {"
a
a
a
a
a
a
a
u
u
u
u
u
u
u
u
u
u
u
u
u
u
u
u
u
u
u
u
u
u
u
u
u
u
a
a
a
a
a
a
a
"}
(18,1,1) = {"
a
a
a
a
a
a
a
u
u
u
u
u
u
u
u
u
u
u
u
u
u
u
u
u
u
u
u
u
u
u
u
u
u
a
a
a
a
a
a
a
"}
(19,1,1) = {"
a
a
a
a
a
a
a
u
u
u
u
u
u
u
u
u
u
u
u
u
u
u
u
u
u
u
u
u
u
u
u
u
u
a
a
a
a
a
a
a
"}
(20,1,1) = {"
a
a
a
a
a
a
a
u
u
u
u
u
u
u
u
u
u
u
u
u
u
u
u
u
u
u
u
u
u
u
u
u
u
a
a
a
a
a
a
a
"}
(21,1,1) = {"
a
a
a
a
a
a
a
u
u
u
u
u
u
u
u
u
u
u
u
u
u
u
u
u
u
u
u
u
u
u
u
u
u
a
a
a
a
a
a
a
"}
(22,1,1) = {"
a
a
a
a
a
a
a
u
u
u
u
u
u
u
u
u
u
u
u
u
u
u
u
u
u
u
u
u
u
u
u
u
u
a
a
a
a
a
a
a
"}
(23,1,1) = {"
a
a
a
a
a
a
a
u
u
u
u
u
u
u
u
u
u
u
u
u
u
u
u
u
u
u
u
u
u
u
u
u
u
a
a
a
a
a
a
a
"}
(24,1,1) = {"
a
a
a
a
a
a
a
u
u
u
u
u
u
u
u
u
u
u
u
u
u
u
u
u
u
u
u
u
u
u
u
u
u
a
a
a
a
a
a
a
"}
(25,1,1) = {"
a
a
a
a
a
a
a
u
u
u
u
u
u
u
u
u
u
u
u
u
u
u
u
u
u
u
u
u
u
u
u
u
u
a
a
a
a
a
a
a
"}
(26,1,1) = {"
a
a
a
a
a
a
a
u
u
u
u
u
u
u
u
u
u
u
u
u
u
u
u
u
u
u
u
u
u
u
u
u
u
a
a
a
a
a
a
a
"}
(27,1,1) = {"
a
a
a
a
a
a
a
u
u
u
u
u
u
u
u
u
u
u
u
u
u
u
u
u
u
u
u
u
u
u
u
u
u
a
a
a
a
a
a
a
"}
(28,1,1) = {"
a
a
a
a
a
a
a
u
u
u
u
u
u
u
u
u
u
u
u
u
u
u
u
u
u
u
u
u
u
u
u
u
u
a
a
a
a
a
a
a
"}
(29,1,1) = {"
a
a
a
a
a
a
a
u
u
u
u
u
u
u
u
u
u
u
u
u
u
u
u
u
u
u
u
u
u
u
u
u
u
a
a
a
a
a
a
a
"}
(30,1,1) = {"
a
a
a
a
a
a
a
u
u
u
u
u
u
u
u
u
u
u
B
B
u
u
u
u
u
u
u
u
u
u
u
u
u
a
a
a
a
a
a
a
"}
(31,1,1) = {"
a
a
a
a
a
a
a
u
u
u
u
u
u
u
B
l
l
l
l
l
l
l
l
l
u
u
u
u
u
u
u
u
u
a
a
a
B
B
B
a
"}
(32,1,1) = {"
a
a
a
a
a
a
a
u
u
u
u
u
u
B
B
l
l
l
l
l
l
l
l
l
B
B
u
u
u
u
u
u
u
a
a
B
B
B
B
B
"}
(33,1,1) = {"
a
a
a
a
a
a
a
u
u
u
u
u
u
B
B
l
l
l
l
l
l
l
l
l
B
B
B
B
u
u
u
u
u
a
a
B
B
B
B
B
"}
(34,1,1) = {"
a
a
a
a
a
a
a
a
a
a
a
a
a
B
B
l
l
l
l
l
l
l
l
l
B
B
B
B
B
B
B
B
a
a
a
B
B
B
B
a
"}
(35,1,1) = {"
a
a
a
a
a
a
a
a
a
a
a
a
B
B
B
l
l
l
l
l
l
l
l
l
B
B
B
B
B
B
B
B
B
B
B
B
B
B
B
a
"}
(36,1,1) = {"
a
a
a
a
a
a
a
a
a
a
a
a
B
B
B
l
l
l
l
l
l
l
l
l
B
B
B
B
B
B
B
B
B
B
B
B
B
B
a
a
"}
(37,1,1) = {"
a
a
a
a
a
a
a
a
a
a
a
a
a
B
B
l
l
l
l
l
l
l
l
l
B
a
B
B
B
B
B
B
B
B
B
B
B
B
a
a
"}
(38,1,1) = {"
a
a
a
a
a
a
a
a
a
a
a
a
a
B
B
B
B
B
B
B
B
B
B
a
a
a
a
a
a
a
a
B
B
B
B
B
B
a
a
a
"}
(39,1,1) = {"
a
a
a
a
a
a
a
a
a
a
a
a
a
a
B
B
B
B
B
B
a
a
a
a
a
a
a
a
a
a
a
a
a
a
a
a
a
a
a
a
"}
(40,1,1) = {"
a
a
a
a
a
a
a
a
a
a
a
a
a
a
a
a
a
a
a
a
a
a
a
a
a
a
a
a
a
a
a
a
a
a
a
a
a
a
a
a
"}
