//MAP CONVERTED BY dmm2tgm.py THIS HEADER COMMENT PREVENTS RECONVERSION, DO NOT REMOVE
"a" = (
/turf/simulated/floor/plating/asteroid/basalt/lava_land_surface_hard,
/area/ruin/unpowered/bigcave/cave1)
"b" = (
/turf/simulated/mineral/ancient/lava_land_surface_hard,
/area/ruin/unpowered/bigcave/cave1)
"d" = (
/turf/simulated/mineral/volcanic/lava_land_surface,
/area/ruin/unpowered/bigcave/cave1)
"j" = (
/obj/effect/baseturf_helper/lava_land/surface,
/turf/simulated/floor/plating/asteroid/basalt/lava_land_surface_hard,
/area/ruin/unpowered/bigcave/cave1)
"q" = (
/turf/template_noop,
/area/template_noop)

(1,1,1) = {"
q
q
q
q
q
q
q
q
q
b
b
b
b
b
b
b
b
b
q
q
q
q
q
q
b
b
b
b
b
q
q
q
q
"}
(2,1,1) = {"
q
q
q
q
q
q
b
b
b
b
b
b
b
b
b
b
b
b
b
b
q
q
d
d
d
b
b
b
b
b
q
q
q
"}
(3,1,1) = {"
q
q
q
q
q
q
b
b
b
a
a
a
a
a
a
a
a
b
b
d
d
d
d
d
a
a
a
b
b
b
b
q
q
"}
(4,1,1) = {"
q
q
b
b
b
b
b
b
a
a
a
a
a
a
a
a
a
a
d
d
d
d
a
a
a
a
a
a
b
b
b
q
q
"}
(5,1,1) = {"
q
b
b
b
b
b
b
a
a
a
a
a
a
a
a
a
a
a
a
a
a
a
a
a
a
a
a
a
a
b
b
b
q
"}
(6,1,1) = {"
q
b
d
a
a
a
a
a
a
a
a
a
a
a
a
a
a
a
a
a
a
a
a
a
a
a
a
a
a
b
b
b
q
"}
(7,1,1) = {"
q
d
d
a
a
a
a
a
a
a
a
a
a
a
a
a
a
a
a
a
a
a
a
a
a
a
a
a
a
b
b
b
q
"}
(8,1,1) = {"
q
q
d
d
a
a
a
a
a
a
a
a
a
a
a
a
a
a
a
a
a
a
a
a
a
a
a
a
a
b
b
b
q
"}
(9,1,1) = {"
q
q
d
d
a
a
a
a
a
a
a
a
a
a
a
a
a
a
a
a
a
a
a
a
a
a
a
a
a
b
b
q
q
"}
(10,1,1) = {"
q
d
d
b
a
a
a
a
a
a
a
a
a
a
a
a
a
a
a
a
a
a
a
a
a
a
a
a
b
b
b
q
q
"}
(11,1,1) = {"
b
b
b
a
a
a
a
a
a
a
a
a
a
a
a
a
a
a
a
a
a
a
a
a
a
a
a
a
b
b
b
q
q
"}
(12,1,1) = {"
b
b
a
a
a
a
a
a
a
a
a
a
a
a
a
a
a
a
a
a
a
a
a
a
a
b
b
b
b
b
q
q
q
"}
(13,1,1) = {"
b
b
a
a
a
a
a
a
a
a
a
a
a
a
a
a
a
a
a
a
a
a
a
b
b
b
b
b
b
q
q
q
q
"}
(14,1,1) = {"
b
b
a
a
a
a
a
a
a
a
a
a
a
a
a
a
a
a
a
a
a
a
a
b
b
b
b
q
q
q
q
q
q
"}
(15,1,1) = {"
b
b
a
a
a
a
a
a
a
a
a
a
a
a
a
a
a
a
a
a
a
a
a
b
b
q
q
q
q
q
q
q
q
"}
(16,1,1) = {"
b
b
b
a
a
a
a
a
a
a
a
a
a
a
a
a
a
a
a
a
a
a
a
b
b
b
q
q
q
q
q
q
q
"}
(17,1,1) = {"
q
b
b
a
a
a
a
a
a
a
a
a
a
a
a
a
j
a
a
a
a
a
a
a
b
b
d
q
q
q
q
q
q
"}
(18,1,1) = {"
q
q
b
b
a
a
a
a
a
a
a
a
a
a
a
a
a
a
a
a
a
a
a
a
a
d
d
d
q
q
q
q
q
"}
(19,1,1) = {"
q
q
b
b
a
a
a
a
a
a
a
a
a
a
a
a
a
a
a
a
a
a
a
a
a
a
d
d
d
d
q
q
q
"}
(20,1,1) = {"
q
q
b
b
b
a
a
a
a
a
a
a
a
a
a
a
a
a
a
a
a
a
a
a
a
a
a
a
d
b
b
b
q
"}
(21,1,1) = {"
q
q
q
b
b
b
a
a
a
a
a
a
a
a
a
a
a
a
a
a
a
a
a
a
a
a
a
a
a
b
b
b
b
"}
(22,1,1) = {"
q
q
q
q
b
b
b
a
a
a
a
a
a
a
a
a
a
a
a
a
a
a
a
a
a
a
a
a
a
a
a
b
b
"}
(23,1,1) = {"
q
q
q
q
q
b
b
a
a
a
a
a
a
a
a
a
a
a
a
a
a
a
a
a
a
a
a
a
a
a
a
a
b
"}
(24,1,1) = {"
q
q
q
q
q
q
b
b
a
a
a
a
a
a
a
a
a
a
a
a
a
a
a
a
a
a
a
a
a
a
a
b
b
"}
(25,1,1) = {"
q
b
b
b
b
q
b
b
a
a
a
a
a
a
a
a
a
a
a
a
a
a
a
a
a
a
a
a
a
a
a
b
b
"}
(26,1,1) = {"
b
b
b
b
b
b
b
b
a
a
a
a
a
a
a
a
a
a
a
a
a
a
a
a
a
a
a
a
a
a
a
b
b
"}
(27,1,1) = {"
b
a
a
a
b
b
b
b
a
a
a
a
a
a
a
a
a
a
a
a
a
a
a
a
a
a
a
a
a
a
a
b
b
"}
(28,1,1) = {"
b
b
a
a
a
b
b
b
a
a
a
a
a
a
a
a
a
a
a
a
a
a
a
a
a
a
a
b
b
b
a
b
q
"}
(29,1,1) = {"
b
b
a
a
a
a
a
a
a
a
a
a
a
b
b
b
b
b
a
a
a
a
a
a
a
b
b
b
b
b
b
b
q
"}
(30,1,1) = {"
b
b
a
a
a
a
a
a
a
a
a
a
a
b
b
b
b
b
b
b
a
a
a
a
a
b
b
q
q
b
b
b
q
"}
(31,1,1) = {"
q
b
d
d
d
a
a
a
a
a
a
a
b
b
b
b
q
q
b
b
b
a
a
a
b
b
q
q
q
q
q
q
q
"}
(32,1,1) = {"
q
q
d
d
d
b
b
b
b
b
b
b
b
b
q
q
q
q
q
b
b
b
b
b
b
b
q
q
q
q
q
q
q
"}
(33,1,1) = {"
q
q
q
q
q
q
b
b
b
b
b
b
b
q
q
q
q
q
q
q
q
b
b
b
q
q
q
q
q
q
q
q
q
"}
