//MAP CONVERTED BY dmm2tgm.py THIS HEADER COMMENT PREVENTS RECONVERSION, DO NOT REMOVE
"b" = (
/obj/effect/sliding_puzzle/lavaland,
/turf/simulated/floor/plating/asteroid/basalt/lava_land_surface,
/area/lavaland/surface/outdoors)
"c" = (
/turf/simulated/floor/plating/asteroid/basalt/lava_land_surface,
/area/lavaland/surface/outdoors)
"n" = (
/turf/template_noop,
/area/lavaland/surface/outdoors)

(1,1,1) = {"
n
n
n
n
n
"}
(2,1,1) = {"
n
c
c
c
n
"}
(3,1,1) = {"
n
c
b
c
n
"}
(4,1,1) = {"
n
c
c
c
n
"}
(5,1,1) = {"
n
n
n
n
n
"}
