"aa" = (/turf/template_noop,/area/template_noop)
"ab" = (/obj/structure/disposalpipe/segment{dir = 4; icon_state = "pipe-c"},/turf/simulated/wall/r_wall,/area/ruin/powered/clownplanet)
"ac" = (/obj/structure/disposalpipe/segment{dir = 2; icon_state = "pipe-c"},/turf/simulated/wall/r_wall,/area/ruin/powered/clownplanet)
"ad" = (/obj/structure/disposalpipe/segment{dir = 4; icon_state = "pipe-c"},/turf/simulated/floor/plating,/area/ruin/powered/clownplanet)
"ae" = (/obj/structure/disposalpipe/segment{dir = 2; icon_state = "pipe-c"},/turf/simulated/floor/plating,/area/ruin/powered/clownplanet)
"af" = (/obj/structure/disposalpipe/segment{invisibility = 101},/obj/effect/turf_decal/tile/yellow,/obj/effect/turf_decal/tile/yellow{dir = 1},/obj/effect/turf_decal/tile/yellow{dir = 8},/obj/effect/turf_decal/tile/yellow{dir = 4},/turf/simulated/floor/plasteel,/area/ruin/powered/clownplanet)
"ag" = (/obj/effect/mob_spawn/human/corpse/damaged,/obj/effect/decal/cleanable/blood/old,/obj/structure/disposalpipe/segment{invisibility = 101},/obj/effect/turf_decal/tile/yellow,/obj/effect/turf_decal/tile/yellow{dir = 1},/obj/effect/turf_decal/tile/yellow{dir = 8},/obj/effect/turf_decal/tile/yellow{dir = 4},/turf/simulated/floor/plasteel,/area/ruin/powered/clownplanet)
"ah" = (/obj/effect/turf_decal/tile/yellow,/obj/effect/turf_decal/tile/yellow{dir = 1},/obj/effect/turf_decal/tile/yellow{dir = 8},/obj/effect/turf_decal/tile/yellow{dir = 4},/obj/structure/disposalpipe/segment{dir = 4; icon_state = "pipe-c"},/turf/simulated/floor/plasteel,/area/ruin/powered/clownplanet)
"ai" = (/obj/structure/disposalpipe/sortjunction{dir = 1},/turf/simulated/wall/r_wall,/area/ruin/powered/clownplanet)
"aj" = (/obj/effect/decal/cleanable/pie_smudge,/obj/structure/disposalpipe/segment{invisibility = 101},/obj/effect/turf_decal/tile/yellow,/obj/effect/turf_decal/tile/yellow{dir = 1},/obj/effect/turf_decal/tile/yellow{dir = 8},/obj/effect/turf_decal/tile/yellow{dir = 4},/turf/simulated/floor/plasteel,/area/ruin/powered/clownplanet)
"ak" = (/obj/structure/disposalpipe/segment{invisibility = 101},/obj/machinery/light/small{dir = 1},/obj/effect/turf_decal/tile/yellow,/obj/effect/turf_decal/tile/yellow{dir = 1},/obj/effect/turf_decal/tile/yellow{dir = 8},/obj/effect/turf_decal/tile/yellow{dir = 4},/turf/simulated/floor/plasteel,/area/ruin/powered/clownplanet)
"al" = (/obj/effect/decal/cleanable/dirt,/obj/effect/turf_decal/tile/yellow,/obj/effect/turf_decal/tile/yellow{dir = 1},/obj/effect/turf_decal/tile/yellow{dir = 8},/obj/effect/turf_decal/tile/yellow{dir = 4},/obj/structure/disposalpipe/segment{dir = 1; icon_state = "pipe-c"},/turf/simulated/floor/plasteel,/area/ruin/powered/clownplanet)
"am" = (/obj/structure/disposalpipe/segment{dir = 4; invisibility = 101},/obj/effect/decal/cleanable/dirt,/obj/effect/turf_decal/tile/yellow,/obj/effect/turf_decal/tile/yellow{dir = 1},/obj/effect/turf_decal/tile/yellow{dir = 8},/obj/effect/turf_decal/tile/yellow{dir = 4},/turf/simulated/floor/plasteel,/area/ruin/powered/clownplanet)
"an" = (/obj/structure/disposalpipe/segment{dir = 4; invisibility = 101},/obj/effect/turf_decal/tile/yellow,/obj/effect/turf_decal/tile/yellow{dir = 1},/obj/effect/turf_decal/tile/yellow{dir = 8},/obj/effect/turf_decal/tile/yellow{dir = 4},/turf/simulated/floor/plasteel,/area/ruin/powered/clownplanet)
"ao" = (/obj/structure/window/reinforced,/obj/structure/disposalpipe/segment{dir = 8; icon_state = "pipe-c"},/turf/simulated/floor/plating,/area/ruin/powered/clownplanet)
"ap" = (/obj/effect/turf_decal/tile/yellow,/obj/effect/turf_decal/tile/yellow{dir = 1},/obj/effect/turf_decal/tile/yellow{dir = 8},/obj/effect/turf_decal/tile/yellow{dir = 4},/obj/structure/disposalpipe/segment{dir = 8; icon_state = "pipe-c"},/turf/simulated/floor/plasteel,/area/ruin/powered/clownplanet)
"aq" = (/obj/structure/disposalpipe/trunk,/obj/structure/disposaloutlet{dir = 1},/turf/simulated/floor/plating,/area/ruin/powered/clownplanet)
"ar" = (/obj/effect/turf_decal/tile/yellow,/obj/effect/turf_decal/tile/yellow{dir = 1},/obj/effect/turf_decal/tile/yellow{dir = 8},/obj/effect/turf_decal/tile/yellow{dir = 4},/turf/simulated/floor/plasteel,/area/ruin/powered/clownplanet)
"as" = (/obj/effect/decal/cleanable/dirt,/obj/effect/turf_decal/tile/yellow,/obj/effect/turf_decal/tile/yellow{dir = 1},/obj/effect/turf_decal/tile/yellow{dir = 8},/obj/effect/turf_decal/tile/yellow{dir = 4},/turf/simulated/floor/plasteel,/area/ruin/powered/clownplanet)
"at" = (/obj/structure/disposalpipe/segment{dir = 4; invisibility = 101},/obj/effect/decal/cleanable/cobweb,/obj/effect/turf_decal/tile/yellow,/obj/effect/turf_decal/tile/yellow{dir = 1},/obj/effect/turf_decal/tile/yellow{dir = 8},/obj/effect/turf_decal/tile/yellow{dir = 4},/turf/simulated/floor/plasteel,/area/ruin/powered/clownplanet)
"au" = (/obj/structure/disposalpipe/segment{invisibility = 101},/turf/simulated/floor/plating,/area/ruin/powered/clownplanet)
"av" = (/obj/effect/turf_decal/tile/yellow,/obj/effect/turf_decal/tile/yellow{dir = 1},/obj/effect/turf_decal/tile/yellow{dir = 8},/obj/effect/turf_decal/tile/yellow{dir = 4},/obj/structure/disposalpipe/segment{dir = 1; icon_state = "pipe-c"},/turf/simulated/floor/plasteel,/area/ruin/powered/clownplanet)
"aw" = (/obj/machinery/light/small{dir = 1},/obj/effect/turf_decal/tile/yellow,/obj/effect/turf_decal/tile/yellow{dir = 1},/obj/effect/turf_decal/tile/yellow{dir = 8},/obj/effect/turf_decal/tile/yellow{dir = 4},/turf/simulated/floor/plasteel,/area/ruin/powered/clownplanet)
"ax" = (/obj/effect/decal/cleanable/pie_smudge,/obj/structure/disposalpipe/segment{invisibility = 101},/obj/effect/turf_decal/tile/yellow,/obj/effect/turf_decal/tile/yellow{dir = 1},/obj/effect/turf_decal/tile/yellow{dir = 8},/obj/effect/turf_decal/tile/yellow{dir = 4},/turf/simulated/floor/plating,/area/ruin/powered/clownplanet)
"ay" = (/obj/effect/decal/cleanable/dirt,/obj/effect/turf_decal/tile/yellow,/obj/effect/turf_decal/tile/yellow{dir = 1},/obj/effect/turf_decal/tile/yellow{dir = 8},/obj/effect/turf_decal/tile/yellow{dir = 4},/obj/structure/disposalpipe/segment{dir = 8; icon_state = "pipe-c"},/turf/simulated/floor/plasteel,/area/ruin/powered/clownplanet)
"az" = (/obj/item/bikehorn,/obj/effect/turf_decal/tile/yellow,/obj/effect/turf_decal/tile/yellow{dir = 1},/obj/effect/turf_decal/tile/yellow{dir = 8},/obj/effect/turf_decal/tile/yellow{dir = 4},/obj/structure/disposalpipe/segment{dir = 1; icon_state = "pipe-c"},/turf/simulated/floor/plasteel,/area/ruin/powered/clownplanet)
"aA" = (/obj/structure/disposalpipe/segment{dir = 1; icon_state = "pipe-c"},/turf/simulated/wall/r_wall,/area/ruin/powered/clownplanet)
"aB" = (/obj/structure/disposalpipe/segment{dir = 4; invisibility = 101},/obj/effect/decal/cleanable/pie_smudge,/obj/effect/turf_decal/tile/yellow,/obj/effect/turf_decal/tile/yellow{dir = 1},/obj/effect/turf_decal/tile/yellow{dir = 8},/obj/effect/turf_decal/tile/yellow{dir = 4},/turf/simulated/floor/plasteel,/area/ruin/powered/clownplanet)
"aC" = (/obj/effect/turf_decal/tile/yellow,/obj/effect/turf_decal/tile/yellow{dir = 1},/obj/effect/turf_decal/tile/yellow{dir = 8},/obj/effect/turf_decal/tile/yellow{dir = 4},/obj/structure/disposalpipe/segment{dir = 2; icon_state = "pipe-c"},/turf/simulated/floor/plasteel,/area/ruin/powered/clownplanet)
"aD" = (/obj/item/bikehorn,/obj/structure/disposalpipe/segment{dir = 4; invisibility = 101},/obj/effect/turf_decal/tile/yellow,/obj/effect/turf_decal/tile/yellow{dir = 1},/obj/effect/turf_decal/tile/yellow{dir = 8},/obj/effect/turf_decal/tile/yellow{dir = 4},/turf/simulated/floor/plasteel,/area/ruin/powered/clownplanet)
"aE" = (/obj/structure/disposalpipe/segment{dir = 8; icon_state = "pipe-c"},/turf/simulated/floor/plating,/area/ruin/powered/clownplanet)
"aF" = (/obj/effect/decal/cleanable/dirt,/obj/structure/disposalpipe/segment{invisibility = 101},/obj/effect/turf_decal/tile/yellow,/obj/effect/turf_decal/tile/yellow{dir = 1},/obj/effect/turf_decal/tile/yellow{dir = 8},/obj/effect/turf_decal/tile/yellow{dir = 4},/turf/simulated/floor/plasteel,/area/ruin/powered/clownplanet)
"aG" = (/obj/machinery/light/small{dir = 4},/obj/effect/turf_decal/tile/yellow,/obj/effect/turf_decal/tile/yellow{dir = 1},/obj/effect/turf_decal/tile/yellow{dir = 8},/obj/effect/turf_decal/tile/yellow{dir = 4},/obj/structure/disposalpipe/segment{dir = 2; icon_state = "pipe-c"},/turf/simulated/floor/plasteel,/area/ruin/powered/clownplanet)
"aH" = (/obj/effect/decal/cleanable/dirt,/obj/machinery/light/small{dir = 8},/obj/effect/turf_decal/tile/yellow,/obj/effect/turf_decal/tile/yellow{dir = 1},/obj/effect/turf_decal/tile/yellow{dir = 8},/obj/effect/turf_decal/tile/yellow{dir = 4},/obj/structure/disposalpipe/segment{dir = 2; icon_state = "pipe-c"},/turf/simulated/floor/plasteel,/area/ruin/powered/clownplanet)
"aI" = (/obj/item/bikehorn,/obj/effect/decal/cleanable/dirt,/obj/structure/disposalpipe/segment{invisibility = 101},/obj/effect/turf_decal/tile/yellow,/obj/effect/turf_decal/tile/yellow{dir = 1},/obj/effect/turf_decal/tile/yellow{dir = 8},/obj/effect/turf_decal/tile/yellow{dir = 4},/turf/simulated/floor/plasteel,/area/ruin/powered/clownplanet)
"aJ" = (/obj/item/bikehorn,/obj/structure/disposalpipe/segment{invisibility = 101},/obj/effect/turf_decal/tile/yellow,/obj/effect/turf_decal/tile/yellow{dir = 1},/obj/effect/turf_decal/tile/yellow{dir = 8},/obj/effect/turf_decal/tile/yellow{dir = 4},/turf/simulated/floor/plasteel,/area/ruin/powered/clownplanet)
"aK" = (/obj/structure/disposalpipe/segment{dir = 4; invisibility = 101},/obj/effect/turf_decal/tile/red,/obj/effect/turf_decal/tile/red{dir = 8},/obj/effect/turf_decal/tile/red{dir = 4},/obj/effect/turf_decal/tile/red{dir = 1},/turf/simulated/floor/plasteel,/area/ruin/powered/clownplanet)
"aL" = (/obj/structure/disposalpipe/segment{dir = 4; invisibility = 101},/turf/simulated/wall/r_wall,/area/ruin/powered/clownplanet)
"aM" = (/obj/effect/decal/cleanable/pie_smudge,/obj/effect/turf_decal/tile/yellow,/obj/effect/turf_decal/tile/yellow{dir = 1},/obj/effect/turf_decal/tile/yellow{dir = 8},/obj/effect/turf_decal/tile/yellow{dir = 4},/turf/simulated/floor/plasteel,/area/ruin/powered/clownplanet)
"aN" = (/obj/structure/disposalpipe/segment{dir = 4; invisibility = 101},/turf/simulated/floor/plasteel{dir = 4; icon_state = "white"},/area/ruin/powered/clownplanet)
"aO" = (/obj/effect/decal/cleanable/dirt,/obj/effect/turf_decal/tile/yellow,/obj/effect/turf_decal/tile/yellow{dir = 1},/obj/effect/turf_decal/tile/yellow{dir = 8},/obj/effect/turf_decal/tile/yellow{dir = 4},/obj/structure/disposalpipe/segment{dir = 4; icon_state = "pipe-c"},/turf/simulated/floor/plasteel,/area/ruin/powered/clownplanet)
"aP" = (/obj/structure/disposalpipe/segment{dir = 4; invisibility = 101},/turf/simulated/floor/plating,/area/ruin/powered/clownplanet)
"aQ" = (/obj/structure/disposalpipe/segment{dir = 4; invisibility = 101},/obj/structure/table,/obj/item/paper/crumpled/bloody/ruins/lavaland/clown_planet/escape,/obj/item/pen/multi,/turf/simulated/floor/plasteel{dir = 4; icon_state = "white"},/area/ruin/powered/clownplanet)
"aR" = (/obj/structure/disposalpipe/segment{dir = 4; invisibility = 101},/obj/structure/table,/obj/item/flashlight/lamp/bananalamp,/turf/simulated/floor/plasteel{dir = 4; icon_state = "white"},/area/ruin/powered/clownplanet)
"aS" = (/obj/effect/decal/cleanable/pie_smudge,/obj/effect/turf_decal/tile/yellow,/obj/effect/turf_decal/tile/yellow{dir = 1},/obj/effect/turf_decal/tile/yellow{dir = 8},/obj/effect/turf_decal/tile/yellow{dir = 4},/obj/structure/disposalpipe/segment{dir = 2; icon_state = "pipe-c"},/turf/simulated/floor/plasteel,/area/ruin/powered/clownplanet)
"aT" = (/obj/structure/disposalpipe/segment{dir = 4; invisibility = 101},/obj/item/pickaxe,/turf/simulated/floor/plasteel{dir = 4; icon_state = "white"},/area/ruin/powered/clownplanet)
"aU" = (/obj/effect/spawner/window/reinforced,/turf/simulated/floor/plating,/area/ruin/powered/clownplanet)
"aV" = (/obj/structure/disposalpipe/segment{dir = 4; icon_state = "pipe-c"},/turf/simulated/floor/plasteel{dir = 4; icon_state = "white"},/area/ruin/powered/clownplanet)
"aW" = (/obj/structure/disposalpipe/segment{dir = 2; icon_state = "pipe-c"},/turf/simulated/floor/plasteel{dir = 4; icon_state = "white"},/area/ruin/powered/clownplanet)
"aX" = (/obj/structure/disposalpipe/trunk{dir = 4},/obj/structure/disposaloutlet{dir = 8},/turf/simulated/floor/plating,/area/ruin/powered/clownplanet)
"aY" = (/obj/structure/disposalpipe/segment{dir = 4; invisibility = 101},/obj/machinery/light/small{dir = 8},/turf/simulated/floor/plasteel{dir = 4; icon_state = "white"},/area/ruin/powered/clownplanet)
"aZ" = (/obj/structure/disposalpipe/segment{dir = 4; invisibility = 101},/turf/simulated/floor/light,/area/ruin/powered/clownplanet)
"ba" = (/obj/structure/disposalpipe/segment{dir = 4; invisibility = 101},/obj/machinery/light/small{dir = 4},/turf/simulated/floor/plasteel{dir = 4; icon_state = "white"},/area/ruin/powered/clownplanet)
"bb" = (/obj/structure/disposalpipe/segment{invisibility = 101},/obj/machinery/light/small{dir = 8},/turf/simulated/floor/plasteel{dir = 4; icon_state = "white"},/area/ruin/powered/clownplanet)
"bc" = (/turf/simulated/floor/light,/area/ruin/powered/clownplanet)
"bd" = (/obj/structure/disposalpipe/segment{dir = 1; icon_state = "pipe-c"},/turf/simulated/floor/plasteel{dir = 4; icon_state = "white"},/area/ruin/powered/clownplanet)
"be" = (/obj/machinery/light/small{dir = 4},/obj/structure/disposalpipe/segment{dir = 8; icon_state = "pipe-c"},/turf/simulated/floor/plasteel{dir = 4; icon_state = "white"},/area/ruin/powered/clownplanet)
"bf" = (/turf/simulated/mineral/clown/volcanic,/area/ruin/powered/clownplanet)
"bg" = (/obj/item/pickaxe,/turf/simulated/floor/plasteel{dir = 4; icon_state = "white"},/area/ruin/powered/clownplanet)
"bh" = (/turf/simulated/floor/plasteel{dir = 4; icon_state = "white"},/area/ruin/powered/clownplanet)
"bi" = (/obj/effect/turf_decal/tile/red,/obj/effect/turf_decal/tile/red{dir = 8},/obj/effect/turf_decal/tile/red{dir = 4},/obj/effect/turf_decal/tile/red{dir = 1},/obj/structure/disposalpipe/segment{dir = 4; icon_state = "pipe-c"},/turf/simulated/floor/plasteel,/area/ruin/powered/clownplanet)
"bj" = (/obj/effect/decal/cleanable/dirt,/obj/effect/turf_decal/tile/yellow,/obj/effect/turf_decal/tile/yellow{dir = 1},/obj/effect/turf_decal/tile/yellow{dir = 8},/obj/effect/turf_decal/tile/yellow{dir = 4},/obj/structure/disposalpipe/segment{dir = 2; icon_state = "pipe-c"},/turf/simulated/floor/plasteel,/area/ruin/powered/clownplanet)
"bk" = (/obj/structure/disposalpipe/segment{dir = 1; icon_state = "pipe-c"},/turf/simulated/floor/plating,/area/ruin/powered/clownplanet)
"bl" = (/obj/item/bikehorn,/obj/effect/turf_decal/tile/yellow,/obj/effect/turf_decal/tile/yellow{dir = 1},/obj/effect/turf_decal/tile/yellow{dir = 8},/obj/effect/turf_decal/tile/yellow{dir = 4},/obj/structure/disposalpipe/segment{dir = 2; icon_state = "pipe-c"},/turf/simulated/floor/plasteel,/area/ruin/powered/clownplanet)
"bm" = (/obj/structure/disposalpipe/segment{dir = 8; icon_state = "pipe-c"},/turf/simulated/floor/plasteel{dir = 4; icon_state = "white"},/area/ruin/powered/clownplanet)
"bn" = (/obj/effect/decal/cleanable/cobweb,/obj/effect/turf_decal/tile/red,/obj/effect/turf_decal/tile/red{dir = 8},/obj/effect/turf_decal/tile/red{dir = 4},/obj/effect/turf_decal/tile/red{dir = 1},/turf/simulated/floor/plasteel,/area/ruin/powered/clownplanet)
"bo" = (/obj/structure/disposalpipe/segment,/obj/effect/turf_decal/tile/yellow,/obj/effect/turf_decal/tile/yellow{dir = 1},/obj/effect/turf_decal/tile/yellow{dir = 8},/obj/effect/turf_decal/tile/yellow{dir = 4},/turf/simulated/floor/plasteel,/area/ruin/powered/clownplanet)
"bp" = (/obj/effect/decal/cleanable/pie_smudge,/obj/effect/turf_decal/tile/yellow{dir = 4},/obj/effect/turf_decal/tile/yellow{dir = 8},/obj/effect/turf_decal/tile/yellow{dir = 1},/obj/effect/turf_decal/tile/yellow,/turf/simulated/floor/plasteel,/area/ruin/powered/clownplanet)
"bq" = (/obj/machinery/disposal/deliveryChute{dir = 1},/obj/structure/disposalpipe/trunk,/turf/simulated/floor/plasteel{dir = 4; icon_state = "white"},/area/ruin/powered/clownplanet)
"br" = (/obj/effect/turf_decal/tile/red,/obj/effect/turf_decal/tile/red{dir = 8},/obj/effect/turf_decal/tile/red{dir = 4},/obj/effect/turf_decal/tile/red{dir = 1},/turf/simulated/floor/plasteel,/area/ruin/powered/clownplanet)
"bs" = (/obj/machinery/light{dir = 1},/obj/effect/turf_decal/tile/red,/obj/effect/turf_decal/tile/red{dir = 8},/obj/effect/turf_decal/tile/red{dir = 4},/obj/effect/turf_decal/tile/red{dir = 1},/turf/simulated/floor/plasteel,/area/ruin/powered/clownplanet)
"bt" = (/obj/effect/decal/cleanable/dirt,/obj/effect/turf_decal/tile/yellow,/obj/effect/turf_decal/tile/yellow{dir = 1},/obj/effect/turf_decal/tile/yellow{dir = 8},/obj/effect/turf_decal/tile/yellow{dir = 4},/obj/structure/disposalpipe/junction{dir = 1; icon_state = "pipe-y"},/turf/simulated/floor/plasteel,/area/ruin/powered/clownplanet)
"bu" = (/obj/effect/decal/cleanable/blood/oil,/obj/structure/disposalpipe/segment{dir = 2; icon_state = "pipe-c"},/turf/simulated/floor/plating,/area/ruin/powered/clownplanet)
"bv" = (/obj/effect/mob_spawn/human/corpse/damaged,/obj/effect/decal/cleanable/blood/old,/obj/effect/turf_decal/tile/yellow{dir = 8},/obj/effect/turf_decal/tile/yellow{dir = 1},/obj/effect/turf_decal/tile/yellow,/obj/effect/turf_decal/tile/yellow{dir = 4},/turf/simulated/floor/plasteel,/area/ruin/powered/clownplanet)
"bw" = (/obj/effect/turf_decal/tile/red,/obj/effect/turf_decal/tile/red{dir = 8},/obj/effect/turf_decal/tile/red{dir = 4},/obj/effect/turf_decal/tile/red{dir = 1},/obj/structure/disposalpipe/segment{dir = 8; icon_state = "pipe-c"},/turf/simulated/floor/plasteel,/area/ruin/powered/clownplanet)
"bx" = (/obj/effect/decal/cleanable/dirt,/obj/effect/turf_decal/tile/yellow,/obj/effect/turf_decal/tile/yellow{dir = 1},/obj/effect/turf_decal/tile/yellow{dir = 8},/obj/effect/turf_decal/tile/yellow{dir = 4},/obj/effect/baseturf_helper/lava_land/surface,/turf/simulated/floor/plasteel,/area/ruin/powered/clownplanet)
"by" = (/obj/structure/table/glass,/obj/item/gun/magic/staff/slipping,/turf/simulated/floor/carpet,/area/ruin/powered/clownplanet)
"bB" = (/turf/simulated/floor/mineral/bananium,/area/ruin/powered/clownplanet)
"bD" = (/obj/effect/decal/mecha_wreckage/honker,/obj/structure/disposalpipe/segment{dir = 4; invisibility = 101},/turf/simulated/floor/plating,/area/ruin/powered/clownplanet)
"bH" = (/obj/effect/decal/cleanable/dirt,/turf/simulated/floor/mineral/bananium,/area/ruin/powered/clownplanet)
"bL" = (/obj/item/reagent_containers/food/drinks/trophy/gold_cup,/obj/structure/table/glass,/turf/simulated/floor/carpet,/area/ruin/powered/clownplanet)
"bM" = (/turf/simulated/floor/carpet,/area/ruin/powered/clownplanet)
"bN" = (/obj/machinery/disposal/deliveryChute,/obj/structure/disposalpipe/trunk{dir = 1},/turf/simulated/floor/carpet,/area/ruin/powered/clownplanet)
"bO" = (/obj/effect/decal/cleanable/cobweb,/turf/simulated/floor/mineral/bananium,/area/ruin/powered/clownplanet)
"bP" = (/obj/structure/statue/bananium/clown,/turf/simulated/floor/carpet,/area/ruin/powered/clownplanet)
"bQ" = (/obj/structure/table/glass,/obj/item/grown/bananapeel/bluespace,/turf/simulated/floor/carpet,/area/ruin/powered/clownplanet)
"bR" = (/obj/structure/table/glass,/obj/item/clothing/shoes/magboots/clown,/turf/simulated/floor/carpet,/area/ruin/powered/clownplanet)
"bS" = (/obj/item/coin/clown,/obj/item/coin/clown,/obj/item/coin/clown,/obj/item/coin/clown,/obj/machinery/light/small{dir = 8},/turf/simulated/floor/carpet,/area/ruin/powered/clownplanet)
"bT" = (/obj/item/slime_extract/rainbow,/obj/structure/table/glass,/turf/simulated/floor/carpet,/area/ruin/powered/clownplanet)
"bU" = (/obj/item/bikehorn/airhorn,/turf/simulated/floor/carpet,/area/ruin/powered/clownplanet)
"bW" = (/obj/item/bikehorn,/turf/simulated/floor/mineral/bananium,/area/ruin/powered/clownplanet)
"bY" = (/obj/effect/mob_spawn/human/corpse/damaged,/obj/effect/decal/cleanable/blood/old,/turf/simulated/floor/mineral/bananium,/area/ruin/powered/clownplanet)
"bZ" = (/obj/machinery/door/airlock/bananium,/turf/simulated/floor/mineral/bananium,/area/ruin/powered/clownplanet)
"ca" = (/obj/item/bikehorn,/obj/effect/decal/cleanable/dirt,/turf/simulated/floor/mineral/bananium,/area/ruin/powered/clownplanet)
"cc" = (/turf/simulated/wall/r_wall,/area/ruin/powered/clownplanet)
"ch" = (/obj/structure/disposalpipe/segment{invisibility = 101},/turf/simulated/wall/r_wall,/area/ruin/powered/clownplanet)
"cu" = (/turf/simulated/floor/plating,/area/ruin/powered/clownplanet)
"dK" = (/obj/machinery/light/small{dir = 1},/turf/simulated/floor/carpet,/area/ruin/powered/clownplanet)
"dL" = (/obj/item/coin/clown,/obj/item/coin/clown,/obj/item/coin/clown,/obj/item/coin/clown,/obj/machinery/light/small{dir = 4},/turf/simulated/floor/carpet,/area/ruin/powered/clownplanet)
"dM" = (/obj/machinery/light{dir = 1},/turf/simulated/floor/mineral/bananium,/area/ruin/powered/clownplanet)
"dO" = (/obj/machinery/light,/turf/simulated/floor/mineral/bananium,/area/ruin/powered/clownplanet)
"eX" = (/obj/effect/mapping_helpers/no_lava,/turf/simulated/floor/noslip/lavaland,/area/lavaland/surface/outdoors/explored)
"gX" = (/obj/effect/mapping_helpers/no_lava,/turf/simulated/floor/chasm/straight_down/lava_land_surface,/area/lavaland/surface/outdoors/explored)
"hY" = (/obj/machinery/light,/obj/effect/mapping_helpers/no_lava,/turf/simulated/floor/plating/asteroid/basalt/lava_land_surface,/area/ruin/powered/clownplanet)
"pv" = (/obj/machinery/light{dir = 4},/turf/simulated/floor/plating/asteroid/basalt/lava_land_surface,/area/ruin/powered/clownplanet)
"ye" = (/turf/simulated/floor/plating/lava/smooth,/area/ruin/powered/clownplanet)
"CB" = (/obj/item/paper/crumpled/bloody/ruins/lavaland/clown_planet/hope,/obj/effect/decal/cleanable/blood/old,/obj/effect/mapping_helpers/no_lava,/turf/simulated/floor/noslip/lavaland,/area/lavaland/surface/outdoors/explored)
"KX" = (/obj/item/grown/bananapeel{color = "#2F3000"; name = "stealth banana peel"},/obj/effect/mapping_helpers/no_lava,/turf/simulated/floor/plating/asteroid/basalt/lava_land_surface,/area/lavaland/surface/outdoors/explored)
"LH" = (/obj/machinery/disposal/deliveryChute{desc = "The following is engraved upon the chute: A FATE WORSE THAN DEATH LIES WITHIN"; dir = 1; name = "THE TRIAL OF HONKITUDE"},/obj/structure/disposalpipe/trunk,/obj/effect/mapping_helpers/no_lava,/turf/simulated/floor/noslip/lavaland,/area/ruin/powered/clownplanet)
"Mv" = (/obj/effect/mapping_helpers/no_lava,/mob/living/simple_animal/hostile/retaliate/clown,/turf/simulated/floor/plating/asteroid/basalt/lava_land_surface,/area/lavaland/surface/outdoors/explored)
"MR" = (/obj/machinery/light{dir = 8},/obj/effect/mapping_helpers/no_lava,/turf/simulated/floor/plating/asteroid/basalt/lava_land_surface,/area/ruin/powered/clownplanet)
"TD" = (/obj/structure/disposalpipe/trunk,/obj/structure/disposaloutlet{dir = 1},/obj/effect/mapping_helpers/no_lava,/turf/simulated/floor/noslip/lavaland,/area/ruin/powered/clownplanet)
"Xm" = (/obj/item/clothing/head/cone,/obj/effect/mapping_helpers/no_lava,/turf/simulated/floor/noslip/lavaland,/area/lavaland/surface/outdoors/explored)
"XO" = (/obj/effect/mapping_helpers/no_lava,/turf/simulated/floor/plating/asteroid/basalt/lava_land_surface,/area/lavaland/surface/outdoors/explored)
"Yf" = (/obj/machinery/light{dir = 1},/obj/effect/mapping_helpers/no_lava,/turf/simulated/floor/plating/asteroid/basalt/lava_land_surface,/area/ruin/powered/clownplanet)
"YI" = (/obj/machinery/light/small,/obj/effect/mapping_helpers/no_lava,/turf/simulated/floor/noslip/lavaland,/area/ruin/powered/clownplanet)

(1,1,1) = {"
aaaaaaaaaaaaaaaaaaaaaaaaXOXOeXeXeXXOXOaaaaaaaaaaaaaaaaaaaaaaaa
aaaaaaaaaaaaaaaaaaMvhYMvMvXmeXCBeXeXMvMvhYMvaaaaaaaaaaaaaaaaaa
aaaaaaaaaaaaccccccccccccccccLHYITDccccccccccccccccccaaaaaaaaaa
aaaaaaaaccccccyeyeyeyeyeyeccchccchccyeyeyeyeyeyeyeccccaaaaaaaa
aaaaaaccccyeyeyeabacadaeccyechyechyeyeccccaqccccyeyeccccaaaaaa
aaaaccccyeyeabaeafagchafahacaucuaiaLaLaLaLaoccccccccyeccccaaaa
aaaaccyeyeccajafafafakafafafafahayasasarawararasarccyeyeccaaaa
aaccccyeabatapavayavayazapafchaAanamamanaBaLanananaCccyeccccaa
aaccyeyeauahamamanaLamamaCafafahanamaDanaLaPanaLanapcuyeyeccaa
aaccyeadaEafahaLanamamacajafaFavaLananamamamaDananaGccaUyeccaa
aaccyeaAaHaIafaXaLaLaLapafaJchahananananaLaLaKaLaCafaMaUyeccaa
aaccyeadayafaAaLaNaNaNaLapafaxafaOanaLaLaQaRaNaLapafaraUyeccaa
aaccyeaAaSavaLaNaNaNaTaNaLayafafafarccaVaNaNaWaVaLaEcuccyeccaa
aaccccyeaAaLaLaYaNaZaZbaaLanayauavaCccbbbcbcbdbeccccccyeccccaa
aapvccccyeyeccbfbgbcbcbhbibjasbkblavaKbmbcbcbhbfccyeyeccccMRaa
XOXOgXccccccbnccbfbhbfccchalanaCbobpccccbfbqbfccbrccccccgXXOXO
XOgXgXgXccbBbrbsccbrccccaAamaCavbtaLbDbuccchccbsbrbOccgXgXXOgX
XOXOKXgXccbHbBbrccbrbrbrccccavbjbxbvccaAaKbwbrbrbBbBccgXKXXOXO
XOXOgXgXccbBbHbBbrbrbrbBccccccchccccbBbBbrccbrbBbBbBccgXgXXOXO
XOgXgXccccccbHccbBbBbBbBccbLdKbNbMbLccbBbBbBbBbBbBccccccgXgXXO
aapvccccbObBbBccbBccbBccbPbMbQbMbRbMbPccbBbBbBbBbHbBbBccccMRaa
aaccccyebBbHbHbHbHbBccccbSbMbTbUbybMdLccccbHbHbBbWbBbByeccccaa
aaccyeyeaUbYbBccbBbBbBbBccbMbMbMbMbMccbYbBbHbHbBbBccbByeyeccaa
aaccyeaUyebBbBbBbBbHbBbBdMccccbZccccdMbBbHbHbBccbBbByecuyeccaa
aaccyecuyeaUbBbBcabHbBccbBbBccbBbBbBbBbBbBbBbBbBbBbByeaUyeccaa
aaccccyeyeyeccbBbHbBbBbBbHbHbHbHbBbBbHbHbBbWccbBccyeyeyeccccaa
aaaaccyeyeaUyeaUdObBbHbHcabHbBbBbBbBbHbBbBdOccyeyecuyeyeccaaaa
aaaaccccyeyecuyeccyeyeyebBbBbBccbBbBbByeyeccyecuaUyeyeccccaaaa
aaaaaaccccyeyeyeyeaUaUcuyeyeyeyeyeyeyeaUaUaUcuyeyeyeccccaaaaaa
aaaaaaaaccccccyeyeyeyeaUaUaUaUaUaUaUaUcuyeyeyeyeccccccaaaaaaaa
aaaaaaaaaaYfccccccccyeyeyeyeyeyeyeyeyeyeyeccccccccYfaaaaaaaaaa
aaaaaaaaaaaaaaaaaaccccccccccccccccccccccccccaaaaaaaaaaaaaaaaaa
"}
