//MAP CONVERTED BY dmm2tgm.py THIS HEADER COMMENT PREVENTS RECONVERSION, DO NOT REMOVE
"a" = (
/turf/simulated/mineral/volcanic/lava_land_surface,
/area/template_noop)
"b" = (
/turf/simulated/floor/plating/asteroid/basalt/lava_land_surface_hard,
/area/ruin/unpowered/smallcave/cave3)
"d" = (
/turf/simulated/mineral/ancient/lava_land_surface_hard,
/area/ruin/unpowered/smallcave/cave3)
"q" = (
/turf/template_noop,
/area/template_noop)
"K" = (
/obj/effect/baseturf_helper/lava_land/surface,
/turf/simulated/floor/plating/asteroid/basalt/lava_land_surface_hard,
/area/ruin/unpowered/smallcave/cave3)

(1,1,1) = {"
q
d
d
d
a
q
q
q
q
q
q
d
d
d
q
q
q
"}
(2,1,1) = {"
d
d
d
a
a
a
a
q
q
q
d
d
d
d
d
d
q
"}
(3,1,1) = {"
d
d
b
b
b
d
d
d
q
d
d
d
b
b
d
d
d
"}
(4,1,1) = {"
d
d
b
b
b
d
d
d
d
d
d
b
b
b
b
d
d
"}
(5,1,1) = {"
d
d
b
b
b
b
b
d
d
b
b
b
b
b
b
d
d
"}
(6,1,1) = {"
q
d
d
b
b
b
b
b
b
b
b
b
b
b
b
d
d
"}
(7,1,1) = {"
q
d
d
d
b
b
b
b
b
b
d
d
b
b
b
a
d
"}
(8,1,1) = {"
q
q
d
d
d
b
b
b
b
d
d
d
d
b
a
a
a
"}
(9,1,1) = {"
q
q
d
d
d
b
b
K
d
d
d
d
d
d
a
a
q
"}
(10,1,1) = {"
q
d
d
d
b
b
b
b
d
b
d
d
d
d
d
a
q
"}
(11,1,1) = {"
a
a
d
b
b
b
b
b
b
b
b
d
b
b
a
a
q
"}
(12,1,1) = {"
a
a
b
b
b
b
b
b
b
b
b
b
b
b
a
a
a
"}
(13,1,1) = {"
a
b
b
b
b
b
b
b
b
b
b
b
b
b
b
a
d
"}
(14,1,1) = {"
d
b
b
b
d
d
a
a
b
b
b
b
b
b
d
d
d
"}
(15,1,1) = {"
d
d
b
b
d
a
a
a
a
b
b
b
b
b
d
d
q
"}
(16,1,1) = {"
d
d
d
d
d
q
q
q
a
d
d
b
b
d
d
d
q
"}
(17,1,1) = {"
q
q
d
d
q
q
q
q
q
d
d
d
d
d
d
q
q
"}
