//MAP CONVERTED BY dmm2tgm.py THIS HEADER COMMENT PREVENTS RECONVERSION, DO NOT REMOVE
"a" = (
/turf/simulated/floor/plating/asteroid/basalt/lava_land_surface,
/area/lavaland/surface/outdoors)
"b" = (
/turf/simulated/mineral/random/high_chance/clown,
/area/ruin/unpowered/cavecomplex/cave3)
"d" = (
/turf/simulated/mineral/ancient/lava_land_surface_hard,
/area/ruin/unpowered/cavecomplex/cave3)
"i" = (
/obj/effect/baseturf_helper/lava_land/surface,
/turf/simulated/mineral/random/high_chance/clown,
/area/ruin/unpowered/cavecomplex/cave3)
"q" = (
/turf/template_noop,
/area/template_noop)
"s" = (
/turf/simulated/mineral/volcanic/lava_land_surface,
/area/lavaland/surface/outdoors)
"N" = (
/turf/simulated/floor/plating/asteroid/basalt/lava_land_surface_hard,
/area/ruin/unpowered/cavecomplex/cave3)

(1,1,1) = {"
q
q
q
q
q
q
q
q
q
q
q
q
q
q
q
q
q
q
q
q
q
q
q
q
q
q
q
q
q
q
q
q
q
d
d
d
d
d
q
q
q
q
q
q
q
q
q
q
q
"}
(2,1,1) = {"
q
q
q
q
q
q
q
q
q
q
q
q
q
q
q
q
q
q
q
q
q
q
q
a
a
a
a
q
q
q
q
q
d
d
d
d
d
d
d
d
q
q
q
a
q
q
q
q
q
"}
(3,1,1) = {"
q
q
q
q
q
q
q
q
q
q
q
q
q
q
q
q
q
q
q
q
a
a
a
a
a
a
a
a
a
a
q
q
d
d
N
N
N
d
d
d
d
q
q
a
q
q
q
q
q
"}
(4,1,1) = {"
q
q
q
q
q
q
q
q
q
q
q
a
a
a
a
a
q
q
a
a
a
a
a
a
a
a
a
a
a
a
a
a
d
N
N
N
N
N
N
N
d
d
a
a
q
q
q
q
q
"}
(5,1,1) = {"
q
q
q
q
q
q
q
q
d
d
a
a
a
a
a
a
a
q
a
a
a
a
q
q
q
q
q
q
q
a
a
a
a
N
N
N
N
N
N
N
N
s
s
q
q
q
q
q
q
"}
(6,1,1) = {"
q
q
q
q
q
q
d
d
d
s
a
a
q
q
q
a
a
a
a
a
q
q
q
q
q
q
q
q
q
q
q
a
a
N
N
N
N
N
N
N
N
d
d
d
q
q
q
q
q
"}
(7,1,1) = {"
q
q
q
q
q
d
d
d
s
s
s
q
q
q
q
q
a
a
a
q
q
q
q
q
q
q
q
q
q
q
q
d
d
d
N
N
N
N
N
N
N
N
d
d
d
q
q
q
q
"}
(8,1,1) = {"
q
q
q
q
d
d
N
N
N
s
d
q
q
q
q
q
a
a
q
q
q
q
q
q
q
q
q
q
q
q
q
d
d
d
N
N
N
N
N
N
N
N
N
d
d
q
q
q
q
"}
(9,1,1) = {"
q
q
q
d
d
d
N
N
N
d
d
q
q
q
q
q
a
a
a
q
q
q
q
q
q
q
q
q
q
q
d
d
d
N
N
N
N
N
d
d
N
N
N
d
d
d
q
q
q
"}
(10,1,1) = {"
q
q
d
d
d
N
N
N
N
N
d
d
q
q
q
a
a
a
a
a
q
q
q
q
q
q
q
q
q
q
d
d
N
N
N
N
N
N
d
d
d
N
N
N
d
d
q
q
q
"}
(11,1,1) = {"
q
q
d
d
N
N
N
N
N
N
d
d
q
q
q
a
q
q
a
a
a
q
q
q
q
q
q
q
q
q
d
d
N
N
N
N
N
d
d
d
d
N
N
N
d
d
q
q
q
"}
(12,1,1) = {"
q
q
d
d
N
N
N
N
N
N
N
d
q
q
a
a
q
q
q
a
a
a
a
q
q
q
q
q
q
q
d
d
N
N
N
N
N
d
d
d
d
d
N
N
s
d
q
q
q
"}
(13,1,1) = {"
q
q
q
d
d
N
N
N
N
N
N
d
q
q
a
a
q
q
q
q
a
a
a
a
a
a
a
a
q
q
d
d
d
N
N
N
d
d
q
q
d
d
d
s
s
s
q
q
q
"}
(14,1,1) = {"
q
q
q
d
d
d
N
N
N
N
d
d
q
q
a
q
q
q
q
a
a
a
a
a
a
a
a
a
a
a
a
d
d
d
d
d
d
d
q
q
q
d
d
d
s
a
q
q
q
"}
(15,1,1) = {"
q
q
q
q
d
d
d
N
N
d
d
d
q
q
q
q
q
q
a
a
a
d
d
d
d
d
d
a
a
a
a
a
d
d
d
d
q
q
q
q
q
q
q
q
a
a
a
q
q
"}
(16,1,1) = {"
q
q
q
q
q
d
a
a
a
d
d
q
q
q
q
q
q
a
a
d
d
d
d
d
d
d
d
d
d
d
a
a
a
d
d
q
q
q
q
q
q
q
q
q
a
a
a
q
q
"}
(17,1,1) = {"
q
q
q
q
q
q
a
a
d
d
q
q
q
q
q
q
d
d
d
d
d
d
d
b
b
b
d
d
d
d
a
a
a
q
q
q
q
q
q
q
q
q
q
q
q
a
a
q
q
"}
(18,1,1) = {"
q
q
q
q
q
a
a
a
q
q
q
q
q
q
q
q
d
d
d
b
b
b
b
b
b
b
b
b
d
d
d
a
a
a
q
q
q
q
q
q
q
q
q
q
q
a
a
a
q
"}
(19,1,1) = {"
q
q
q
q
q
a
a
a
q
q
q
q
q
q
q
q
d
d
b
b
b
b
b
b
b
b
b
b
b
d
d
d
a
a
q
q
q
q
q
q
q
q
q
q
q
q
a
a
q
"}
(20,1,1) = {"
q
q
q
q
a
a
a
q
q
q
q
q
q
q
a
d
d
b
b
b
b
b
b
b
b
b
b
b
b
b
d
d
a
a
q
q
q
q
q
q
q
q
q
q
q
q
a
a
q
"}
(21,1,1) = {"
q
q
q
q
a
a
a
q
q
q
q
q
q
a
a
d
d
b
b
b
b
b
b
b
b
b
b
b
b
b
d
d
a
a
q
q
q
q
q
q
q
q
q
q
q
q
a
a
q
"}
(22,1,1) = {"
q
q
q
a
a
a
a
q
q
q
q
q
q
a
d
d
d
b
b
b
b
b
b
b
b
b
b
b
b
b
d
d
a
a
q
q
q
q
q
q
q
q
q
q
q
q
q
a
q
"}
(23,1,1) = {"
q
a
a
a
a
a
q
q
q
q
q
q
a
a
d
d
d
b
b
b
b
b
b
b
b
b
b
b
b
b
d
d
a
a
a
q
a
a
a
a
a
q
q
q
q
q
q
a
q
"}
(24,1,1) = {"
q
q
q
q
a
a
q
q
q
q
q
q
a
a
d
d
b
b
b
b
b
b
b
b
b
b
b
b
b
b
d
d
a
a
a
a
a
a
a
a
a
a
a
q
q
q
q
q
q
"}
(25,1,1) = {"
q
q
q
q
a
a
a
q
q
q
q
a
a
a
d
d
b
b
b
b
b
b
b
b
i
b
b
b
b
b
d
d
a
a
a
a
a
a
q
q
a
a
a
d
q
q
q
q
q
"}
(26,1,1) = {"
q
q
q
q
q
a
a
a
q
q
a
a
a
a
d
d
b
b
b
b
b
b
b
b
b
b
b
b
b
b
d
d
a
a
q
q
q
q
q
q
d
a
a
d
d
q
q
q
q
"}
(27,1,1) = {"
q
q
q
q
q
a
a
a
a
a
a
a
a
a
a
d
d
b
b
b
b
b
b
b
b
b
b
b
b
d
d
a
a
q
q
q
q
q
q
q
d
a
N
d
d
q
q
q
q
"}
(28,1,1) = {"
q
q
q
q
q
q
q
a
a
a
a
q
a
a
a
d
d
b
b
b
b
b
b
b
b
b
b
b
b
d
d
a
q
q
q
q
q
q
q
d
d
N
N
d
d
q
q
q
q
"}
(29,1,1) = {"
q
q
q
q
q
q
q
q
q
q
q
q
a
a
a
a
d
d
b
b
b
b
b
b
b
b
b
b
d
d
a
a
q
q
q
q
q
q
q
d
d
N
N
N
d
d
q
q
q
"}
(30,1,1) = {"
q
q
q
q
q
a
q
q
q
q
q
q
q
q
a
a
a
d
d
d
d
b
b
b
b
b
d
d
d
d
q
q
q
q
q
q
q
q
q
d
d
N
N
N
d
d
q
q
q
"}
(31,1,1) = {"
q
q
q
q
q
a
q
q
q
q
q
q
q
q
q
a
a
d
d
d
d
d
d
d
d
d
d
d
d
q
q
q
q
q
q
q
q
q
d
d
N
N
N
N
d
d
q
q
q
"}
(32,1,1) = {"
q
q
q
q
a
a
q
q
q
q
q
q
q
q
q
q
a
a
a
d
d
d
d
d
d
d
d
q
q
q
q
q
q
q
q
q
q
q
d
d
N
N
N
N
d
d
q
q
q
"}
(33,1,1) = {"
q
q
q
q
a
q
q
q
q
q
q
q
q
q
q
q
q
a
a
a
a
a
a
a
a
q
q
q
q
q
q
q
q
q
q
q
q
d
d
N
N
N
N
d
d
d
q
q
q
"}
(34,1,1) = {"
q
q
q
q
a
a
q
q
q
q
q
q
q
q
q
q
q
q
q
a
a
a
a
a
a
a
q
q
q
q
q
q
q
a
q
q
q
d
d
N
N
N
N
d
d
d
q
q
q
"}
(35,1,1) = {"
q
q
q
q
a
a
a
a
q
q
q
q
q
q
q
q
q
q
q
q
q
q
q
q
a
a
a
q
q
q
q
q
q
a
q
q
q
d
N
N
N
N
N
d
d
q
q
q
q
"}
(36,1,1) = {"
q
q
q
q
q
a
a
a
a
a
q
q
q
q
q
q
q
q
q
q
q
q
q
q
q
a
a
q
q
q
q
a
a
a
q
q
d
d
N
N
N
N
d
d
d
q
q
q
q
"}
(37,1,1) = {"
q
q
q
q
q
a
a
a
a
a
a
q
q
q
q
q
q
q
q
q
q
q
q
q
q
a
a
a
a
a
a
a
a
q
q
q
d
d
N
N
N
d
d
d
q
q
q
q
q
"}
(38,1,1) = {"
q
q
q
q
a
a
q
q
q
a
a
a
q
q
q
q
q
q
d
d
q
q
q
q
q
q
a
a
a
a
a
q
q
q
q
d
d
d
N
N
N
d
d
q
q
q
q
q
q
"}
(39,1,1) = {"
q
q
q
a
a
q
q
q
q
q
a
a
a
q
q
d
d
d
d
d
d
d
q
q
q
q
a
a
a
q
q
q
q
q
q
d
d
N
N
N
N
d
d
d
q
q
q
q
q
"}
(40,1,1) = {"
q
q
q
a
a
q
q
q
q
q
q
a
a
q
d
d
d
d
N
N
d
d
d
q
q
q
q
a
a
q
q
q
q
q
q
d
d
N
N
N
N
N
d
d
q
q
q
q
q
"}
(41,1,1) = {"
q
q
a
a
q
q
q
q
q
q
q
a
a
s
d
d
d
N
N
N
N
d
d
q
q
q
q
a
a
q
q
q
q
q
q
d
d
N
N
N
N
d
d
d
q
q
q
q
q
"}
(42,1,1) = {"
q
q
a
a
q
q
q
q
q
q
q
q
s
s
d
N
N
N
N
N
d
d
d
q
q
q
a
a
a
a
q
q
q
q
q
d
d
N
N
N
N
d
d
q
q
q
q
q
q
"}
(43,1,1) = {"
q
q
a
a
q
q
q
q
q
q
q
d
s
s
N
N
N
N
N
N
a
a
a
a
q
a
a
a
a
a
a
q
q
q
q
d
d
a
a
N
d
d
q
q
q
q
q
q
q
"}
(44,1,1) = {"
q
q
a
a
q
q
q
q
q
q
q
d
d
N
N
N
N
N
N
N
N
a
a
a
a
a
q
q
a
a
a
a
q
q
q
q
d
a
a
a
d
q
q
q
q
q
q
q
q
"}
(45,1,1) = {"
q
q
a
q
q
q
q
q
q
q
q
d
d
d
N
N
N
N
N
N
d
d
q
a
a
q
q
q
q
q
a
a
a
a
q
q
a
a
a
a
q
q
q
q
q
q
q
q
q
"}
(46,1,1) = {"
q
q
a
q
q
q
q
q
q
q
q
d
d
d
N
N
N
N
N
d
d
q
q
q
q
q
q
q
q
q
q
a
a
a
a
a
a
a
q
q
q
q
q
q
q
q
q
q
q
"}
(47,1,1) = {"
q
q
q
q
q
q
q
q
q
q
q
q
d
d
d
N
N
N
d
d
d
q
q
q
q
q
q
q
q
q
q
q
q
a
a
a
a
q
q
q
q
q
q
q
q
q
q
q
q
"}
(48,1,1) = {"
q
q
q
q
q
q
q
q
q
q
q
q
q
d
d
d
d
d
d
d
q
q
q
q
q
q
q
q
q
q
q
q
q
q
q
q
q
q
q
q
q
q
q
q
q
q
q
q
q
"}
(49,1,1) = {"
q
q
q
q
q
q
q
q
q
q
q
q
q
q
q
d
d
d
q
q
q
q
q
q
q
q
q
q
q
q
q
q
q
q
q
q
q
q
q
q
q
q
q
q
q
q
q
q
q
"}
