//MAP CONVERTED BY dmm2tgm.py THIS HEADER COMMENT PREVENTS RECONVERSION, DO NOT REMOVE
"aa" = (
/turf/template_noop,
/area/template_noop)
"ad" = (
/obj/structure/flora/ausbushes/leafybush,
/turf/simulated/floor/beach/sand,
/area/ruin/powered/beach)
"al" = (
/obj/effect/turf_decal/sand/plating,
/obj/effect/turf_decal/stripes/asteroid/line{
	dir = 1
	},
/turf/simulated/floor/plasteel,
/area/ruin/powered/beach)
"am" = (
/obj/item/reagent_containers/spray/spraytan,
/obj/effect/turf_decal/sand/plating,
/turf/simulated/floor/plasteel,
/area/ruin/powered/beach)
"ap" = (
/obj/structure/flora/ausbushes/sparsegrass,
/turf/simulated/floor/beach/sand,
/area/ruin/powered/beach)
"aq" = (
/obj/structure/flora/ausbushes/sunnybush,
/turf/simulated/floor/beach/sand,
/area/ruin/powered/beach)
"az" = (
/obj/item/clothing/accessory/necklace/dope,
/obj/item/reagent_containers/spray/spraytan,
/turf/simulated/floor/beach/sand,
/area/ruin/powered/beach)
"aA" = (
/obj/item/reagent_containers/spray/spraytan,
/turf/simulated/floor/beach/sand,
/area/ruin/powered/beach)
"aK" = (
/obj/effect/turf_decal/sand,
/turf/simulated/floor/beach/sand,
/area/ruin/powered/beach)
"aL" = (
/obj/effect/turf_decal/sand/plating,
/obj/structure/chair/stool,
/turf/simulated/floor/plasteel,
/area/ruin/powered/beach)
"aU" = (
/obj/effect/overlay/palmtree_l,
/turf/simulated/floor/beach/sand,
/area/ruin/powered/beach)
"aV" = (
/obj/effect/mob_spawn/human/beach/alive,
/turf/simulated/floor/beach/sand,
/area/ruin/powered/beach)
"aZ" = (
/obj/effect/overlay/coconut,
/turf/simulated/floor/beach/sand,
/area/ruin/powered/beach)
"bi" = (
/obj/structure/closet/athletic_mixed,
/obj/effect/turf_decal/sand,
/turf/simulated/floor/pod,
/area/ruin/powered/beach)
"bj" = (
/obj/structure/rack,
/obj/item/clothing/shoes/sandal,
/obj/item/clothing/shoes/sandal,
/obj/effect/turf_decal/sand,
/turf/simulated/floor/pod,
/area/ruin/powered/beach)
"bk" = (
/obj/machinery/light/small{
	dir = 4
	},
/obj/effect/turf_decal/sand,
/turf/simulated/floor/pod,
/area/ruin/powered/beach)
"bl" = (
/obj/effect/turf_decal/sand,
/turf/simulated/floor/pod/light,
/area/ruin/powered/beach)
"bm" = (
/obj/machinery/light{
	dir = 8
	},
/obj/effect/turf_decal/sand,
/turf/simulated/floor/beach/sand,
/area/ruin/powered/beach)
"bn" = (
/obj/machinery/light{
	dir = 4
	},
/obj/effect/turf_decal/sand,
/turf/simulated/floor/beach/sand,
/area/ruin/powered/beach)
"bo" = (
/obj/machinery/shower{
	dir = 4
	},
/obj/effect/turf_decal/sand,
/turf/simulated/floor/pod/light,
/area/ruin/powered/beach)
"bp" = (
/obj/machinery/light/small{
	dir = 8;
	light_power = 3
	},
/obj/effect/turf_decal/sand,
/turf/simulated/floor/pod,
/area/ruin/powered/beach)
"bq" = (
/obj/effect/turf_decal/sand,
/turf/simulated/floor/pod,
/area/ruin/powered/beach)
"br" = (
/obj/effect/baseturf_helper/lava_land/surface,
/obj/effect/turf_decal/sand,
/turf/simulated/floor/beach/sand,
/area/ruin/powered/beach)
"bx" = (
/obj/structure/flora/rock,
/turf/simulated/floor/beach/sand,
/area/ruin/powered/beach)
"bz" = (
/mob/living/simple_animal/crab,
/turf/simulated/floor/beach/sand,
/area/ruin/powered/beach)
"bA" = (
/obj/structure/window/reinforced{
	dir = 1
	},
/obj/structure/window/reinforced{
	dir = 8
	},
/obj/item/bikehorn/airhorn,
/obj/structure/table/wood,
/obj/item/storage/firstaid/regular,
/obj/item/storage/firstaid/brute,
/turf/simulated/floor/wood,
/area/ruin/powered/beach)
"bB" = (
/obj/structure/window/reinforced{
	dir = 4
	},
/obj/structure/window/reinforced{
	dir = 1;
	layer = 2.9
	},
/obj/structure/chair/stool,
/turf/simulated/floor/wood,
/area/ruin/powered/beach)
"bE" = (
/turf/simulated/floor/beach/sand,
/area/ruin/powered/beach)
"bF" = (
/obj/item/beach_ball,
/turf/simulated/floor/beach/sand,
/area/ruin/powered/beach)
"bG" = (
/obj/structure/window/reinforced{
	dir = 8
	},
/obj/structure/window/reinforced,
/obj/item/megaphone,
/turf/simulated/floor/wood,
/area/ruin/powered/beach)
"bH" = (
/obj/structure/window/reinforced{
	dir = 4
	},
/obj/effect/mob_spawn/human/beach/alive/lifeguard,
/turf/simulated/floor/wood,
/area/ruin/powered/beach)
"bJ" = (
/obj/structure/chair,
/turf/simulated/floor/beach/sand,
/area/ruin/powered/beach)
"bK" = (
/obj/item/storage/backpack/duffel,
/turf/simulated/floor/beach/sand,
/area/ruin/powered/beach)
"bL" = (
/obj/machinery/poolcontroller/invisible,
/turf/simulated/floor/beach/water,
/area/ruin/powered/beach)
"bM" = (
/turf/simulated/floor/plasteel/stairs/old,
/area/ruin/powered/beach)
"bN" = (
/obj/structure/flora/ausbushes/reedbush,
/turf/simulated/floor/beach/sand,
/area/ruin/powered/beach)
"bO" = (
/obj/item/camera,
/turf/simulated/floor/beach/sand,
/area/ruin/powered/beach)
"bP" = (
/obj/item/reagent_containers/food/drinks/cans/beer,
/turf/simulated/floor/beach/sand,
/area/ruin/powered/beach)
"bQ" = (
/obj/structure/flora/ausbushes/reedbush,
/turf/simulated/floor/beach/coastline_t,
/area/ruin/powered/beach)
"bR" = (
/turf/simulated/floor/beach/coastline_t,
/area/ruin/powered/beach)
"bS" = (
/obj/structure/flora/ausbushes/sparsegrass,
/turf/simulated/floor/beach/coastline_t,
/area/ruin/powered/beach)
"bT" = (
/turf/simulated/floor/beach/coastline_b,
/area/ruin/powered/beach)
"bU" = (
/turf/simulated/floor/beach/water,
/area/ruin/powered/beach)
"bV" = (
/obj/structure/flora/ausbushes/stalkybush,
/turf/simulated/floor/beach/water,
/area/ruin/powered/beach)
"bW" = (
/turf/simulated/wall/r_wall,
/area/ruin/powered/beach)
"cs" = (
/obj/effect/overlay/palmtree_l,
/obj/machinery/light{
	dir = 4
	},
/turf/simulated/floor/beach/sand,
/area/ruin/powered/beach)
"ct" = (
/obj/machinery/light,
/turf/simulated/floor/beach/water,
/area/ruin/powered/beach)
"cz" = (
/obj/effect/turf_decal/sand/plating,
/obj/effect/turf_decal/caution{
	dir = 4
	},
/turf/simulated/floor/plasteel,
/area/ruin/powered/beach)
"cP" = (
/obj/structure/flora/tree/palm{
	pixel_x = -7;
	pixel_y = 18
	},
/turf/simulated/floor/beach/sand,
/area/ruin/powered/beach)
"cR" = (
/obj/structure/table/wood,
/obj/item/tank/internals/oxygen,
/obj/item/pickaxe,
/obj/item/clothing/mask/gas,
/turf/simulated/floor/pod,
/area/ruin/powered/beach)
"dR" = (
/obj/structure/table,
/obj/item/reagent_containers/food/drinks/shaker,
/obj/item/reagent_containers/glass/rag,
/obj/machinery/light{
	dir = 1
	},
/turf/simulated/floor/wood,
/area/ruin/powered/beach)
"fo" = (
/obj/effect/turf_decal/sand,
/obj/structure/urinal{
	pixel_y = 28
	},
/turf/simulated/floor/plating,
/area/ruin/powered/beach)
"fY" = (
/obj/effect/turf_decal/sand/plating,
/obj/effect/turf_decal/caution{
	dir = 1
	},
/turf/simulated/floor/plasteel,
/area/ruin/powered/beach)
"gg" = (
/obj/effect/turf_decal/sand/plating,
/turf/simulated/floor/plasteel,
/area/ruin/powered/beach)
"hw" = (
/obj/structure/table/wood,
/obj/item/clothing/glasses/sunglasses/big,
/obj/item/clothing/glasses/sunglasses/big{
	pixel_y = 9
	},
/turf/simulated/floor/wood,
/area/ruin/powered/beach)
"hy" = (
/obj/machinery/door/airlock/sandstone{
	name = "Restroom"
	},
/obj/effect/turf_decal/sand,
/turf/simulated/floor/plating,
/area/ruin/powered/beach)
"iD" = (
/obj/effect/turf_decal/sand/plating,
/obj/effect/turf_decal/caution,
/turf/simulated/floor/plasteel,
/area/ruin/powered/beach)
"jC" = (
/obj/machinery/door/airlock/sandstone{
	name = "Restroom"
	},
/turf/simulated/floor/plating,
/area/ruin/powered/beach)
"lh" = (
/obj/structure/weightmachine/stacklifter,
/turf/simulated/floor/beach/sand,
/area/ruin/powered/beach)
"lt" = (
/obj/machinery/door/airlock/sandstone{
	name = "Bar Storage"
	},
/turf/simulated/floor/wood,
/area/ruin/powered/beach)
"lF" = (
/obj/machinery/light{
	dir = 4
	},
/turf/simulated/floor/pod/light,
/area/ruin/powered/beach)
"lM" = (
/obj/structure/dresser,
/turf/simulated/floor/pod,
/area/ruin/powered/beach)
"lT" = (
/obj/structure/sign/barsign,
/turf/simulated/wall/mineral/sandstone,
/area/ruin/powered/beach)
"lY" = (
/obj/structure/table,
/obj/machinery/chem_dispenser/beer,
/turf/simulated/floor/wood,
/area/ruin/powered/beach)
"mh" = (
/obj/effect/spawner/window,
/turf/simulated/floor/plating,
/area/ruin/powered/beach)
"nR" = (
/obj/structure/reagent_dispensers/fueltank,
/turf/simulated/floor/plating,
/area/ruin/powered/beach)
"oN" = (
/turf/simulated/floor/wood,
/area/ruin/powered/beach)
"pg" = (
/obj/effect/turf_decal/sand,
/obj/structure/sink{
	dir = 4;
	pixel_x = 12
	},
/turf/simulated/floor/plating,
/area/ruin/powered/beach)
"pI" = (
/obj/machinery/door/airlock/hatch{
	name = "Lava Beach Club"
	},
/obj/structure/fans/tiny,
/turf/simulated/floor/pod,
/area/ruin/powered/beach)
"qa" = (
/obj/machinery/light/small{
	dir = 4
	},
/turf/simulated/floor/pod,
/area/ruin/powered/beach)
"qf" = (
/obj/structure/table,
/obj/machinery/kitchen_machine/microwave,
/turf/simulated/floor/wood,
/area/ruin/powered/beach)
"qT" = (
/obj/machinery/shower{
	dir = 8
	},
/turf/simulated/floor/pod/light,
/area/ruin/powered/beach)
"ry" = (
/obj/structure/table,
/obj/item/storage/toolbox/mechanical,
/obj/item/storage/box/lights/mixed,
/obj/item/stack/cable_coil,
/obj/machinery/light/small{
	dir = 1
	},
/obj/item/storage/box/donkpockets,
/turf/simulated/floor/plating,
/area/ruin/powered/beach)
"rC" = (
/obj/machinery/portable_atmospherics/canister/oxygen,
/turf/simulated/floor/plating,
/area/ruin/powered/beach)
"rX" = (
/obj/item/tank/internals/oxygen,
/turf/simulated/floor/plating,
/area/ruin/powered/beach)
"sq" = (
/turf/simulated/floor/plating,
/area/ruin/powered/beach)
"tq" = (
/obj/structure/table/wood,
/obj/item/clothing/glasses/sunglasses/big{
	pixel_y = 9
	},
/obj/item/clothing/glasses/sunglasses/big,
/turf/simulated/floor/wood,
/area/ruin/powered/beach)
"uA" = (
/obj/item/radio/beacon,
/turf/simulated/floor/beach/sand,
/area/ruin/powered/beach)
"uP" = (
/obj/machinery/light{
	dir = 8
	},
/obj/structure/flora/rock,
/turf/simulated/floor/beach/sand,
/area/ruin/powered/beach)
"vu" = (
/obj/effect/turf_decal/sand/plating,
/obj/structure/closet/crate,
/obj/item/toy/figure/bartender,
/obj/item/trash/candy,
/obj/item/tank/internals/emergency_oxygen,
/obj/effect/turf_decal/stripes/asteroid/line{
	dir = 1
	},
/turf/simulated/floor/plasteel,
/area/ruin/powered/beach)
"wf" = (
/obj/structure/table/wood,
/obj/item/reagent_containers/food/drinks/bottle/tequila{
	pixel_y = 7
	},
/turf/simulated/floor/wood,
/area/ruin/powered/beach)
"wl" = (
/obj/effect/turf_decal/sand/plating,
/obj/effect/turf_decal/caution{
	dir = 8
	},
/turf/simulated/floor/plasteel,
/area/ruin/powered/beach)
"xU" = (
/obj/effect/turf_decal/sand,
/obj/machinery/light/small{
	dir = 1
	},
/obj/structure/toilet,
/turf/simulated/floor/plating,
/area/ruin/powered/beach)
"yc" = (
/obj/structure/weightmachine/weightlifter,
/turf/simulated/floor/beach/sand,
/area/ruin/powered/beach)
"zw" = (
/obj/structure/closet/athletic_mixed,
/turf/simulated/floor/pod,
/area/ruin/powered/beach)
"zz" = (
/obj/structure/table,
/obj/machinery/reagentgrinder,
/turf/simulated/floor/wood,
/area/ruin/powered/beach)
"zM" = (
/obj/structure/table,
/obj/item/storage/box/beakers,
/obj/item/reagent_containers/spray/spraytan,
/obj/item/storage/box/drinkingglasses,
/turf/simulated/floor/plating,
/area/ruin/powered/beach)
"Bl" = (
/obj/machinery/light{
	dir = 8
	},
/turf/simulated/floor/beach/sand,
/area/ruin/powered/beach)
"Bo" = (
/obj/structure/table/wood,
/obj/item/flashlight/lamp,
/turf/simulated/floor/wood,
/area/ruin/powered/beach)
"DN" = (
/obj/effect/turf_decal/sand,
/turf/simulated/floor/plating,
/area/ruin/powered/beach)
"Ec" = (
/obj/machinery/door/airlock/sandstone{
	name = "Beach Access"
	},
/turf/simulated/floor/pod,
/area/ruin/powered/beach)
"Ek" = (
/obj/effect/turf_decal/sand/plating,
/obj/machinery/vending/cigarette/beach,
/turf/simulated/floor/plasteel,
/area/ruin/powered/beach)
"Gc" = (
/turf/simulated/floor/pod/light,
/area/ruin/powered/beach)
"HC" = (
/obj/structure/rack,
/obj/item/clothing/shoes/sandal,
/obj/item/clothing/shoes/sandal,
/turf/simulated/floor/pod,
/area/ruin/powered/beach)
"Ky" = (
/obj/structure/reagent_dispensers/beerkeg,
/turf/simulated/floor/wood,
/area/ruin/powered/beach)
"KF" = (
/obj/effect/mob_spawn/human/bartender/alive,
/turf/simulated/floor/plating,
/area/ruin/powered/beach)
"KX" = (
/obj/effect/turf_decal/sand/plating,
/obj/machinery/vending/cola/free,
/turf/simulated/floor/plasteel,
/area/ruin/powered/beach)
"Lm" = (
/obj/item/flashlight/lantern,
/obj/machinery/light/small{
	dir = 1
	},
/turf/simulated/floor/plating,
/area/ruin/powered/beach)
"Ml" = (
/turf/simulated/wall/mineral/sandstone,
/area/ruin/powered/beach)
"Ns" = (
/obj/machinery/disco/immobile,
/turf/simulated/floor/light/colour_cycle,
/area/ruin/powered/beach)
"NQ" = (
/obj/machinery/door/airlock/sandstone{
	name = "Bar"
	},
/turf/simulated/floor/wood,
/area/ruin/powered/beach)
"Pl" = (
/obj/effect/turf_decal/sand/plating,
/turf/simulated/floor/beach/sand,
/area/ruin/powered/beach)
"Qv" = (
/obj/machinery/vending/boozeomat,
/turf/simulated/floor/wood,
/area/ruin/powered/beach)
"QS" = (
/obj/machinery/light{
	dir = 4
	},
/turf/simulated/floor/beach/sand,
/area/ruin/powered/beach)
"SA" = (
/obj/structure/urinal{
	pixel_y = 28
	},
/turf/simulated/floor/plating,
/area/ruin/powered/beach)
"Tq" = (
/obj/structure/table,
/obj/item/ammo_box/shotgun/beanbag,
/obj/item/gun/projectile/revolver/doublebarrel,
/turf/simulated/floor/plating,
/area/ruin/powered/beach)
"TD" = (
/obj/effect/mapping_helpers/no_lava,
/turf/simulated/floor/plating/asteroid/basalt/lava_land_surface,
/area/lavaland/surface/outdoors)
"TJ" = (
/obj/structure/table,
/obj/machinery/chem_dispenser/soda,
/obj/machinery/light{
	dir = 1
	},
/turf/simulated/floor/wood,
/area/ruin/powered/beach)
"TP" = (
/obj/machinery/light{
	dir = 8
	},
/turf/simulated/floor/pod/light,
/area/ruin/powered/beach)
"TS" = (
/obj/structure/closet/secure_closet/freezer/meat,
/turf/simulated/floor/wood,
/area/ruin/powered/beach)
"UU" = (
/obj/effect/turf_decal/sand/plating,
/obj/machinery/light{
	dir = 1
	},
/turf/simulated/floor/plasteel,
/area/ruin/powered/beach)
"VO" = (
/turf/simulated/floor/pod,
/area/ruin/powered/beach)
"WF" = (
/obj/effect/turf_decal/sand,
/obj/machinery/light{
	dir = 1
	},
/turf/simulated/floor/beach/sand,
/area/ruin/powered/beach)
"Xp" = (
/obj/machinery/light/small{
	dir = 8;
	light_power = 3
	},
/turf/simulated/floor/pod,
/area/ruin/powered/beach)
"YN" = (
/obj/effect/turf_decal/sand/plating,
/obj/machinery/vending/snack/free,
/turf/simulated/floor/plasteel,
/area/ruin/powered/beach)
"ZW" = (
/obj/machinery/processor,
/turf/simulated/floor/wood,
/area/ruin/powered/beach)

(1,1,1) = {"
aa
aa
aa
aa
aa
aa
aa
aa
aa
aa
aa
TD
TD
TD
TD
TD
TD
TD
aa
aa
aa
aa
aa
aa
aa
aa
aa
aa
"}
(2,1,1) = {"
aa
aa
aa
aa
aa
aa
aa
aa
aa
TD
TD
TD
TD
TD
TD
TD
TD
TD
TD
TD
aa
aa
aa
aa
aa
aa
aa
aa
"}
(3,1,1) = {"
aa
aa
aa
aa
aa
aa
aa
aa
lF
TD
bW
bW
bW
pI
bW
pI
bW
bW
bW
TD
lF
aa
aa
aa
aa
aa
aa
aa
"}
(4,1,1) = {"
aa
aa
aa
aa
aa
bW
bW
bW
bW
bW
bW
zw
Xp
Gc
bo
Gc
bp
cR
bW
bW
bW
bW
bW
aa
aa
aa
aa
aa
"}
(5,1,1) = {"
aa
aa
aa
bW
bW
bW
ap
Bl
bE
bE
bW
HC
VO
bl
bl
Gc
VO
lM
bW
ad
bQ
bT
bW
bW
bW
aa
aa
aa
"}
(6,1,1) = {"
aa
aa
bW
bW
ap
bE
bE
bE
bE
bE
bW
mh
mh
mh
Ec
mh
mh
mh
bW
ap
bR
bT
bU
ct
bW
bW
aa
aa
"}
(7,1,1) = {"
aa
bW
bW
ad
bE
bE
lh
bE
yc
bE
uP
bE
bE
bm
aK
bm
bE
bE
Bl
bN
bR
bT
bU
bU
bU
bW
bW
aa
"}
(8,1,1) = {"
aa
bW
aq
bE
bE
bE
bE
aV
bE
bE
bE
bE
bE
bE
bE
bE
bz
bE
bJ
bE
bS
bT
bU
bU
bU
bU
bW
aa
"}
(9,1,1) = {"
bW
bW
bE
ap
az
bE
lh
bE
yc
bE
bE
bE
aU
aZ
bE
bE
bE
bE
bE
bE
bR
bT
bU
bU
bU
ct
bW
bW
"}
(10,1,1) = {"
bW
ad
bE
bE
bE
bE
bE
bE
bE
bE
bE
bE
bE
bE
bE
bE
bE
bE
bJ
aA
bR
bT
bU
bU
bU
bU
bU
bW
"}
(11,1,1) = {"
bW
bW
bW
bW
WF
aK
aK
aK
aK
aK
aK
aK
aK
bE
bE
bE
ap
bE
bE
bO
bR
bT
bU
bU
bU
bU
bU
bW
"}
(12,1,1) = {"
bW
Tq
zM
bW
al
gg
gg
gg
gg
gg
gg
am
aK
aK
bE
ap
bx
bE
bJ
bE
bR
bT
bU
bU
bV
bU
bU
bW
"}
(13,1,1) = {"
bW
ry
sq
Ml
Ml
Ml
Ml
gg
gg
gg
gg
gg
gg
aK
bE
bE
bE
bE
bE
bE
bR
bT
bU
bU
bU
bU
bU
bW
"}
(14,1,1) = {"
bW
nR
sq
lt
oN
oN
tq
aL
gg
gg
wl
gg
gg
aK
bE
ap
bE
bE
bJ
bE
bR
bT
bU
bU
bU
bU
ct
bW
"}
(15,1,1) = {"
bW
KF
sq
Ml
TJ
oN
Bo
aL
gg
fY
Ns
iD
gg
aK
bx
bE
uA
bE
bK
bE
bR
bT
bU
bU
bU
bU
bU
bW
"}
(16,1,1) = {"
bW
rC
rX
Ml
lY
oN
hw
aL
gg
gg
cz
gg
gg
aK
ap
bE
bE
bE
bJ
bE
bR
bT
bU
bU
bU
bU
bU
bW
"}
(17,1,1) = {"
bW
Ml
Ml
Ml
Qv
oN
wf
aL
gg
gg
gg
gg
gg
br
bE
bE
bE
aA
bE
bE
bR
bT
bU
bU
bU
bU
bU
bW
"}
(18,1,1) = {"
bW
xU
DN
Ml
zz
oN
Ml
Ml
NQ
Ml
UU
gg
aK
aK
bE
bE
bE
bE
bJ
bE
bR
bT
bU
bU
bU
bU
bU
bW
"}
(19,1,1) = {"
bW
Ml
jC
Ml
dR
oN
oN
oN
oN
lT
gg
gg
aK
bE
bE
aU
bE
bE
bE
bE
bR
bT
bU
bV
bU
bU
bU
bW
"}
(20,1,1) = {"
bW
SA
sq
Ml
qf
Ky
ZW
TS
TS
Ml
gg
gg
aK
bE
aZ
bE
bE
bF
bE
bz
bR
bT
bU
bU
bU
bU
ct
bW
"}
(21,1,1) = {"
bW
fo
sq
Ml
Ml
Ml
Ml
Ml
Ml
Ml
UU
gg
aK
bE
bE
bE
bE
QS
bE
bE
bR
bT
bU
bU
bU
bU
bU
bW
"}
(22,1,1) = {"
bW
Lm
DN
Ml
vu
Ek
KX
YN
gg
gg
gg
gg
aK
bE
bE
bE
bA
bG
Gc
bE
bR
bT
bU
bU
bU
bU
bU
bW
"}
(23,1,1) = {"
bW
pg
DN
hy
gg
gg
gg
gg
gg
gg
gg
gg
aK
bE
bE
bE
bB
bH
bM
bE
bR
bT
bU
bU
bU
bU
bU
bW
"}
(24,1,1) = {"
bW
bW
bW
bW
Pl
Pl
Pl
Pl
Pl
Pl
Pl
Pl
Pl
bE
bE
bE
bE
bE
bE
bP
bR
bT
bU
bU
bU
bV
bU
bW
"}
(25,1,1) = {"
bW
ap
bE
bE
bE
bE
bE
bE
bE
bE
bE
bE
cP
bE
ap
bE
bE
bE
bJ
bE
bR
bT
bU
bU
bU
bU
bL
bW
"}
(26,1,1) = {"
bW
bW
bE
ap
bE
bE
aU
aA
bE
bE
bz
bE
bE
bE
bE
bE
aZ
bE
bE
bE
bR
bT
bU
bU
bU
ct
bW
bW
"}
(27,1,1) = {"
aa
bW
aq
bE
bE
bE
bE
aZ
bE
bE
bE
bE
bE
bE
bE
bE
bE
bE
bE
bE
bS
bT
bU
bU
bU
bU
bW
aa
"}
(28,1,1) = {"
aa
bW
bW
ap
bE
bE
aq
aV
bE
bE
QS
bE
bE
bn
aK
bn
bE
bx
cs
bE
bR
bT
bU
bU
bU
bW
bW
aa
"}
(29,1,1) = {"
aa
aa
bW
bW
ad
bE
bE
bE
bE
bE
bW
mh
mh
mh
Ec
mh
mh
mh
bW
ap
bR
bT
bU
ct
bW
bW
aa
aa
"}
(30,1,1) = {"
aa
aa
aa
bW
bW
bW
ap
QS
ap
bE
bW
bi
VO
Gc
bl
bl
bq
lM
bW
bN
bR
bT
bW
bW
bW
aa
aa
aa
"}
(31,1,1) = {"
aa
aa
aa
aa
aa
bW
bW
bW
bW
bW
bW
bj
bk
Gc
qT
bl
qa
cR
bW
bW
bW
bW
bW
aa
aa
aa
aa
aa
"}
(32,1,1) = {"
aa
aa
aa
aa
aa
aa
aa
aa
TP
TD
bW
bW
bW
pI
bW
pI
bW
bW
bW
TD
TP
aa
aa
aa
aa
aa
aa
aa
"}
(33,1,1) = {"
aa
aa
aa
aa
aa
aa
aa
aa
aa
TD
TD
TD
TD
TD
TD
TD
TD
TD
TD
TD
aa
aa
aa
aa
aa
aa
aa
aa
"}
(34,1,1) = {"
aa
aa
aa
aa
aa
aa
aa
aa
aa
aa
aa
TD
TD
TD
TD
TD
TD
TD
aa
aa
aa
aa
aa
aa
aa
aa
aa
aa
"}
