"a" = (/turf/template_noop,/area/template_noop)
"b" = (/turf/simulated/mineral/random/volcanic,/area/lavaland/surface/outdoors)
"c" = (/turf/simulated/floor/plating/asteroid/basalt/lava_land_surface,/area/lavaland/surface/outdoors)
"d" = (/obj/structure/stone_tile/block{dir = 8},/obj/structure/stone_tile/block{dir = 4},/turf/simulated/floor/plating/asteroid/basalt/lava_land_surface,/area/lavaland/surface/outdoors)
"e" = (/obj/structure/stone_tile/block{dir = 8},/obj/structure/stone_tile/block/cracked{dir = 4},/turf/simulated/floor/plating/asteroid/basalt/lava_land_surface,/area/lavaland/surface/outdoors)
"f" = (/obj/structure/stone_tile/block{dir = 4},/obj/structure/stone_tile/block/cracked{dir = 8},/turf/simulated/floor/plating/asteroid/basalt/lava_land_surface,/area/lavaland/surface/outdoors)
"g" = (/obj/structure/stone_tile{dir = 4},/turf/simulated/floor/plating/asteroid/basalt/lava_land_surface,/area/lavaland/surface/outdoors)
"h" = (/obj/structure/stone_tile{dir = 1},/turf/simulated/floor/plating/asteroid/basalt/lava_land_surface,/area/lavaland/surface/outdoors)
"i" = (/obj/structure/stone_tile{dir = 8},/obj/structure/stone_tile{dir = 1},/obj/structure/stone_tile/cracked,/turf/simulated/floor/plating/asteroid/basalt/lava_land_surface,/area/lavaland/surface/outdoors)
"j" = (/obj/structure/stone_tile/block{dir = 8},/obj/structure/stone_tile/block/cracked{dir = 4},/obj/effect/baseturf_helper/lava_land/surface,/turf/simulated/floor/plating/asteroid/basalt/lava_land_surface,/area/lavaland/surface/outdoors)
"k" = (/obj/structure/stone_tile,/obj/structure/stone_tile{dir = 4},/obj/structure/stone_tile/cracked{dir = 8},/turf/simulated/floor/plating/asteroid/basalt/lava_land_surface,/area/lavaland/surface/outdoors)
"l" = (/obj/structure/stone_tile/cracked,/obj/structure/stone_tile{dir = 8},/obj/structure/stone_tile{dir = 1},/turf/simulated/floor/plating/asteroid/basalt/lava_land_surface,/area/lavaland/surface/outdoors)
"m" = (/obj/structure/stone_tile{dir = 8},/obj/structure/stone_tile,/obj/structure/stone_tile/cracked{dir = 4},/turf/simulated/floor/plating/asteroid/basalt/lava_land_surface,/area/lavaland/surface/outdoors)
"n" = (/obj/structure/stone_tile{dir = 4},/obj/structure/stone_tile{dir = 8},/obj/structure/stone_tile/cracked,/turf/simulated/floor/plating/asteroid/basalt/lava_land_surface,/area/lavaland/surface/outdoors)
"o" = (/obj/structure/stone_tile/cracked{dir = 4},/turf/simulated/floor/plating/asteroid/basalt/lava_land_surface,/area/lavaland/surface/outdoors)
"p" = (/obj/structure/stone_tile{dir = 1},/obj/structure/stone_tile/cracked{dir = 8},/obj/structure/stone_tile,/turf/simulated/floor/plating/asteroid/basalt/lava_land_surface,/area/lavaland/surface/outdoors)
"q" = (/obj/structure/stone_tile{dir = 4},/obj/structure/stone_tile/cracked,/obj/structure/stone_tile{dir = 8},/turf/simulated/floor/plating/asteroid/basalt/lava_land_surface,/area/lavaland/surface/outdoors)
"r" = (/obj/structure/stone_tile{dir = 1},/obj/structure/stone_tile{dir = 8},/obj/structure/stone_tile,/turf/simulated/floor/plating/asteroid/basalt/lava_land_surface,/area/lavaland/surface/outdoors)
"s" = (/obj/structure/stone_tile/surrounding_tile/cracked,/turf/simulated/floor/plating/asteroid/basalt/lava_land_surface,/area/lavaland/surface/outdoors)
"t" = (/obj/structure/stone_tile/block/cracked,/turf/simulated/floor/plating/asteroid/basalt/lava_land_surface,/area/lavaland/surface/outdoors)
"u" = (/obj/structure/stone_tile/surrounding_tile{dir = 8},/turf/simulated/floor/plating/asteroid/basalt/lava_land_surface,/area/lavaland/surface/outdoors)
"v" = (/obj/structure/stone_tile/surrounding/cracked{dir = 6},/obj/structure/stone_tile/center,/turf/simulated/floor/plating/asteroid/basalt/lava_land_surface,/area/lavaland/surface/outdoors)
"w" = (/obj/structure/stone_tile/block{dir = 8},/obj/structure/stone_tile/block{dir = 4},/mob/living/simple_animal/hostile/megafauna/blood_drunk_miner/hunter,/turf/simulated/floor/plating/asteroid/basalt/lava_land_surface,/area/lavaland/surface/outdoors)

(1,1,1) = {"
aabbbbbbaaa
abbccdcbbaa
abbccecbbaa
abbbceccbba
aabbcdccbba
aabbcfcccbb
abbccdcccbb
abbcgfhccbb
bbcgijkhccb
bcglcdcmhcb
bcnhcwcopcb
bbcqhforccb
bbccstuccbb
abbccvcbbbb
aabbccbbbaa
aaabbbbbaaa
"}
