//MAP CONVERTED BY dmm2tgm.py THIS HEADER COMMENT PREVENTS RECONVERSION, DO NOT REMOVE
"a" = (
/turf/template_noop,
/area/template_noop)
"b" = (
/turf/simulated/wall/mineral/titanium/nodiagonal,
/area/shuttle/freegolem)
"c" = (
/obj/structure/fans/tiny,
/obj/machinery/door/airlock/titanium,
/turf/simulated/floor/plating,
/area/shuttle/freegolem)
"d" = (
/obj/structure/closet/crate/golemgear,
/turf/simulated/floor/plating,
/area/shuttle/freegolem)
"e" = (
/obj/item/storage/toolbox/mechanical,
/obj/item/reagent_containers/spray/cleaner,
/turf/simulated/floor/plating,
/area/shuttle/freegolem)
"f" = (
/turf/simulated/floor/plating,
/area/shuttle/freegolem)
"g" = (
/obj/structure/reagent_dispensers/watertank/high,
/turf/simulated/floor/plating,
/area/shuttle/freegolem)
"i" = (
/obj/structure/shuttle/engine/propulsion{
	dir = 4;
	icon_state = "burst_l"
	},
/turf/simulated/floor/plating/lavaland_air,
/area/shuttle/freegolem)
"j" = (
/obj/machinery/light/small,
/turf/simulated/floor/plating,
/area/shuttle/freegolem)
"k" = (
/obj/structure/reagent_dispensers/watertank,
/turf/simulated/floor/plating,
/area/shuttle/freegolem)
"l" = (
/obj/machinery/door/airlock/titanium,
/turf/simulated/floor/mineral/titanium/purple,
/area/shuttle/freegolem)
"m" = (
/obj/machinery/economy/vending/hydronutrients,
/turf/simulated/floor/mineral/titanium/purple,
/area/shuttle/freegolem)
"n" = (
/obj/machinery/economy/vending/hydroseeds,
/turf/simulated/floor/mineral/titanium/purple,
/area/shuttle/freegolem)
"o" = (
/obj/machinery/light{
	dir = 1;
	on = 1
	},
/turf/simulated/floor/mineral/titanium/purple,
/area/shuttle/freegolem)
"p" = (
/turf/simulated/floor/mineral/titanium/purple,
/area/shuttle/freegolem)
"q" = (
/obj/machinery/mineral/equipment_vendor/golem,
/turf/simulated/floor/mineral/titanium/purple,
/area/shuttle/freegolem)
"s" = (
/obj/machinery/light{
	dir = 8
	},
/turf/simulated/floor/mineral/titanium/purple,
/area/shuttle/freegolem)
"t" = (
/obj/effect/mob_spawn/human/alive/golem/adamantine,
/turf/simulated/floor/mineral/titanium/purple,
/area/shuttle/freegolem)
"u" = (
/obj/machinery/mineral/ore_redemption/golem,
/turf/simulated/floor/mineral/titanium/purple,
/area/shuttle/freegolem)
"v" = (
/obj/effect/spawner/window/shuttle,
/turf/simulated/floor/plating,
/area/shuttle/freegolem)
"w" = (
/obj/structure/statue/gold/rd{
	name = "statue of the Liberator"
	},
/obj/structure/window/reinforced{
	dir = 4
	},
/turf/simulated/floor/mineral/titanium/purple,
/area/shuttle/freegolem)
"x" = (
/obj/structure/computerframe,
/turf/simulated/floor/mineral/titanium/purple,
/area/shuttle/freegolem)
"y" = (
/obj/structure/table/wood,
/obj/item/resonator,
/turf/simulated/floor/mineral/titanium/purple,
/area/shuttle/freegolem)
"z" = (
/obj/structure/extinguisher_cabinet{
	name = "north bump";
	pixel_y = 30
	},
/turf/simulated/floor/mineral/titanium/purple,
/area/shuttle/freegolem)
"A" = (
/obj/effect/mapping_helpers/no_lava,
/turf/simulated/floor/plating/asteroid/basalt/lava_land_surface,
/area/ruin/powered/golem_ship)
"B" = (
/obj/machinery/door/airlock/titanium,
/obj/structure/fans/tiny,
/obj/docking_port/stationary{
	area_type = /area/ruin/powered/golem_ship;
	dir = 8;
	dwidth = 8;
	height = 20;
	id = "freegolem_lavaland";
	name = "Lavaland Surface";
	turf_type = /turf/simulated/floor/plating/asteroid/basalt/lava_land_surface;
	width = 16
	},
/obj/docking_port/mobile/free_golem,
/turf/simulated/floor/mineral/titanium/purple,
/area/shuttle/freegolem)
"C" = (
/obj/structure/window/reinforced{
	dir = 4
	},
/obj/structure/table/wood,
/obj/item/bedsheet/rd/royal_cape{
	layer = 3;
	pixel_x = 5;
	pixel_y = 9
	},
/obj/item/book/manual/research_and_development{
	name = "Sacred Text of the Liberator";
	pixel_x = -4;
	pixel_y = 3
	},
/turf/simulated/floor/mineral/titanium/purple,
/area/shuttle/freegolem)
"D" = (
/obj/machinery/light,
/obj/structure/chair/comfy/purp{
	dir = 1
	},
/turf/simulated/floor/mineral/titanium/purple,
/area/shuttle/freegolem)
"E" = (
/obj/structure/extinguisher_cabinet{
	name = "south bump";
	pixel_y = -30
	},
/obj/machinery/light,
/turf/simulated/floor/mineral/titanium/purple,
/area/shuttle/freegolem)
"F" = (
/obj/structure/fans/tiny,
/obj/machinery/door/airlock/titanium,
/turf/simulated/floor/mineral/titanium/purple,
/area/shuttle/freegolem)
"G" = (
/obj/item/resonator/upgraded,
/turf/simulated/floor/mineral/titanium/purple,
/area/shuttle/freegolem)
"H" = (
/obj/machinery/autolathe,
/turf/simulated/floor/mineral/titanium/purple,
/area/shuttle/freegolem)
"I" = (
/obj/structure/table/wood,
/obj/machinery/reagentgrinder,
/obj/item/book/manual/wiki/hydroponics,
/turf/simulated/floor/mineral/titanium/purple,
/area/shuttle/freegolem)
"J" = (
/obj/machinery/economy/vending/coffee/free,
/turf/simulated/floor/mineral/titanium/purple,
/area/shuttle/freegolem)
"K" = (
/obj/machinery/economy/vending/snack/free,
/turf/simulated/floor/mineral/titanium/purple,
/area/shuttle/freegolem)
"L" = (
/obj/machinery/light,
/turf/simulated/floor/mineral/titanium/purple,
/area/shuttle/freegolem)
"M" = (
/obj/structure/table/wood,
/obj/item/storage/firstaid/brute,
/obj/item/storage/firstaid/brute,
/obj/item/storage/firstaid/brute,
/turf/simulated/floor/mineral/titanium/purple,
/area/shuttle/freegolem)
"N" = (
/obj/structure/table/wood,
/obj/item/storage/firstaid/fire,
/obj/item/storage/firstaid/fire,
/obj/item/storage/firstaid/fire,
/obj/machinery/light,
/turf/simulated/floor/mineral/titanium/purple,
/area/shuttle/freegolem)
"O" = (
/obj/structure/table/wood,
/obj/item/storage/firstaid/adv,
/obj/item/storage/firstaid/adv,
/turf/simulated/floor/mineral/titanium/purple,
/area/shuttle/freegolem)
"P" = (
/obj/effect/mapping_helpers/no_lava,
/turf/template_noop,
/area/template_noop)
"Q" = (
/obj/structure/table/wood,
/obj/item/disk/design_disk/golem_shell,
/obj/item/areaeditor/golem,
/turf/simulated/floor/mineral/titanium/purple,
/area/shuttle/freegolem)
"R" = (
/obj/machinery/light/small{
	dir = 1
	},
/turf/simulated/floor/plating,
/area/shuttle/freegolem)
"S" = (
/obj/structure/reagent_dispensers/fueltank,
/turf/simulated/floor/plating,
/area/shuttle/freegolem)
"T" = (
/obj/structure/ore_box,
/turf/simulated/floor/plating,
/area/shuttle/freegolem)
"U" = (
/obj/structure/shuttle/engine/heater{
	dir = 4
	},
/obj/structure/window/plasmareinforced{
	dir = 8
	},
/turf/simulated/floor/plating/lavaland_air,
/area/shuttle/freegolem)
"V" = (
/obj/effect/mapping_helpers/no_lava,
/obj/effect/mapping_helpers/no_lava,
/turf/template_noop,
/area/template_noop)
"W" = (
/obj/machinery/door/airlock/titanium,
/obj/structure/fans/tiny,
/turf/simulated/floor/mineral/titanium/purple,
/area/shuttle/freegolem)
"X" = (
/obj/machinery/computer/shuttle/golem_ship/recall,
/obj/effect/mapping_helpers/no_lava,
/turf/simulated/floor/plating/asteroid/basalt/lava_land_surface,
/area/ruin/powered/golem_ship)

(1,1,1) = {"
a
a
a
P
V
P
P
P
b
v
v
b
P
P
P
V
P
a
a
a
"}
(2,1,1) = {"
a
a
a
P
V
P
P
P
b
w
C
b
P
P
P
V
P
a
a
a
"}
(3,1,1) = {"
a
a
a
P
P
b
b
W
b
x
D
b
W
b
b
P
P
a
a
a
"}
(4,1,1) = {"
P
P
P
P
P
b
m
p
s
p
p
s
p
J
b
P
P
P
P
P
"}
(5,1,1) = {"
P
P
P
P
P
b
n
p
p
p
p
p
p
K
b
P
P
P
P
P
"}
(6,1,1) = {"
P
P
b
b
b
b
o
p
p
p
p
p
p
L
b
b
b
b
P
P
"}
(7,1,1) = {"
P
P
b
d
f
l
p
p
p
p
p
p
p
p
l
f
T
b
P
P
"}
(8,1,1) = {"
P
P
b
d
f
l
p
p
p
p
p
p
p
p
l
f
T
b
P
P
"}
(9,1,1) = {"
P
P
b
d
j
b
o
p
p
p
p
p
p
L
b
R
T
b
P
P
"}
(10,1,1) = {"
P
P
b
d
f
b
p
p
t
y
y
t
p
p
b
f
T
b
P
P
"}
(11,1,1) = {"
P
P
b
d
f
b
p
p
t
y
y
t
p
p
b
f
T
b
P
P
"}
(12,1,1) = {"
P
P
b
d
j
b
o
p
p
p
p
p
p
L
b
R
T
b
P
P
"}
(13,1,1) = {"
P
P
b
d
f
l
p
p
p
p
p
p
p
p
l
f
T
b
P
P
"}
(14,1,1) = {"
P
P
b
d
f
l
p
p
p
p
p
p
p
p
l
f
T
b
P
P
"}
(15,1,1) = {"
P
P
b
e
f
b
p
p
p
p
p
p
p
M
b
f
e
b
V
V
"}
(16,1,1) = {"
P
P
c
f
j
b
o
p
p
p
p
p
p
N
b
R
f
c
V
V
"}
(17,1,1) = {"
P
P
c
f
f
b
p
p
p
p
p
G
p
O
b
f
f
c
V
V
"}
(18,1,1) = {"
P
P
b
g
k
b
q
p
u
p
p
H
I
Q
b
S
S
b
V
V
"}
(19,1,1) = {"
P
P
b
U
U
b
U
U
b
z
E
b
U
U
b
U
U
b
P
P
"}
(20,1,1) = {"
P
P
b
i
i
b
i
i
b
B
F
b
i
i
b
i
i
b
P
P
"}
(21,1,1) = {"
P
P
P
P
P
P
P
P
A
A
A
X
P
P
P
P
P
P
P
P
"}
(22,1,1) = {"
P
P
P
P
P
P
P
P
P
P
P
P
P
P
P
P
P
P
P
P
"}
