//MAP CONVERTED BY dmm2tgm.py THIS HEADER COMMENT PREVENTS RECONVERSION, DO NOT REMOVE
"a" = (
/turf/template_noop,
/area/template_noop)
"b" = (
/turf/simulated/wall/mineral/titanium/nodiagonal,
/area/shuttle/freegolem)
"c" = (
/obj/structure/fans/tiny,
/obj/machinery/door/airlock/titanium,
/turf/simulated/floor/plating,
/area/shuttle/freegolem)
"d" = (
/obj/structure/closet/crate/golemgear,
/turf/simulated/floor/plating,
/area/shuttle/freegolem)
"e" = (
/obj/item/storage/toolbox/mechanical,
/obj/item/reagent_containers/spray/cleaner,
/turf/simulated/floor/plating,
/area/shuttle/freegolem)
"f" = (
/turf/simulated/floor/plating,
/area/shuttle/freegolem)
"g" = (
/obj/structure/reagent_dispensers/watertank/high,
/turf/simulated/floor/plating,
/area/shuttle/freegolem)
"i" = (
/obj/structure/shuttle/engine/propulsion{
	dir = 4;
	icon_state = "burst_l"
	},
/turf/simulated/floor/plating/lavaland_air,
/area/shuttle/freegolem)
"j" = (
/obj/machinery/light/small,
/turf/simulated/floor/plating,
/area/shuttle/freegolem)
"k" = (
/obj/structure/reagent_dispensers/watertank,
/turf/simulated/floor/plating,
/area/shuttle/freegolem)
"l" = (
/obj/machinery/door/airlock/titanium,
/turf/simulated/floor/mineral/titanium/purple,
/area/shuttle/freegolem)
"m" = (
/obj/machinery/economy/vending/hydronutrients,
/turf/simulated/floor/mineral/titanium/purple,
/area/shuttle/freegolem)
"n" = (
/obj/machinery/economy/vending/hydroseeds,
/turf/simulated/floor/mineral/titanium/purple,
/area/shuttle/freegolem)
"o" = (
/obj/machinery/light{
	dir = 1;
	on = 1
	},
/turf/simulated/floor/mineral/titanium/purple,
/area/shuttle/freegolem)
"p" = (
/turf/simulated/floor/mineral/titanium/purple,
/area/shuttle/freegolem)
"q" = (
/obj/machinery/mineral/equipment_vendor/golem,
/turf/simulated/floor/mineral/titanium/purple,
/area/shuttle/freegolem)
"r" = (
/obj/machinery/door/airlock/titanium,
/obj/structure/fans/tiny,
/turf/simulated/floor/mineral/titanium/purple,
/area/shuttle/freegolem)
"s" = (
/obj/machinery/light{
	dir = 8
	},
/turf/simulated/floor/mineral/titanium/purple,
/area/shuttle/freegolem)
"t" = (
/obj/effect/mob_spawn/human/alive/golem/adamantine,
/turf/simulated/floor/mineral/titanium/purple,
/area/shuttle/freegolem)
"u" = (
/obj/machinery/mineral/ore_redemption/golem,
/turf/simulated/floor/mineral/titanium/purple,
/area/shuttle/freegolem)
"v" = (
/obj/effect/spawner/window/shuttle,
/turf/simulated/floor/plating,
/area/shuttle/freegolem)
"w" = (
/obj/structure/statue/gold/rd{
	name = "statue of the Liberator"
	},
/obj/structure/window/reinforced{
	dir = 4
	},
/turf/simulated/floor/mineral/titanium/purple,
/area/shuttle/freegolem)
"x" = (
/obj/structure/computerframe,
/turf/simulated/floor/mineral/titanium/purple,
/area/shuttle/freegolem)
"y" = (
/obj/structure/table/wood,
/obj/item/resonator,
/turf/simulated/floor/mineral/titanium/purple,
/area/shuttle/freegolem)
"z" = (
/obj/structure/extinguisher_cabinet{
	name = "north bump";
	pixel_y = 30
	},
/turf/simulated/floor/mineral/titanium/purple,
/area/shuttle/freegolem)
"A" = (
/turf/simulated/floor/plating/asteroid/basalt/lava_land_surface,
/area/ruin/powered/golem_ship)
"B" = (
/obj/machinery/door/airlock/titanium,
/obj/structure/fans/tiny,
/obj/docking_port/stationary{
	area_type = /area/ruin/powered/golem_ship;
	dir = 8;
	dwidth = 8;
	height = 20;
	id = "freegolem_lavaland";
	name = "Lavaland Surface";
	turf_type = /turf/simulated/floor/plating/asteroid/basalt/lava_land_surface;
	width = 16
	},
/obj/docking_port/mobile{
	dir = 8;
	dwidth = 8;
	height = 20;
	id = "freegolem";
	name = "Free Golem Ship";
	width = 16
	},
/turf/simulated/floor/mineral/titanium/purple,
/area/shuttle/freegolem)
"C" = (
/obj/structure/window/reinforced{
	dir = 4
	},
/obj/structure/table/wood,
/obj/item/bedsheet/rd/royal_cape{
	layer = 3;
	pixel_x = 5;
	pixel_y = 9
	},
/obj/item/book/manual/research_and_development{
	name = "Sacred Text of the Liberator";
	pixel_x = -4;
	pixel_y = 3
	},
/turf/simulated/floor/mineral/titanium/purple,
/area/shuttle/freegolem)
"D" = (
/obj/machinery/light,
/obj/structure/chair/comfy/purp{
	dir = 1
	},
/turf/simulated/floor/mineral/titanium/purple,
/area/shuttle/freegolem)
"E" = (
/obj/structure/extinguisher_cabinet{
	name = "south bump";
	pixel_y = -30
	},
/obj/machinery/light,
/turf/simulated/floor/mineral/titanium/purple,
/area/shuttle/freegolem)
"F" = (
/obj/structure/fans/tiny,
/obj/machinery/door/airlock/titanium,
/turf/simulated/floor/mineral/titanium/purple,
/area/shuttle/freegolem)
"G" = (
/obj/item/resonator/upgraded,
/turf/simulated/floor/mineral/titanium/purple,
/area/shuttle/freegolem)
"H" = (
/obj/machinery/autolathe,
/turf/simulated/floor/mineral/titanium/purple,
/area/shuttle/freegolem)
"I" = (
/obj/structure/table/wood,
/obj/machinery/reagentgrinder,
/obj/item/book/manual/wiki/hydroponics,
/turf/simulated/floor/mineral/titanium/purple,
/area/shuttle/freegolem)
"J" = (
/obj/machinery/economy/vending/coffee/free,
/turf/simulated/floor/mineral/titanium/purple,
/area/shuttle/freegolem)
"K" = (
/obj/machinery/economy/vending/snack/free,
/turf/simulated/floor/mineral/titanium/purple,
/area/shuttle/freegolem)
"L" = (
/obj/machinery/light,
/turf/simulated/floor/mineral/titanium/purple,
/area/shuttle/freegolem)
"M" = (
/obj/structure/table/wood,
/obj/item/storage/firstaid/brute,
/obj/item/storage/firstaid/brute,
/obj/item/storage/firstaid/brute,
/turf/simulated/floor/mineral/titanium/purple,
/area/shuttle/freegolem)
"N" = (
/obj/structure/table/wood,
/obj/item/storage/firstaid/fire,
/obj/item/storage/firstaid/fire,
/obj/item/storage/firstaid/fire,
/obj/machinery/light,
/turf/simulated/floor/mineral/titanium/purple,
/area/shuttle/freegolem)
"O" = (
/obj/structure/table/wood,
/obj/item/storage/firstaid/adv,
/obj/item/storage/firstaid/adv,
/turf/simulated/floor/mineral/titanium/purple,
/area/shuttle/freegolem)
"P" = (
/obj/machinery/computer/shuttle/golem_ship/recall,
/turf/simulated/floor/plating/asteroid/basalt/lava_land_surface,
/area/ruin/powered/golem_ship)
"Q" = (
/obj/structure/table/wood,
/obj/item/disk/design_disk/golem_shell,
/obj/item/areaeditor/golem,
/turf/simulated/floor/mineral/titanium/purple,
/area/shuttle/freegolem)
"R" = (
/obj/machinery/light/small{
	dir = 1
	},
/turf/simulated/floor/plating,
/area/shuttle/freegolem)
"S" = (
/obj/structure/reagent_dispensers/fueltank,
/turf/simulated/floor/plating,
/area/shuttle/freegolem)
"T" = (
/obj/structure/ore_box,
/turf/simulated/floor/plating,
/area/shuttle/freegolem)
"U" = (
/obj/structure/shuttle/engine/heater{
	dir = 4
	},
/obj/structure/window/plasmareinforced{
	dir = 8
	},
/turf/simulated/floor/plating/lavaland_air,
/area/shuttle/freegolem)

(1,1,1) = {"
a
a
a
a
a
a
b
v
v
b
a
a
a
a
a
a
"}
(2,1,1) = {"
a
a
a
a
a
a
b
w
C
b
a
a
a
a
a
a
"}
(3,1,1) = {"
a
a
a
b
b
r
b
x
D
b
r
b
b
a
a
a
"}
(4,1,1) = {"
a
a
a
b
m
p
s
p
p
s
p
J
b
a
a
a
"}
(5,1,1) = {"
a
a
a
b
n
p
p
p
p
p
p
K
b
a
a
a
"}
(6,1,1) = {"
b
b
b
b
o
p
p
p
p
p
p
L
b
b
b
b
"}
(7,1,1) = {"
b
d
f
l
p
p
p
p
p
p
p
p
l
f
T
b
"}
(8,1,1) = {"
b
d
f
l
p
p
p
p
p
p
p
p
l
f
T
b
"}
(9,1,1) = {"
b
d
j
b
o
p
p
p
p
p
p
L
b
R
T
b
"}
(10,1,1) = {"
b
d
f
b
p
p
t
y
y
t
p
p
b
f
T
b
"}
(11,1,1) = {"
b
d
f
b
p
p
t
y
y
t
p
p
b
f
T
b
"}
(12,1,1) = {"
b
d
j
b
o
p
p
p
p
p
p
L
b
R
T
b
"}
(13,1,1) = {"
b
d
f
l
p
p
p
p
p
p
p
p
l
f
T
b
"}
(14,1,1) = {"
b
d
f
l
p
p
p
p
p
p
p
p
l
f
T
b
"}
(15,1,1) = {"
b
e
f
b
p
p
p
p
p
p
p
M
b
f
e
b
"}
(16,1,1) = {"
c
f
j
b
o
p
p
p
p
p
p
N
b
R
f
c
"}
(17,1,1) = {"
c
f
f
b
p
p
p
p
p
G
p
O
b
f
f
c
"}
(18,1,1) = {"
b
g
k
b
q
p
u
p
p
H
I
Q
b
S
S
b
"}
(19,1,1) = {"
b
U
U
b
U
U
b
z
E
b
U
U
b
U
U
b
"}
(20,1,1) = {"
b
i
i
b
i
i
b
B
F
b
i
i
b
i
i
b
"}
(21,1,1) = {"
a
a
a
a
a
a
A
A
A
P
a
a
a
a
a
a
"}
