//MAP CONVERTED BY dmm2tgm.py THIS HEADER COMMENT PREVENTS RECONVERSION, DO NOT REMOVE
"a" = (
/turf/simulated/mineral/ancient/lava_land_surface_hard,
/area/ruin/unpowered/smallcave/cave2)
"b" = (
/turf/simulated/floor/plating/asteroid/basalt/lava_land_surface_hard,
/area/ruin/unpowered/smallcave/cave2)
"d" = (
/turf/simulated/mineral/volcanic/lava_land_surface,
/area/ruin/unpowered/smallcave/cave2)
"q" = (
/turf/template_noop,
/area/template_noop)
"K" = (
/obj/effect/baseturf_helper/lava_land/surface,
/turf/simulated/floor/plating/asteroid/basalt/lava_land_surface_hard,
/area/ruin/unpowered/smallcave/cave2)

(1,1,1) = {"
q
q
q
q
q
q
q
q
a
a
a
a
a
q
q
q
q
"}
(2,1,1) = {"
q
q
q
q
q
q
q
a
a
a
a
a
a
a
a
q
q
"}
(3,1,1) = {"
q
q
q
q
q
q
q
a
a
a
b
b
a
a
a
a
q
"}
(4,1,1) = {"
q
q
q
q
q
q
q
d
a
b
b
b
b
a
a
d
q
"}
(5,1,1) = {"
q
q
q
q
q
q
d
d
d
b
b
b
b
b
d
d
q
"}
(6,1,1) = {"
q
q
q
q
q
q
a
d
b
b
b
b
b
b
d
d
q
"}
(7,1,1) = {"
q
q
a
d
d
a
a
a
a
b
b
b
b
b
a
a
a
"}
(8,1,1) = {"
q
a
a
a
d
d
a
a
a
b
b
b
b
b
a
a
a
"}
(9,1,1) = {"
q
a
a
a
b
b
a
a
K
b
b
b
b
b
b
a
a
"}
(10,1,1) = {"
a
a
a
b
b
b
b
b
b
b
b
b
b
b
b
a
a
"}
(11,1,1) = {"
a
a
b
b
b
b
b
b
b
b
b
b
b
b
b
a
a
"}
(12,1,1) = {"
a
a
b
b
b
b
b
b
b
b
b
b
b
b
b
a
a
"}
(13,1,1) = {"
a
a
b
b
b
b
b
b
b
b
b
b
b
a
a
a
a
"}
(14,1,1) = {"
a
a
b
b
a
a
a
b
b
b
b
b
a
a
a
a
q
"}
(15,1,1) = {"
a
a
a
a
a
a
a
d
b
b
b
b
a
a
q
q
q
"}
(16,1,1) = {"
a
a
a
a
a
d
d
d
d
b
b
a
a
a
q
q
q
"}
(17,1,1) = {"
q
a
a
a
q
q
q
d
a
a
a
a
a
q
q
q
q
"}
