//MAP CONVERTED BY dmm2tgm.py THIS HEADER COMMENT PREVENTS RECONVERSION, DO NOT REMOVE
"a" = (
/turf/template_noop,
/area/template_noop)
"b" = (
/turf/simulated/mineral/random/volcanic,
/area/lavaland/surface/outdoors)
"c" = (
/turf/simulated/floor/plating/asteroid/basalt/lava_land_surface,
/area/lavaland/surface/outdoors)
"d" = (
/obj/structure/stone_tile/block{
	dir = 8
	},
/obj/structure/stone_tile/block{
	dir = 4
	},
/obj/effect/mapping_helpers/no_lava,
/turf/simulated/floor/plating/asteroid/basalt/lava_land_surface,
/area/lavaland/surface/outdoors)
"e" = (
/obj/structure/stone_tile/block{
	dir = 8
	},
/obj/structure/stone_tile/block/cracked{
	dir = 4
	},
/obj/effect/mapping_helpers/no_lava,
/turf/simulated/floor/plating/asteroid/basalt/lava_land_surface,
/area/lavaland/surface/outdoors)
"f" = (
/obj/structure/stone_tile/block{
	dir = 4
	},
/obj/structure/stone_tile/block/cracked{
	dir = 8
	},
/obj/effect/mapping_helpers/no_lava,
/turf/simulated/floor/plating/asteroid/basalt/lava_land_surface,
/area/lavaland/surface/outdoors)
"g" = (
/obj/structure/stone_tile{
	dir = 4
	},
/obj/effect/mapping_helpers/no_lava,
/turf/simulated/floor/plating/asteroid/basalt/lava_land_surface,
/area/lavaland/surface/outdoors)
"h" = (
/obj/structure/stone_tile{
	dir = 1
	},
/obj/effect/mapping_helpers/no_lava,
/turf/simulated/floor/plating/asteroid/basalt/lava_land_surface,
/area/lavaland/surface/outdoors)
"i" = (
/obj/structure/stone_tile{
	dir = 8
	},
/obj/structure/stone_tile{
	dir = 1
	},
/obj/structure/stone_tile/cracked,
/obj/effect/mapping_helpers/no_lava,
/turf/simulated/floor/plating/asteroid/basalt/lava_land_surface,
/area/lavaland/surface/outdoors)
"k" = (
/obj/structure/stone_tile,
/obj/structure/stone_tile{
	dir = 4
	},
/obj/structure/stone_tile/cracked{
	dir = 8
	},
/obj/effect/mapping_helpers/no_lava,
/turf/simulated/floor/plating/asteroid/basalt/lava_land_surface,
/area/lavaland/surface/outdoors)
"l" = (
/obj/structure/stone_tile/cracked,
/obj/structure/stone_tile{
	dir = 8
	},
/obj/structure/stone_tile{
	dir = 1
	},
/obj/effect/mapping_helpers/no_lava,
/turf/simulated/floor/plating/asteroid/basalt/lava_land_surface,
/area/lavaland/surface/outdoors)
"m" = (
/obj/structure/stone_tile{
	dir = 8
	},
/obj/structure/stone_tile,
/obj/structure/stone_tile/cracked{
	dir = 4
	},
/obj/effect/mapping_helpers/no_lava,
/turf/simulated/floor/plating/asteroid/basalt/lava_land_surface,
/area/lavaland/surface/outdoors)
"n" = (
/obj/structure/stone_tile{
	dir = 4
	},
/obj/structure/stone_tile{
	dir = 8
	},
/obj/structure/stone_tile/cracked,
/obj/effect/mapping_helpers/no_lava,
/turf/simulated/floor/plating/asteroid/basalt/lava_land_surface,
/area/lavaland/surface/outdoors)
"o" = (
/obj/structure/stone_tile/cracked{
	dir = 4
	},
/obj/effect/mapping_helpers/no_lava,
/turf/simulated/floor/plating/asteroid/basalt/lava_land_surface,
/area/lavaland/surface/outdoors)
"p" = (
/obj/structure/stone_tile{
	dir = 1
	},
/obj/structure/stone_tile/cracked{
	dir = 8
	},
/obj/structure/stone_tile,
/obj/effect/mapping_helpers/no_lava,
/turf/simulated/floor/plating/asteroid/basalt/lava_land_surface,
/area/lavaland/surface/outdoors)
"q" = (
/obj/structure/stone_tile{
	dir = 4
	},
/obj/structure/stone_tile/cracked,
/obj/structure/stone_tile{
	dir = 8
	},
/obj/effect/mapping_helpers/no_lava,
/turf/simulated/floor/plating/asteroid/basalt/lava_land_surface,
/area/lavaland/surface/outdoors)
"r" = (
/obj/structure/stone_tile{
	dir = 1
	},
/obj/structure/stone_tile{
	dir = 8
	},
/obj/structure/stone_tile,
/obj/effect/mapping_helpers/no_lava,
/turf/simulated/floor/plating/asteroid/basalt/lava_land_surface,
/area/lavaland/surface/outdoors)
"s" = (
/obj/structure/stone_tile/surrounding_tile/cracked,
/obj/effect/mapping_helpers/no_lava,
/turf/simulated/floor/plating/asteroid/basalt/lava_land_surface,
/area/lavaland/surface/outdoors)
"t" = (
/obj/structure/stone_tile/block/cracked,
/obj/effect/mapping_helpers/no_lava,
/turf/simulated/floor/plating/asteroid/basalt/lava_land_surface,
/area/lavaland/surface/outdoors)
"u" = (
/obj/structure/stone_tile/surrounding_tile{
	dir = 8
	},
/obj/effect/mapping_helpers/no_lava,
/turf/simulated/floor/plating/asteroid/basalt/lava_land_surface,
/area/lavaland/surface/outdoors)
"v" = (
/obj/structure/stone_tile/surrounding/cracked{
	dir = 6
	},
/obj/structure/stone_tile/center,
/obj/effect/mapping_helpers/no_lava,
/turf/simulated/floor/plating/asteroid/basalt/lava_land_surface,
/area/lavaland/surface/outdoors/unexplored)
"w" = (
/obj/structure/stone_tile/block{
	dir = 8
	},
/obj/structure/stone_tile/block{
	dir = 4
	},
/mob/living/simple_animal/hostile/megafauna/blood_drunk_miner/hunter,
/obj/effect/mapping_helpers/no_lava,
/turf/simulated/floor/plating/asteroid/basalt/lava_land_surface,
/area/lavaland/surface/outdoors)
"E" = (
/obj/effect/mapping_helpers/no_lava,
/turf/simulated/floor/plating/asteroid/basalt/lava_land_surface,
/area/lavaland/surface/outdoors)
"H" = (
/turf/simulated/floor/plating/asteroid/basalt/lava_land_surface,
/area/lavaland/surface/outdoors/unexplored)
"L" = (
/obj/effect/mapping_helpers/no_lava,
/turf/simulated/floor/plating/asteroid/basalt/lava_land_surface,
/area/lavaland/surface/outdoors/unexplored)
"U" = (
/turf/simulated/mineral/random/volcanic,
/area/lavaland/surface/outdoors/unexplored)

(1,1,1) = {"
a
a
a
a
U
a
a
a
U
a
U
a
U
U
a
a
a
a
a
a
"}
(2,1,1) = {"
a
U
U
U
U
U
a
U
U
U
U
U
U
U
U
U
U
a
a
a
"}
(3,1,1) = {"
a
a
U
U
U
U
U
a
U
U
E
E
E
U
U
U
U
U
a
a
"}
(4,1,1) = {"
a
a
U
E
E
E
b
b
b
E
E
c
b
E
E
E
E
U
a
a
"}
(5,1,1) = {"
a
U
U
b
b
E
E
b
E
E
c
E
E
E
b
b
b
U
U
a
"}
(6,1,1) = {"
U
U
E
E
b
c
E
E
E
c
E
E
c
b
b
b
c
U
U
a
"}
(7,1,1) = {"
a
U
U
E
E
E
c
E
E
E
E
c
E
g
n
E
E
U
U
U
"}
(8,1,1) = {"
U
U
U
b
c
E
E
E
E
E
E
E
g
l
h
q
E
L
U
U
"}
(9,1,1) = {"
U
U
U
E
E
E
E
E
E
E
E
g
i
E
E
h
s
L
U
a
"}
(10,1,1) = {"
U
U
H
c
E
d
e
e
d
f
d
f
e
d
w
f
t
v
U
U
"}
(11,1,1) = {"
U
U
U
E
E
E
E
E
E
E
E
h
k
E
E
o
u
L
U
U
"}
(12,1,1) = {"
a
U
U
b
c
E
E
E
E
E
E
E
h
m
o
r
E
L
U
a
"}
(13,1,1) = {"
a
U
c
E
E
E
c
E
E
E
E
c
E
h
p
E
E
H
U
U
"}
(14,1,1) = {"
U
U
E
E
b
c
E
E
E
c
E
E
c
b
b
c
b
U
U
U
"}
(15,1,1) = {"
a
U
U
b
b
E
E
c
E
E
c
E
E
E
b
b
b
U
U
a
"}
(16,1,1) = {"
a
U
U
E
E
E
U
U
c
E
E
b
b
E
E
E
E
U
a
a
"}
(17,1,1) = {"
U
U
U
U
U
U
U
U
c
c
E
E
E
U
U
U
U
U
a
a
"}
(18,1,1) = {"
a
U
a
U
U
a
U
U
U
U
U
U
U
U
U
a
U
a
a
a
"}
(19,1,1) = {"
a
a
a
U
a
a
a
U
a
U
U
U
a
a
a
a
a
a
a
a
"}
