//MAP CONVERTED BY dmm2tgm.py THIS HEADER COMMENT PREVENTS RECONVERSION, DO NOT REMOVE
"a" = (
/turf/simulated/floor/plating/asteroid/basalt/lava_land_surface_hard,
/area/ruin/unpowered/bigcave/cave3)
"d" = (
/turf/simulated/mineral/ancient/lava_land_surface_hard,
/area/ruin/unpowered/bigcave/cave3)
"j" = (
/obj/effect/baseturf_helper/lava_land/surface,
/turf/simulated/mineral/ancient/lava_land_surface_hard,
/area/ruin/unpowered/bigcave/cave3)
"q" = (
/turf/template_noop,
/area/template_noop)
"I" = (
/turf/simulated/mineral/volcanic/lava_land_surface,
/area/ruin/unpowered/bigcave/cave3)

(1,1,1) = {"
q
q
q
q
q
q
q
q
q
q
q
q
q
q
q
q
q
q
d
d
d
d
d
d
d
q
q
q
q
q
q
q
q
"}
(2,1,1) = {"
q
q
q
q
q
q
q
q
q
q
I
I
I
I
q
q
d
d
d
d
d
d
d
d
d
d
d
q
q
q
q
q
q
"}
(3,1,1) = {"
q
q
q
q
q
q
q
q
d
d
I
I
I
d
d
d
d
d
d
a
a
a
a
a
d
d
I
I
q
q
q
q
q
"}
(4,1,1) = {"
q
q
q
q
q
q
q
q
d
d
d
I
I
I
d
d
d
d
a
a
a
a
a
a
a
I
I
I
I
q
q
q
q
"}
(5,1,1) = {"
q
q
q
q
q
q
q
d
d
d
a
a
a
a
d
d
d
a
a
a
a
a
a
a
a
a
a
I
I
d
q
q
q
"}
(6,1,1) = {"
q
q
q
q
q
q
q
d
d
a
a
a
a
a
d
d
d
a
a
a
a
a
a
a
a
a
a
I
d
d
q
q
q
"}
(7,1,1) = {"
q
q
q
q
q
q
q
d
d
a
a
a
a
a
a
d
d
d
a
a
a
a
a
a
a
a
a
a
d
d
q
q
q
"}
(8,1,1) = {"
q
q
q
q
q
q
q
d
d
a
a
a
a
a
a
d
d
d
d
d
a
a
a
a
a
a
a
a
d
d
d
q
q
"}
(9,1,1) = {"
q
q
q
q
q
q
q
d
d
d
a
a
a
a
a
a
a
a
d
a
a
a
a
a
a
a
a
a
d
d
d
q
q
"}
(10,1,1) = {"
q
q
q
q
I
I
d
d
d
d
d
a
a
a
a
a
a
a
a
a
a
a
a
a
a
a
a
a
a
d
d
q
q
"}
(11,1,1) = {"
q
q
q
I
I
I
I
d
d
d
d
d
d
d
a
a
a
a
a
a
a
a
a
a
a
a
a
a
a
d
d
d
q
"}
(12,1,1) = {"
q
q
d
d
I
I
a
a
a
d
d
d
d
d
d
d
d
a
a
a
a
a
a
a
a
a
a
a
a
d
d
d
q
"}
(13,1,1) = {"
q
d
d
d
d
a
a
a
a
a
d
d
d
d
d
d
d
d
a
a
a
a
a
a
a
a
a
a
a
d
d
d
q
"}
(14,1,1) = {"
q
d
d
d
a
a
a
a
a
a
a
a
d
d
d
d
d
d
d
a
a
a
a
a
a
a
a
a
a
a
d
d
d
"}
(15,1,1) = {"
q
d
d
d
a
a
a
a
a
a
a
a
d
d
d
d
d
d
d
a
a
a
a
a
a
a
a
a
a
a
d
d
d
"}
(16,1,1) = {"
d
d
d
a
a
a
a
a
a
a
a
a
a
d
d
d
d
d
d
d
a
a
a
a
a
a
a
a
a
a
d
d
d
"}
(17,1,1) = {"
d
d
d
a
a
a
a
a
a
a
a
a
a
a
d
d
j
d
d
d
a
a
a
a
a
a
a
a
a
a
a
d
d
"}
(18,1,1) = {"
d
d
d
a
a
a
a
a
a
a
a
a
a
a
a
a
d
d
d
a
a
a
a
a
a
a
a
a
a
a
a
d
d
"}
(19,1,1) = {"
d
d
d
a
a
a
a
a
a
a
a
a
a
a
a
a
a
a
a
a
a
a
a
a
a
a
a
a
a
a
a
d
d
"}
(20,1,1) = {"
d
d
a
a
a
a
a
a
a
a
a
a
a
a
a
a
a
a
a
a
a
a
a
a
a
a
a
a
a
a
a
d
d
"}
(21,1,1) = {"
d
d
a
a
a
a
a
a
a
a
a
a
a
a
a
a
a
a
a
a
a
a
a
a
a
a
a
a
a
a
a
d
d
"}
(22,1,1) = {"
d
d
d
a
a
a
a
a
a
a
a
a
a
a
a
a
a
a
a
a
a
a
a
a
a
a
a
a
a
a
a
d
d
"}
(23,1,1) = {"
d
d
d
a
a
a
a
a
a
a
a
d
d
a
a
a
a
a
a
a
a
a
a
a
a
a
a
a
a
a
a
d
d
"}
(24,1,1) = {"
q
d
d
a
a
a
a
a
a
a
a
d
d
d
a
a
a
a
a
a
a
a
a
a
a
a
a
a
a
a
d
d
q
"}
(25,1,1) = {"
q
d
d
d
a
a
a
a
a
a
a
a
d
d
d
a
a
a
a
a
a
a
a
a
a
a
a
a
a
d
d
d
q
"}
(26,1,1) = {"
q
d
d
d
d
a
a
a
a
a
a
a
d
d
d
d
d
a
a
a
a
a
a
a
a
a
a
a
a
d
d
d
q
"}
(27,1,1) = {"
q
q
d
d
d
a
a
a
a
a
a
a
d
d
d
d
d
d
d
a
a
a
a
a
a
a
a
a
a
I
d
d
q
"}
(28,1,1) = {"
q
q
q
d
d
d
d
a
a
a
a
a
I
d
q
q
d
d
d
d
a
a
a
a
a
a
a
a
a
I
I
q
q
"}
(29,1,1) = {"
q
q
q
q
d
d
d
d
a
a
a
I
I
d
q
q
q
d
d
d
d
a
a
a
a
a
a
a
I
I
I
q
q
"}
(30,1,1) = {"
q
q
q
q
q
d
d
d
d
I
I
I
I
I
q
q
q
q
d
d
d
a
a
a
a
a
a
a
I
I
I
q
q
"}
(31,1,1) = {"
q
q
q
q
q
q
d
d
d
d
I
I
I
q
q
q
q
q
d
d
d
d
d
a
a
d
d
d
d
I
q
q
q
"}
(32,1,1) = {"
q
q
q
q
q
q
q
q
d
d
d
d
q
q
q
q
q
q
q
d
d
d
d
d
d
d
d
d
q
q
q
q
q
"}
(33,1,1) = {"
q
q
q
q
q
q
q
q
q
q
q
q
q
q
q
q
q
q
q
q
q
d
d
d
d
d
q
q
q
q
q
q
q
"}
