//MAP CONVERTED BY dmm2tgm.py THIS HEADER COMMENT PREVENTS RECONVERSION, DO NOT REMOVE
"aa" = (
/turf/template_noop,
/area/template_noop)
"ad" = (
/obj/structure/flora/ausbushes/leafybush,
/turf/simulated/floor/beach/sand,
/area/ruin/powered/beach)
"ae" = (
/obj/structure/table,
/obj/item/storage/toolbox/mechanical,
/obj/item/stack/cable_coil,
/obj/item/storage/box/lights/mixed,
/turf/simulated/floor/plating,
/area/ruin/powered/beach)
"af" = (
/obj/structure/table,
/obj/item/clothing/mask/gas,
/obj/machinery/light/small{
	dir = 1
	},
/obj/item/clothing/glasses/sunglasses/big,
/obj/item/clothing/glasses/sunglasses/big,
/obj/item/clothing/glasses/sunglasses/big,
/turf/simulated/floor/plating,
/area/ruin/powered/beach)
"ag" = (
/obj/structure/reagent_dispensers/fueltank,
/turf/simulated/floor/plating,
/area/ruin/powered/beach)
"ah" = (
/obj/effect/mob_spawn/human/bartender/alive,
/turf/simulated/floor/plating,
/area/ruin/powered/beach)
"ai" = (
/obj/machinery/portable_atmospherics/canister/oxygen,
/turf/simulated/floor/plating,
/area/ruin/powered/beach)
"aj" = (
/turf/simulated/wall/mineral/sandstone,
/area/ruin/powered/beach)
"ak" = (
/obj/structure/toilet,
/turf/simulated/floor/beach/sand,
/area/ruin/powered/beach)
"al" = (
/obj/structure/urinal{
	pixel_y = 32
	},
/turf/simulated/floor/plating,
/area/ruin/powered/beach)
"am" = (
/obj/structure/urinal{
	pixel_y = 32
	},
/turf/simulated/floor/beach/sand,
/area/ruin/powered/beach)
"an" = (
/obj/item/flashlight/lantern,
/obj/machinery/light/small{
	dir = 1
	},
/turf/simulated/floor/plating,
/area/ruin/powered/beach)
"ao" = (
/obj/structure/sink{
	dir = 4;
	pixel_x = 11
	},
/obj/structure/mirror{
	pixel_x = 28
	},
/turf/simulated/floor/beach/sand,
/area/ruin/powered/beach)
"ap" = (
/obj/structure/flora/ausbushes/sparsegrass,
/turf/simulated/floor/beach/sand,
/area/ruin/powered/beach)
"aq" = (
/obj/structure/flora/ausbushes/sunnybush,
/turf/simulated/floor/beach/sand,
/area/ruin/powered/beach)
"ar" = (
/turf/simulated/floor/beach/sand,
/area/ruin/powered/beach)
"as" = (
/turf/simulated/floor/plating,
/area/ruin/powered/beach)
"at" = (
obj/item/tank/oxygen,
/turf/simulated/floor/plating,
/area/ruin/powered/beach)
"au" = (
/turf/simulated/floor/beach/sand,
/area/ruin/powered/beach)
"av" = (
/obj/structure/mineral_door/sandstone{
	name = "Lavatory"
	},
/turf/simulated/floor/plating,
/area/ruin/powered/beach)
"aw" = (
/obj/structure/mineral_door/sandstone{
	name = "Bar Storage"
	},
/turf/simulated/floor/wood,
/area/ruin/powered/beach)
"ax" = (
/obj/structure/extinguisher_cabinet,
/turf/simulated/wall/mineral/sandstone,
/area/ruin/powered/beach)
"ay" = (
/obj/structure/mineral_door/sandstone{
	name = "Restroom"
	},
/turf/simulated/floor/beach/sand,
/area/ruin/powered/beach)
"az" = (
/obj/item/clothing/accessory/necklace,
/turf/simulated/floor/beach/sand,
/area/ruin/powered/beach)
"aA" = (
/turf/simulated/floor/beach/sand,
/area/ruin/powered/beach)
"aB" = (
/turf/simulated/floor/plating/asteroid{
	baseturf = /turf/simulated/floor/beach/sand
	},
/area/ruin/powered/beach)
"aC" = (
/turf/simulated/floor/wood,
/area/ruin/powered/beach)
"aD" = (
/obj/structure/table,
/obj/machinery/light{
	dir = 1
	},
/obj/machinery/chem_dispenser/soda,
/turf/simulated/floor/wood,
/area/ruin/powered/beach)
"aE" = (
/obj/structure/table,
/obj/machinery/reagentgrinder,
/turf/simulated/floor/wood,
/area/ruin/powered/beach)
"aF" = (
/obj/machinery/vending/boozeomat{
	emagged = 1
	req_access_txt = "0"
	},
/turf/simulated/floor/wood,
/area/ruin/powered/beach)
"aH" = (
/obj/structure/table,
/obj/machinery/light{
	dir = 1
	},
/obj/item/reagent_containers/food/drinks/shaker,
/obj/item/reagent_containers/glass/rag,
/turf/simulated/floor/wood,
/area/ruin/powered/beach)
"aI" = (
/obj/structure/table,
/obj/machinery/microwave,
/turf/simulated/floor/wood,
/area/ruin/powered/beach)
"aJ" = (
/obj/structure/closet/crate,
/obj/item/tank/emergency_oxygen,
/obj/item/trash/candy,
/obj/item/toy/owl,
/turf/simulated/floor/plating/asteroid{
	baseturf = /turf/simulated/floor/beach/sand
	},
/area/ruin/powered/beach)
"aK" = (
/turf/simulated/floor/plating/asteroid{
	baseturf = /turf/simulated/floor/beach/sand
	},
/area/ruin/powered/beach)
"aM" = (
/obj/structure/reagent_dispensers/beerkeg,
/turf/simulated/floor/wood,
/area/ruin/powered/beach)
"aN" = (
/obj/machinery/vending/cigarette,
/turf/simulated/floor/plating/asteroid{
	baseturf = /turf/simulated/floor/beach/sand
	},
/area/ruin/powered/beach)
"aO" = (
/turf/simulated/floor/beach/sand,
/area/ruin/powered/beach)
"aP" = (
/obj/structure/table/wood,
/turf/simulated/floor/wood,
/area/ruin/powered/beach)
"aQ" = (
/obj/structure/table/wood,
/obj/item/flashlight/lamp,
/turf/simulated/floor/wood,
/area/ruin/powered/beach)
"aR" = (
/obj/structure/table/wood,
/obj/item/reagent_containers/food/drinks/bottle/tequila,
/turf/simulated/floor/wood,
/area/ruin/powered/beach)
"aS" = (
/obj/machinery/processor,
/turf/simulated/floor/wood,
/area/ruin/powered/beach)
"aT" = (
/obj/machinery/vending/cola,
/turf/simulated/floor/plating/asteroid{
	baseturf = /turf/simulated/floor/beach/sand
	},
/area/ruin/powered/beach)
"aU" = (
/obj/effect/overlay/palmtree_l,
/turf/simulated/floor/beach/sand,
/area/ruin/powered/beach)
"aV" = (
/obj/effect/mob_spawn/human/beach/alive,
/turf/simulated/floor/beach/sand,
/area/ruin/powered/beach)
"aW" = (
/obj/structure/chair/stool,
/turf/simulated/floor/plating/asteroid{
	baseturf = /turf/simulated/floor/beach/sand
	},
/area/ruin/powered/beach)
"aX" = (
/obj/structure/closet/secure_closet/freezer/meat/open,
/turf/simulated/floor/wood,
/area/ruin/powered/beach)
"aY" = (
/obj/machinery/vending/snack,
/turf/simulated/floor/plating/asteroid{
	baseturf = /turf/simulated/floor/beach/sand
	},
/area/ruin/powered/beach)
"aZ" = (
/obj/effect/overlay/coconut,
/turf/simulated/floor/beach/sand,
/area/ruin/powered/beach)
"bb" = (
/turf/simulated/floor/beach/sand,
/area/ruin/powered/beach)
"bc" = (
/obj/structure/mineral_door/sandstone{
	name = "Bar Access"
	},
/turf/simulated/floor/wood,
/area/ruin/powered/beach)
"bd" = (
/obj/structure/closet/secure_closet/freezer/kitchen{
	req_access = null
	},
/turf/simulated/floor/wood,
/area/ruin/powered/beach)
"be" = (
/turf/simulated/floor/beach/sand,
/area/ruin/powered/beach)
"bg" = (
/obj/structure/sign/barsign,
/turf/simulated/wall/mineral/sandstone,
/area/ruin/powered/beach)
"bl" = (
/turf/simulated/floor/plating/asteroid{
	baseturf = /turf/simulated/floor/beach/sand
	},
/area/ruin/powered/beach)
"bx" = (
/obj/structure/flora/rock,
/turf/simulated/floor/beach/sand,
/area/ruin/powered/beach)
"bz" = (
/mob/living/simple_animal/crab,
/turf/simulated/floor/beach/sand,
/area/ruin/powered/beach)
"bA" = (
/obj/structure/window/reinforced{
	dir = 1
	},
/obj/structure/window/reinforced{
	dir = 8
	},
/obj/item/bikehorn/airhorn,
/obj/structure/table/wood,
/obj/item/storage/firstaid/regular,
/obj/item/storage/firstaid/brute,
/turf/simulated/floor/wood,
/area/ruin/powered/beach)
"bB" = (
/obj/structure/window/reinforced{
	dir = 4
	},
/obj/structure/window/reinforced{
	dir = 1;
	layer = 2.9
	},
/obj/structure/chair/stool,
/turf/simulated/floor/wood,
/area/ruin/powered/beach)
"bE" = (
/turf/simulated/floor/beach/sand,
/area/ruin/powered/beach)
"bF" = (
/obj/item/beach_ball,
/turf/simulated/floor/beach/sand,
/area/ruin/powered/beach)
"bG" = (
/obj/structure/window/reinforced{
	dir = 8
	},
/obj/structure/window/reinforced,
/obj/item/megaphone,
/turf/simulated/floor/wood,
/area/ruin/powered/beach)
"bH" = (
/obj/structure/window/reinforced{
	dir = 4
	},
/obj/effect/mob_spawn/human/beach/alive/lifeguard,
/turf/simulated/floor/wood,
/area/ruin/powered/beach)
"bJ" = (
/obj/structure/chair,
/turf/simulated/floor/beach/sand,
/area/ruin/powered/beach)
"bK" = (
/obj/item/storage/backpack/duffel,
/turf/simulated/floor/beach/sand,
/area/ruin/powered/beach)
"bL" = (
/turf/simulated/floor/pod/light,
/area/ruin/powered/beach)
"bM" = (
/turf/simulated/floor/plasteel/stairs/old,
/area/ruin/powered/beach)
"bN" = (
/obj/structure/flora/ausbushes/reedbush,
/turf/simulated/floor/beach/sand,
/area/ruin/powered/beach)
"bO" = (
/obj/item/camera,
/turf/simulated/floor/beach/sand,
/area/ruin/powered/beach)
"bP" = (
/obj/item/reagent_containers/food/drinks/cans/beer,
/turf/simulated/floor/beach/sand,
/area/ruin/powered/beach)
"bQ" = (
/obj/structure/flora/ausbushes/reedbush,
/turf/simulated/floor/beach/coastline_t,
/area/ruin/powered/beach)
"bR" = (
/turf/simulated/floor/beach/coastline_t,
/area/ruin/powered/beach)
"bS" = (
/obj/structure/flora/ausbushes/sparsegrass,
/turf/simulated/floor/beach/coastline_t,
/area/ruin/powered/beach)
"bT" = (
/turf/simulated/floor/beach/coastline_b,
/area/ruin/powered/beach)
"bU" = (
/turf/simulated/floor/beach/water,
/area/ruin/powered/beach)
"bV" = (
/obj/structure/flora/ausbushes/stalkybush,
/turf/simulated/floor/beach/water,
/area/ruin/powered/beach)
"bW" = (
/turf/simulated/wall/r_wall,
/area/ruin/powered/beach)
"cd" = (
/obj/machinery/light/small{
	dir = 1
	},
/turf/simulated/wall/mineral/sandstone,
/area/ruin/powered/beach)
"ce" = (
/obj/machinery/light{
	dir = 1
	},
/turf/simulated/floor/beach/sand,
/area/ruin/powered/beach)
"cg" = (
/obj/machinery/light{
	dir = 8
	},
/turf/simulated/floor/beach/sand,
/area/ruin/powered/beach)
"ch" = (
/obj/machinery/light{
	dir = 4
	},
/turf/simulated/floor/beach/sand,
/area/ruin/powered/beach)
"cj" = (
/obj/machinery/light{
	dir = 1
	},
/turf/simulated/floor/plating/asteroid{
	baseturf = /turf/simulated/floor/beach/sand
	},
/area/ruin/powered/beach)
"cs" = (
/obj/effect/overlay/palmtree_l,
/obj/machinery/light{
	dir = 4
	},
/turf/simulated/floor/beach/sand,
/area/ruin/powered/beach)
"ct" = (
/obj/machinery/light,
/turf/simulated/floor/beach/water,
/area/ruin/powered/beach)
"cR" = (
/obj/structure/table/wood,
obj/item/tank/oxygen,
/obj/item/pickaxe,
/obj/item/clothing/mask/gas,
/turf/simulated/floor/pod,
/area/ruin/powered/beach)
"dw" = (
/obj/structure/mineral_door/sandstone{
	name = "Beach Access"
	},
/turf/simulated/floor/pod,
/area/ruin/powered/beach)
"gg" = (
/obj/structure/table,
/obj/item/storage/box/drinkingglasses,
/obj/item/storage/box/drinkingglasses,
/obj/item/storage/box/beakers,
/obj/item/storage/box/donkpockets,
/turf/simulated/floor/plating,
/area/ruin/powered/beach)
"hY" = (
/obj/structure/table,
/obj/machinery/chem_dispenser/beer,
/turf/simulated/floor/wood,
/area/ruin/powered/beach)
"iw" = (
/obj/machinery/light/small{
	light_power = 3;
	dir = 8
	},
/turf/simulated/floor/pod,
/area/ruin/powered/beach)
"jF" = (
/turf/simulated/floor/pod,
/area/ruin/powered/beach)
"lF" = (
/obj/machinery/light{
	dir = 4
	},
/turf/simulated/floor/pod{
	oxygen = 14
	nitrogen = 23
	temperature = 300
	},
/area/ruin/powered/beach)
"lM" = (
/obj/structure/dresser,
/turf/simulated/floor/pod,
/area/ruin/powered/beach)
"mh" = (
/obj/effect/spawner/window,
/turf/simulated/floor/plating,
/area/ruin/powered/beach)
"oK" = (
/turf/simulated/floor/plating/asteroid{
	baseturf = /turf/simulated/floor/beach/sand
	},
/area/ruin/powered/beach)
"pg" = (
/obj/machinery/shower{
	dir = 4
	},
/turf/simulated/floor/pod/light,
/area/ruin/powered/beach)
"pI" = (
/obj/machinery/door/airlock/hatch{
	name = "Lava Beach Club"
	},
/obj/structure/fans/tiny,
/turf/simulated/floor/pod,
/area/ruin/powered/beach)
"pU" = (
/obj/machinery/light/small{
	dir = 4
	},
/turf/simulated/floor/pod,
/area/ruin/powered/beach)
"qa" = (
/obj/machinery/light/small{
	dir = 4
	},
/turf/simulated/floor/pod,
/area/ruin/powered/beach)
"qT" = (
/obj/machinery/shower{
	dir = 8
	},
/turf/simulated/floor/pod/light,
/area/ruin/powered/beach)
"sy" = (
/turf/simulated/floor/plating/asteroid{
	baseturf = /turf/simulated/floor/beach/sand
	},
/area/ruin/powered/beach)
"sO" = (
/turf/simulated/floor/light/colour_cycle,
/area/ruin/powered/beach)
"vl" = (
/obj/structure/closet/athletic_mixed,
/turf/simulated/floor/pod,
/area/ruin/powered/beach)
"wY" = (
/turf/simulated/floor/pod/light,
/area/ruin/powered/beach)
"yp" = (
/turf/simulated/floor/plating/asteroid{
	baseturf = /turf/simulated/floor/beach/sand
	},
/area/ruin/powered/beach)
"zw" = (
/obj/structure/closet/athletic_mixed,
/turf/simulated/floor/pod,
/area/ruin/powered/beach)
"Bl" = (
/obj/machinery/light{
	dir = 8
	},
/turf/simulated/floor/beach/sand,
/area/ruin/powered/beach)
"Ec" = (
/obj/structure/mineral_door/sandstone{
	name = "Beach Access"
	},
/turf/simulated/floor/pod,
/area/ruin/powered/beach)
"Ga" = (
/turf/simulated/floor/plating/asteroid{
	baseturf = /turf/simulated/floor/beach/sand
	},
/area/ruin/powered/beach)
"Gc" = (
/turf/simulated/floor/pod/light,
/area/ruin/powered/beach)
"HC" = (
/obj/structure/rack,
/obj/item/clothing/shoes/sandal,
/obj/item/clothing/shoes/sandal,
/turf/simulated/floor/pod,
/area/ruin/powered/beach)
"QS" = (
/obj/machinery/light{
	dir = 4
	},
/turf/simulated/floor/beach/sand,
/area/ruin/powered/beach)
"TP" = (
/obj/machinery/light{
	dir = 8
	},
/turf/simulated/floor/pod{
	oxygen = 14
	nitrogen = 23
	temperature = 300
	},
/area/ruin/powered/beach)
"VO" = (
/turf/simulated/floor/pod,
/area/ruin/powered/beach)
"Xp" = (
/obj/machinery/light/small{
	light_power = 3;
	dir = 8
	},
/turf/simulated/floor/pod,
/area/ruin/powered/beach)

(1,1,1) = {"
aa
aa
aa
aa
aa
aa
aa
aa
aa
lF
aa
bW
bW
bW
pI
bW
pI
bW
bW
bW
aa
lF
aa
aa
aa
aa
aa
aa
aa
aa
"}
(2,1,1) = {"
aa
aa
aa
aa
aa
aa
bW
bW
bW
bW
bW
bW
vl
iw
wY
pg
wY
Xp
cR
bW
bW
bW
bW
bW
aa
aa
aa
aa
aa
aa
"}
(3,1,1) = {"
aa
aa
aa
aa
bW
bW
bW
ap
cg
ar
ar
bW
HC
VO
Gc
Gc
wY
VO
lM
bW
ad
bQ
bT
bW
bW
bW
aa
aa
aa
aa
"}
(4,1,1) = {"
aa
aa
aa
bW
bW
ap
ar
ar
ar
ar
ar
bW
mh
mh
mh
dw
mh
mh
mh
bW
ap
bR
bT
bU
ct
bW
bW
aa
aa
aa
"}
(5,1,1) = {"
aa
aa
bW
bW
ad
ar
ar
aO
ar
bb
ar
cg
ar
ar
Bl
aA
Bl
ar
ar
cg
bN
bR
bT
bU
bU
bU
bW
bW
aa
aa
"}
(6,1,1) = {"
aa
aa
bW
aq
ar
ar
ar
ar
aV
ar
ar
ar
ar
ar
ar
ar
ar
bz
ar
bJ
ar
bS
bT
bU
bU
bU
bU
bW
aa
aa
"}
(7,1,1) = {"
aa
bW
bW
ar
ap
az
ar
aO
ar
bb
ar
ar
ar
aU
aZ
ar
ar
ar
ar
ar
ar
bR
bT
bU
bU
bU
ct
bW
bW
aa
"}
(8,1,1) = {"
aa
bW
ad
ar
ar
ar
ar
ar
ar
ar
ar
ar
ar
ar
ar
ar
ar
ar
ar
bJ
bE
bR
bT
bU
bU
bU
bU
bU
bW
aa
"}
(9,1,1) = {"
aa
bW
bW
bW
bW
ce
aA
aA
aA
aA
aA
aA
aA
aA
ar
ar
ar
ap
ar
ar
bO
bR
bT
bU
bU
bU
bU
bU
bW
aa
"}
(10,1,1) = {"
aa
bW
ae
gg
bW
aB
aK
aK
aK
aK
aK
aK
yp
aA
ar
ar
ap
bx
ar
bJ
ar
bR
bT
bU
bU
bV
bU
bU
bW
aa
"}
(11,1,1) = {"
aa
bW
af
as
aj
aj
aj
aj
aB
aK
aK
aK
aK
aA
ar
ar
ar
ar
ar
ar
ar
bR
bT
bU
bU
bU
bU
bU
bW
aa
"}
(12,1,1) = {"
aa
bW
ag
as
aw
aC
aC
aP
aW
aK
Ga
aK
aK
aA
ar
ar
ap
ar
ar
bJ
ar
bR
bT
bU
bU
bU
bU
ct
bW
aa
"}
(13,1,1) = {"
aa
bW
ah
as
aj
aD
aC
aQ
aW
oK
sO
bl
aK
aA
ar
bx
ar
ar
ar
bK
ar
bR
bT
bU
bU
bU
bU
bU
bW
aa
"}
(14,1,1) = {"
aa
bW
ai
at
ax
hY
aC
aP
aW
aK
sy
aK
aK
aA
ar
ap
ar
ar
ar
bJ
ar
bR
bT
bU
bU
bU
bU
bU
bW
aa
"}
(15,1,1) = {"
aa
bW
cd
aj
aj
aF
aC
aR
aW
aK
aK
aK
aK
aA
ar
ar
ar
ar
bE
ar
ar
bR
bT
bU
bU
bU
bU
bU
bW
aa
"}
(16,1,1) = {"
aa
bW
ak
au
aj
aE
aC
aj
aj
bc
aj
cj
aK
aA
ar
ar
ar
ar
ar
bJ
ar
bR
bT
bU
bU
bU
bU
bU
bW
aa
"}
(17,1,1) = {"
aa
bW
aj
av
aj
aH
aC
aC
aC
aC
bg
aB
aK
aA
ar
ar
aU
ar
ar
ar
ar
bR
bT
bU
bV
bU
bU
bU
bW
aa
"}
(18,1,1) = {"
aa
bW
al
as
aj
aI
aM
aS
aX
bd
aj
aB
aK
aA
ar
aZ
ar
ar
bF
ar
bz
bR
bT
bU
bU
bU
bU
ct
bW
aa
"}
(19,1,1) = {"
aa
bW
am
as
aj
aj
aj
aj
aj
aj
aj
cj
aK
aA
ar
ar
ar
ar
ch
ar
ar
bR
bT
bU
bU
bU
bU
bU
bW
aa
"}
(20,1,1) = {"
aa
bW
an
au
aj
aJ
aN
aT
aY
aK
aK
aK
aK
aA
ar
ar
ar
bA
bG
bL
ar
bR
bT
bU
bU
bU
bU
bU
bW
aa
"}
(21,1,1) = {"
aa
bW
ao
au
ay
aK
aK
aK
aK
aK
aK
aK
aK
aA
ar
ar
ar
bB
bH
bM
ar
bR
bT
bU
bU
bU
bU
bU
bW
aa
"}
(22,1,1) = {"
aa
bW
bW
bW
bW
ce
aA
aA
aA
aA
aA
aA
aA
aA
ar
ar
ar
ar
ar
ar
bP
bR
bT
bU
bU
bU
bV
bU
bW
aa
"}
(23,1,1) = {"
aa
bW
ap
ar
ar
ar
ar
ar
ar
ar
ar
ar
ar
ar
ar
ar
ar
ar
ar
bJ
ar
bR
bT
bU
bU
bU
bU
bU
bW
aa
"}
(24,1,1) = {"
aa
bW
bW
ar
ap
ar
ar
aU
bE
ar
ar
bz
ar
ar
ar
ar
ar
aZ
ar
ar
ar
bR
bT
bU
bU
bU
ct
bW
bW
aa
"}
(25,1,1) = {"
aa
aa
bW
aq
ar
ar
ar
ar
aZ
ar
ar
ar
ar
ar
ar
ar
ar
ar
ar
ar
ar
bS
bT
bU
bU
bU
bU
bW
aa
aa
"}
(26,1,1) = {"
aa
aa
bW
bW
ap
ar
ar
aq
aV
be
ar
ch
ar
ar
QS
aA
QS
ar
ar
cs
ar
bR
bT
bU
bU
bU
bW
bW
aa
aa
"}
(27,1,1) = {"
aa
aa
aa
bW
bW
ad
ar
ar
ar
ar
ar
bW
mh
mh
mh
Ec
mh
mh
mh
bW
ap
bR
bT
bU
ct
bW
bW
aa
aa
aa
"}
(28,1,1) = {"
aa
aa
aa
aa
bW
bW
bW
ap
ch
ap
ar
bW
zw
VO
wY
Gc
Gc
jF
lM
bW
bN
bR
bT
bW
bW
bW
aa
aa
aa
aa
"}
(29,1,1) = {"
aa
aa
aa
aa
aa
aa
bW
bW
bW
bW
bW
bW
HC
qa
wY
qT
Gc
pU
cR
bW
bW
bW
bW
bW
aa
aa
aa
aa
aa
aa
"}
(30,1,1) = {"
aa
aa
aa
aa
aa
aa
aa
aa
aa
TP
aa
bW
bW
bW
pI
bW
pI
bW
bW
bW
aa
TP
aa
aa
aa
aa
aa
aa
aa
aa
"}