"a" = (/turf/template_noop,/area/template_noop)
"b" = (/turf/unsimulated/beach/water,/area/template_noop)
"c" = (/obj/machinery/shower{pixel_y = 24},/obj/structure/window/reinforced/polarized{dir = 4; id = "room_s"},/turf/unsimulated/floor{dir = 8; icon_state = "whiteblue"},/area/template_noop)
"d" = (/turf/unsimulated/floor/carpet,/area/template_noop)
"e" = (/obj/structure/rack,/obj/item/clothing/suit/apron,/obj/item/clothing/suit/storage/hazardvest,/obj/item/clothing/suit/holidaypriest,/obj/item/clothing/suit/judgerobe,/obj/item/clothing/suit/storage/labcoat,/obj/item/clothing/suit/hooded/nun,/obj/item/clothing/suit/straight_jacket,/obj/item/clothing/suit/wizrobe/fake,/obj/item/clothing/suit/xenos,/obj/item/clothing/suit/wizrobe/marisa/fake,/turf/unsimulated/floor/carpet,/area/template_noop)
"f" = (/obj/structure/rack,/obj/item/clothing/head/collectable/police,/obj/item/clothing/head/nun_hood,/obj/item/clothing/head/mailman,/obj/item/clothing/head/nursehat,/obj/item/clothing/head/wizard/fake,/obj/item/clothing/head/powdered_wig,/obj/item/clothing/head/xenos,/obj/item/clothing/head/wizard/marisa/fake,/obj/item/clothing/mask/gas/sexyclown,/turf/unsimulated/floor/carpet,/area/template_noop)
"g" = (/obj/structure/rack,/obj/item/clothing/gloves/color/latex,/obj/item/clothing/gloves/color/latex,/obj/item/clothing/head/kitty,/obj/item/clothing/head/rabbitears,/obj/item/clothing/mask/muzzle,/obj/item/clothing/accessory/stethoscope,/turf/unsimulated/floor/carpet,/area/template_noop)
"h" = (/obj/structure/dresser,/turf/unsimulated/floor/carpet,/area/template_noop)
"i" = (/obj/structure/table/woodentable,/obj/item/device/flashlight/lamp/green,/turf/unsimulated/floor/carpet,/area/template_noop)
"j" = (/obj/structure/window/reinforced/polarized{dir = 4; id = "room_s"},/turf/unsimulated/floor{dir = 8; icon_state = "whiteblue"},/area/template_noop)
"k" = (/obj/structure/stool/bed,/obj/item/weapon/bedsheet/hop,/turf/unsimulated/floor/carpet,/area/template_noop)
"l" = (/obj/machinery/light{dir = 8},/obj/item/weapon/soap/deluxe,/obj/machinery/button/windowtint{id = "room_s"; pixel_x = -24; pixel_y = 0; range = 5},/turf/unsimulated/floor{dir = 1; icon_state = "whiteblue"},/area/template_noop)
"m" = (/turf/unsimulated/floor{dir = 1; icon_state = "whiteblue"},/area/template_noop)
"n" = (/obj/structure/window/reinforced/polarized{dir = 4; id = "room_s"},/turf/unsimulated/floor{dir = 1; icon_state = "whitebluecorner"},/area/template_noop)
"o" = (/obj/structure/sink{icon_state = "sink"; dir = 8; pixel_x = -12; pixel_y = 2},/obj/structure/mirror{pixel_x = -28},/turf/unsimulated/floor{icon_state = "freezerfloor"},/area/template_noop)
"p" = (/obj/structure/toilet{dir = 1},/turf/unsimulated/floor{icon_state = "freezerfloor"},/area/template_noop)
"q" = (/obj/machinery/door/window/eastleft,/turf/unsimulated/floor{icon_state = "freezerfloor"},/area/template_noop)

(1,1,1) = {"
aaaaaaaaaaa
abbcdefghia
abbjdddddka
almndddddka
aopqdddddda
aaaaaaaaaaa
aaaaaaaaaaa
"}

