//MAP CONVERTED BY dmm2tgm.py THIS HEADER COMMENT PREVENTS RECONVERSION, DO NOT REMOVE
"a" = (
/obj/structure/window/plastitanium,
/obj/effect/mapping_helpers/turfs/damage,
/obj/structure/window/plastitanium{
	dir = 4
	},
/obj/machinery/power/terminal{
	dir = 8
	},
/obj/structure/cable/yellow,
/obj/machinery/atmospherics/pipe/simple/visible{
	dir = 9
	},
/turf/simulated/floor/engine,
/area/ruin/space/unpowered)
"c" = (
/obj/structure/window/plastitanium{
	dir = 8
	},
/obj/machinery/atmospherics/unary/thermomachine/freezer/on{
	dir = 4
	},
/turf/simulated/floor/mineral/plastitanium/red,
/area/ruin/space/unpowered)
"g" = (
/obj/effect/decal/cleanable/glass,
/obj/machinery/atmospherics/pipe/manifold/visible{
	dir = 8
	},
/turf/simulated/floor/engine,
/area/ruin/space/unpowered)
"h" = (
/turf/template_noop,
/area/template_noop)
"j" = (
/obj/effect/mapping_helpers/turfs/damage,
/obj/effect/decal/cleanable/glass,
/obj/machinery/atmospherics/pipe/cap/visible,
/turf/simulated/floor/engine,
/area/ruin/space/unpowered)
"k" = (
/obj/structure/window/plastitanium{
	dir = 8
	},
/obj/machinery/atmospherics/pipe/simple/visible,
/turf/simulated/floor/engine,
/area/ruin/space/unpowered)
"l" = (
/obj/effect/mapping_helpers/turfs/damage,
/obj/effect/decal/cleanable/glass,
/obj/machinery/atmospherics/pipe/manifold/visible{
	dir = 4
	},
/turf/simulated/floor/engine,
/area/ruin/space/unpowered)
"m" = (
/obj/effect/map_effect/marker_helper/mapmanip/submap/edge{
	dir = 8
	},
/turf/template_noop,
/area/template_noop)
"o" = (
/obj/effect/decal/cleanable/glass,
/obj/structure/computerframe,
/obj/effect/mapping_helpers/turfs/damage,
/turf/simulated/floor/plating,
/area/ruin/space/unpowered)
"r" = (
/obj/effect/mapping_helpers/turfs/damage,
/obj/effect/decal/cleanable/glass,
/turf/simulated/floor/engine,
/area/ruin/space/unpowered)
"t" = (
/obj/effect/decal/cleanable/glass,
/obj/structure/chair/comfy/shuttle{
	dir = 1
	},
/obj/effect/mapping_helpers/turfs/damage,
/turf/simulated/floor/mineral/plastitanium/red,
/area/ruin/space/unpowered)
"w" = (
/obj/effect/decal/cleanable/glass,
/obj/structure/chair/comfy/shuttle{
	dir = 1
	},
/obj/effect/mob_spawn/human/corpse/engineer,
/obj/effect/mapping_helpers/turfs/damage,
/obj/item/clothing/gloves/color/yellow,
/turf/simulated/floor/mineral/plastitanium/red,
/area/ruin/space/unpowered)
"A" = (
/obj/structure/cable,
/obj/structure/window/plastitanium{
	dir = 4
	},
/obj/structure/machine_frame,
/obj/item/stack/cable_coil/five,
/turf/simulated/floor/engine,
/area/ruin/space/unpowered)
"B" = (
/obj/structure/window/plastitanium{
	dir = 8
	},
/obj/structure/machine_frame,
/turf/simulated/floor/mineral/plastitanium/red,
/area/ruin/space/unpowered)
"E" = (
/obj/effect/decal/cleanable/glass,
/obj/structure/cable{
	icon_state = "0-2"
	},
/obj/machinery/power/emitter{
	dir = 1
	},
/obj/effect/mapping_helpers/turfs/damage,
/obj/structure/window/plastitanium{
	dir = 4
	},
/turf/simulated/floor/engine,
/area/ruin/space/unpowered)
"I" = (
/obj/machinery/atmospherics/unary/passive_vent{
	dir = 1
	},
/turf/simulated/floor/plating/asteroid/airless,
/area/ruin/space/unpowered)
"J" = (
/obj/structure/closet/crate/secure/engineering,
/obj/item/nuke_core/supermatter_sliver,
/obj/effect/decal/cleanable/glass,
/obj/effect/mapping_helpers/turfs/damage,
/turf/simulated/floor/engine,
/area/ruin/space/unpowered)
"K" = (
/obj/structure/shuttle/engine/propulsion/burst,
/obj/effect/map_effect/marker/mapmanip/submap/extract/space_ruin/asteroid8,
/turf/simulated/wall/mineral/titanium,
/area/ruin/space/unpowered)
"M" = (
/obj/structure/window/plastitanium{
	dir = 8
	},
/obj/structure/window/plastitanium,
/obj/machinery/power/smes/empty,
/obj/machinery/atmospherics/pipe/simple/visible{
	dir = 5
	},
/obj/effect/map_effect/marker/mapmanip/submap/extract/space_ruin/asteroid8,
/turf/simulated/floor/engine,
/area/ruin/space/unpowered)
"N" = (
/obj/machinery/door/airlock/titanium{
	id_tag = "s_docking_airlock";
	name = "Escape Pod Hatch"
	},
/obj/effect/mapping_helpers/turfs/damage,
/turf/simulated/floor/mineral/titanium/blue,
/area/ruin/space/unpowered)
"P" = (
/obj/effect/mapping_helpers/turfs/damage,
/obj/effect/decal/cleanable/glass,
/obj/structure/machine_frame,
/obj/item/stack/cable_coil/five,
/turf/simulated/floor/engine,
/area/ruin/space/unpowered)
"Q" = (
/obj/machinery/atmospherics/unary/vent_pump,
/obj/effect/decal/cleanable/glass,
/turf/simulated/floor/plating,
/area/ruin/space/unpowered)
"S" = (
/obj/structure/shuttle/engine/propulsion/burst,
/turf/simulated/wall/mineral/titanium,
/area/ruin/space/unpowered)
"T" = (
/obj/effect/mapping_helpers/turfs/damage,
/obj/machinery/power/rad_collector/pre_activated,
/obj/structure/cable/yellow{
	icon_state = "0-2"
	},
/obj/machinery/atmospherics/pipe/simple/visible{
	dir = 6;
	level = 1
	},
/turf/simulated/floor/engine,
/area/ruin/space/unpowered)
"X" = (
/obj/effect/mapping_helpers/turfs/damage,
/obj/effect/decal/cleanable/glass,
/obj/structure/window/plastitanium,
/obj/machinery/atmospherics/trinary/filter,
/turf/simulated/floor/engine,
/area/ruin/space/unpowered)
"Z" = (
/obj/effect/mapping_helpers/turfs/damage,
/obj/structure/window/plastitanium,
/obj/structure/window/plastitanium{
	dir = 4
	},
/obj/structure/window/plastitanium{
	dir = 8
	},
/obj/structure/window/plastitanium,
/obj/item/nuke_core/supermatter_sliver,
/turf/simulated/floor/engine,
/area/ruin/space/unpowered)

(1,1,1) = {"
h
h
h
h
h
h
h
h
"}
(2,1,1) = {"
h
h
Q
B
c
K
h
h
"}
(3,1,1) = {"
h
h
o
w
t
N
h
h
"}
(4,1,1) = {"
h
h
J
E
A
S
h
h
"}
(5,1,1) = {"
h
h
h
m
h
h
h
h
"}
(6,1,1) = {"
h
h
h
h
h
h
h
h
"}
(7,1,1) = {"
h
h
P
g
k
M
h
h
"}
(8,1,1) = {"
h
h
r
Z
T
a
h
h
"}
(9,1,1) = {"
h
h
j
l
X
I
h
h
"}
(10,1,1) = {"
h
h
h
m
h
h
h
h
"}
(11,1,1) = {"
h
h
h
h
h
h
h
h
"}
