//MAP CONVERTED BY dmm2tgm.py THIS HEADER COMMENT PREVENTS RECONVERSION, DO NOT REMOVE
"bB" = (
/obj/item/reagent_containers/glass/beaker/large{
	pixel_x = 9;
	pixel_y = -8
	},
/obj/structure/table/reinforced,
/obj/machinery/light{
	dir = 4
	},
/turf/simulated/floor/plasteel/freezer,
/area/station/hallway/spacebridge/scidock)
"cc" = (
/turf/simulated/mineral/ancient,
/area/mine/unexplored/cere/engineering)
"co" = (
/obj/item/chair,
/obj/item/reagent_containers/dropper/precision{
	pixel_x = 9;
	pixel_y = 5
	},
/turf/simulated/floor/plating{
	icon_state = "asteroidplating"
	},
/area/station/hallway/spacebridge/scidock)
"cM" = (
/obj/effect/turf_decal/tiles/department/science/side{
	dir = 1
	},
/turf/simulated/floor/plasteel/white,
/area/station/hallway/spacebridge/scidock)
"dz" = (
/obj/item/clothing/glasses/science,
/obj/item/light/tube{
	status = 2
	},
/turf/simulated/floor/plasteel/freezer,
/area/station/hallway/spacebridge/scidock)
"dA" = (
/obj/machinery/light/small{
	dir = 4
	},
/turf/simulated/floor/plasteel/white,
/area/station/hallway/spacebridge/scidock)
"dL" = (
/obj/effect/decal/cleanable/dirt,
/turf/simulated/floor/plasteel/white,
/area/station/maintenance/maintcentral)
"dO" = (
/obj/machinery/chem_master,
/turf/simulated/floor/plasteel/freezer,
/area/station/hallway/spacebridge/scidock)
"fh" = (
/turf/simulated/mineral/ancient,
/area/station/hallway/spacebridge/scidock)
"fu" = (
/obj/effect/spawner/random/maintenance,
/turf/simulated/floor/plating/asteroid/ancient,
/area/station/hallway/spacebridge/scidock)
"fQ" = (
/obj/machinery/light/small{
	dir = 4
	},
/obj/effect/decal/cleanable/dirt,
/turf/simulated/floor/plating,
/area/station/maintenance/maintcentral)
"ho" = (
/turf/simulated/floor/plasteel/white,
/area/station/hallway/spacebridge/scidock)
"hA" = (
/obj/machinery/door/airlock/glass,
/obj/effect/mapping_helpers/airlock/access/all/engineering/maintenance,
/turf/simulated/floor/plating{
	icon_state = "asteroidplating"
	},
/area/station/hallway/spacebridge/scidock)
"ie" = (
/obj/structure/falsewall,
/turf/simulated/floor/plating,
/area/station/maintenance/maintcentral)
"iv" = (
/turf/simulated/floor/plasteel/freezer,
/area/station/hallway/spacebridge/scidock)
"kV" = (
/obj/machinery/door/airlock/glass,
/obj/effect/mapping_helpers/airlock/access/all/engineering/maintenance,
/turf/simulated/floor/plating,
/area/station/maintenance/maintcentral)
"ld" = (
/obj/effect/decal/cleanable/dirt,
/turf/simulated/floor/plating,
/area/station/maintenance/maintcentral)
"ly" = (
/obj/machinery/door/airlock/glass,
/obj/structure/fans/tiny,
/obj/effect/mapping_helpers/airlock/access/all/engineering/maintenance,
/turf/simulated/floor/plating{
	icon_state = "asteroidplating"
	},
/area/station/hallway/spacebridge/scidock)
"mL" = (
/obj/structure/table/reinforced,
/obj/item/reagent_containers/glass/beaker/drugs,
/obj/machinery/light/built{
	dir = 8
	},
/turf/simulated/floor/plasteel/freezer,
/area/station/hallway/spacebridge/scidock)
"mU" = (
/obj/effect/map_effect/marker_helper/mapmanip/submap/edge{
	dir = 4
	},
/turf/template_noop,
/area/template_noop)
"nb" = (
/obj/structure/table,
/obj/effect/spawner/random/food_trash,
/obj/machinery/light/small{
	dir = 8
	},
/obj/effect/decal/cleanable/dirt,
/obj/effect/turf_decal/tiles/department/science/side{
	dir = 8
	},
/turf/simulated/floor/plasteel/white,
/area/station/hallway/spacebridge/scidock)
"ny" = (
/obj/effect/decal/cleanable/blood/tracks/mapped,
/turf/simulated/floor/plasteel/freezer,
/area/station/hallway/spacebridge/scidock)
"nC" = (
/obj/effect/decal/cleanable/dirt,
/obj/effect/turf_decal/tiles/department/science/side,
/turf/simulated/floor/plasteel/white,
/area/station/hallway/spacebridge/scidock)
"ok" = (
/obj/effect/spawner/window/reinforced/grilled,
/turf/simulated/floor/plating,
/area/station/maintenance/maintcentral)
"pk" = (
/obj/machinery/floodlight{
	light_power = 1
	},
/turf/simulated/floor/plating{
	icon_state = "asteroidplating"
	},
/area/station/hallway/spacebridge/scidock)
"py" = (
/turf/simulated/mineral/ancient/outer,
/area/mine/unexplored/cere/engineering)
"rd" = (
/turf/simulated/wall,
/area/station/hallway/spacebridge/scidock)
"tZ" = (
/obj/machinery/chem_heater,
/turf/simulated/floor/plating{
	icon_state = "asteroidplating"
	},
/area/station/hallway/spacebridge/scidock)
"uw" = (
/obj/structure/closet/secure_closet/reagents,
/turf/simulated/floor/plating{
	icon_state = "asteroidplating"
	},
/area/station/hallway/spacebridge/scidock)
"vx" = (
/obj/effect/decal/cleanable/dirt,
/turf/simulated/floor/plasteel/white,
/area/station/hallway/spacebridge/scidock)
"vC" = (
/obj/item/reagent_containers/glass/beaker/large{
	pixel_x = -8
	},
/turf/simulated/floor/plating{
	icon_state = "asteroidplating"
	},
/area/station/hallway/spacebridge/scidock)
"vM" = (
/obj/item/kirbyplants/large,
/obj/effect/turf_decal/tiles/department/science/side{
	dir = 1
	},
/turf/simulated/floor/plasteel/white,
/area/station/hallway/spacebridge/scidock)
"vW" = (
/obj/effect/decal/cleanable/dirt,
/obj/effect/turf_decal/tiles/department/science/corner{
	dir = 8
	},
/turf/simulated/floor/plasteel/white,
/area/station/hallway/spacebridge/scidock)
"wy" = (
/turf/simulated/wall,
/area/station/maintenance/maintcentral)
"xS" = (
/obj/item/reagent_containers/glass/beaker/large{
	pixel_x = -8
	},
/obj/effect/decal/cleanable/blood/tracks/mapped,
/obj/effect/decal/cleanable/blood/tracks/mapped{
	dir = 10
	},
/obj/effect/decal/cleanable/dirt,
/turf/simulated/floor/plasteel/freezer,
/area/station/hallway/spacebridge/scidock)
"yu" = (
/obj/effect/spawner/random/maintenance,
/turf/simulated/floor/plasteel/white,
/area/station/hallway/spacebridge/scidock)
"zC" = (
/obj/machinery/door/airlock/glass,
/obj/structure/fans/tiny,
/obj/effect/mapping_helpers/airlock/access/all/engineering/maintenance,
/turf/simulated/floor/plating,
/area/station/maintenance/maintcentral)
"Af" = (
/obj/machinery/door/airlock/research,
/obj/effect/decal/cleanable/dirt,
/obj/effect/mapping_helpers/airlock/access/all/engineering/maintenance,
/turf/simulated/floor/plasteel/freezer,
/area/station/hallway/spacebridge/scidock)
"BP" = (
/obj/structure/machine_frame,
/turf/simulated/floor/plating{
	icon_state = "asteroidplating"
	},
/area/station/hallway/spacebridge/scidock)
"Cy" = (
/turf/simulated/floor/plating/asteroid/ancient,
/area/station/hallway/spacebridge/scidock)
"DD" = (
/obj/structure/chair/comfy/corp,
/obj/effect/turf_decal/tiles/department/science/side{
	dir = 9
	},
/turf/simulated/floor/plasteel/white,
/area/station/hallway/spacebridge/scidock)
"DV" = (
/obj/effect/decal/cleanable/dirt,
/obj/effect/decal/cleanable/dirt,
/turf/simulated/floor/plasteel/freezer,
/area/station/hallway/spacebridge/scidock)
"Ee" = (
/obj/item/chair,
/obj/item/reagent_containers/dropper/precision{
	pixel_x = 9;
	pixel_y = 5
	},
/obj/effect/decal/cleanable/blood/tracks/mapped,
/turf/simulated/floor/plasteel/freezer,
/area/station/hallway/spacebridge/scidock)
"Ev" = (
/obj/effect/decal/cleanable/blood/tracks/mapped,
/obj/effect/decal/cleanable/dirt,
/obj/item/light/tube{
	status = 2
	},
/turf/simulated/floor/plasteel/freezer,
/area/station/hallway/spacebridge/scidock)
"ET" = (
/turf/template_noop,
/area/template_noop)
"EV" = (
/obj/structure/lattice/catwalk,
/turf/space,
/area/space/nearstation)
"EX" = (
/obj/effect/spawner/random/maintenance,
/obj/effect/decal/cleanable/blood/tracks/mapped{
	dir = 6
	},
/turf/simulated/floor/plasteel/freezer,
/area/station/hallway/spacebridge/scidock)
"EZ" = (
/obj/effect/spawner/random/food_trash,
/obj/effect/decal/cleanable/dirt,
/obj/effect/turf_decal/tiles/department/science/side,
/turf/simulated/floor/plasteel/white,
/area/station/hallway/spacebridge/scidock)
"Fb" = (
/obj/effect/decal/cleanable/dirt,
/turf/simulated/floor/plasteel/freezer,
/area/station/hallway/spacebridge/scidock)
"Fg" = (
/obj/effect/decal/cleanable/dirt,
/obj/effect/turf_decal/tiles/department/science/side,
/turf/simulated/floor/plasteel/white,
/area/station/maintenance/maintcentral)
"Id" = (
/turf/simulated/floor/plating{
	icon_state = "asteroidplating"
	},
/area/station/hallway/spacebridge/scidock)
"IY" = (
/turf/simulated/mineral/ancient/outer,
/area/station/hallway/spacebridge/scidock)
"Kf" = (
/obj/effect/spawner/random/maintenance,
/turf/simulated/floor/plating{
	icon_state = "asteroidplating"
	},
/area/station/hallway/spacebridge/scidock)
"KO" = (
/obj/structure/machine_frame,
/turf/simulated/floor/plasteel/freezer,
/area/station/hallway/spacebridge/scidock)
"Ms" = (
/obj/machinery/door/airlock/research,
/obj/effect/mapping_helpers/airlock/access/all/engineering/maintenance,
/turf/simulated/floor/plasteel/white,
/area/station/hallway/spacebridge/scidock)
"Pe" = (
/obj/structure/table/reinforced,
/obj/item/reagent_containers/pill/random_drugs,
/turf/simulated/floor/plasteel/freezer,
/area/station/hallway/spacebridge/scidock)
"Qu" = (
/obj/structure/chair/comfy/corp{
	dir = 1
	},
/obj/effect/decal/cleanable/dirt,
/obj/effect/turf_decal/tiles/department/science/side{
	dir = 10
	},
/turf/simulated/floor/plasteel/white,
/area/station/hallway/spacebridge/scidock)
"QJ" = (
/obj/item/reagent_containers/dropper{
	pixel_x = -10;
	pixel_y = 5
	},
/obj/effect/decal/cleanable/dirt,
/turf/simulated/floor/plasteel/freezer,
/area/station/hallway/spacebridge/scidock)
"Rl" = (
/obj/effect/mapping_helpers/turfs/rust,
/turf/simulated/wall,
/area/station/maintenance/maintcentral)
"RH" = (
/obj/effect/spawner/grouped_spawner{
	group_id = "tunnelbats";
	max_per_spawner = 1;
	name = "bat spawner";
	path_to_spawn = /mob/living/basic/scarybat;
	total_amount = 20
	},
/turf/simulated/floor/plating{
	icon_state = "asteroidplating"
	},
/area/station/hallway/spacebridge/scidock)
"Sn" = (
/obj/structure/closet/secure_closet/freezer/fridge,
/obj/effect/spawner/random/food_trash,
/obj/effect/decal/cleanable/dirt,
/obj/effect/turf_decal/tiles/department/science/corner{
	dir = 1
	},
/turf/simulated/floor/plasteel/white,
/area/station/hallway/spacebridge/scidock)
"Ss" = (
/obj/machinery/chem_master,
/turf/simulated/floor/plating{
	icon_state = "asteroidplating"
	},
/area/station/hallway/spacebridge/scidock)
"SC" = (
/obj/effect/map_effect/marker_helper/mapmanip/submap/edge,
/turf/template_noop,
/area/template_noop)
"SR" = (
/turf/simulated/floor/plating/asteroid/ancient/airless,
/area/station/hallway/spacebridge/scidock)
"SS" = (
/obj/item/reagent_containers/glass/beaker/large{
	pixel_x = 9;
	pixel_y = -8
	},
/turf/simulated/floor/plating/asteroid/ancient,
/area/station/hallway/spacebridge/scidock)
"Tg" = (
/obj/effect/spawner/random/maintenance,
/obj/structure/table/reinforced,
/obj/machinery/light/built{
	dir = 8
	},
/turf/simulated/floor/plasteel/freezer,
/area/station/hallway/spacebridge/scidock)
"Tj" = (
/obj/effect/map_effect/marker_helper/mapmanip/submap/edge{
	dir = 8
	},
/turf/template_noop,
/area/template_noop)
"Up" = (
/turf/simulated/mineral/ancient,
/area/station/maintenance/maintcentral)
"US" = (
/obj/item/chair{
	dir = 1
	},
/obj/effect/decal/cleanable/blood/tracks/mapped{
	dir = 8
	},
/turf/simulated/floor/plasteel/freezer,
/area/station/hallway/spacebridge/scidock)
"UX" = (
/obj/item/chair/wood{
	dir = 4
	},
/obj/item/reagent_containers/dropper{
	pixel_x = -10;
	pixel_y = 5
	},
/turf/simulated/floor/plating{
	icon_state = "asteroidplating"
	},
/area/station/hallway/spacebridge/scidock)
"Vb" = (
/obj/structure/lattice,
/turf/space,
/area/space/nearstation)
"Vo" = (
/turf/space,
/area/space)
"VG" = (
/obj/structure/closet/secure_closet/reagents,
/obj/item/reagent_containers/glass/beaker/drugs{
	pixel_x = 7;
	pixel_y = -7
	},
/obj/item/reagent_containers/glass/beaker/drugs{
	pixel_x = 4;
	pixel_y = -4
	},
/obj/item/reagent_containers/glass/beaker/drugs{
	pixel_x = 1;
	pixel_y = -1
	},
/obj/effect/decal/cleanable/blood/tracks/mapped{
	dir = 9
	},
/obj/effect/decal/cleanable/dirt,
/turf/simulated/floor/plasteel/freezer,
/area/station/hallway/spacebridge/scidock)
"VM" = (
/obj/machinery/door/airlock/research,
/obj/effect/decal/cleanable/blood/tracks/mapped,
/obj/effect/mapping_helpers/airlock/access/all/engineering/maintenance,
/turf/simulated/floor/plasteel/freezer,
/area/station/hallway/spacebridge/scidock)
"WL" = (
/obj/effect/map_effect/marker/mapmanip/submap/extract/station/cerestation/engineering_science,
/turf/simulated/mineral/ancient,
/area/station/hallway/spacebridge/scidock)
"Xf" = (
/turf/simulated/floor/plating,
/area/station/maintenance/maintcentral)
"YQ" = (
/obj/machinery/light/small{
	dir = 4
	},
/turf/simulated/floor/plating{
	icon_state = "asteroidplating"
	},
/area/station/hallway/spacebridge/scidock)
"Zc" = (
/obj/machinery/chem_heater,
/turf/simulated/floor/plasteel/freezer,
/area/station/hallway/spacebridge/scidock)

(1,1,1) = {"
ET
ET
ET
ET
ET
ET
ET
mU
ET
ET
ET
ET
ET
ET
mU
ET
ET
ET
ET
ET
ET
mU
ET
ET
ET
ET
ET
ET
ET
ET
ET
ET
ET
ET
ET
ET
ET
ET
ET
ET
ET
ET
ET
ET
ET
ET
ET
ET
ET
ET
"}
(2,1,1) = {"
ET
ET
ET
ET
ET
ET
SC
Up
cc
py
Vo
Vo
Vo
Vo
SR
SR
SR
IY
IY
IY
fh
fh
fh
fh
fh
fh
fh
WL
ET
ET
ET
ET
ET
ET
ET
ET
ET
ET
ET
ET
ET
ET
ET
ET
ET
ET
ET
ET
ET
ET
"}
(3,1,1) = {"
ET
ET
ET
ET
ET
ET
ET
Up
py
Vo
Vo
Vo
Vo
Vo
IY
IY
SR
IY
fh
fh
fh
fh
BP
Kf
Ss
Cy
uw
fh
ET
ET
ET
ET
ET
ET
ET
ET
ET
ET
ET
ET
ET
ET
ET
ET
ET
ET
ET
ET
ET
ET
"}
(4,1,1) = {"
ET
ET
ET
ET
ET
ET
ET
Up
py
Vo
Vo
Vb
Vo
EV
IY
IY
IY
IY
fh
fh
fh
fh
co
Cy
vC
RH
fu
fh
ET
ET
ET
ET
ET
ET
ET
ET
ET
ET
ET
ET
ET
ET
ET
ET
ET
ET
ET
ET
ET
ET
"}
(5,1,1) = {"
ET
ET
ET
ET
ET
ET
ET
wy
wy
ok
ok
wy
Vo
Vb
rd
fh
fh
fh
fh
fh
fh
fh
Id
pk
Cy
Id
UX
fh
ET
ET
ET
ET
ET
ET
ET
ET
ET
ET
ET
ET
ET
ET
ET
ET
ET
ET
ET
ET
ET
ET
"}
(6,1,1) = {"
ET
ET
ET
ET
ET
ET
ET
zC
fQ
Xf
ld
kV
Vo
Vb
hA
Id
YQ
ly
Id
Kf
Id
Id
Cy
Cy
Id
SS
tZ
fh
ET
ET
ET
ET
ET
ET
ET
ET
ET
ET
ET
ET
ET
ET
ET
ET
ET
ET
ET
ET
ET
ET
"}
(7,1,1) = {"
ET
ET
ET
ET
ET
ET
SC
Rl
Rl
ok
ok
wy
Vo
Vo
rd
fh
fh
fh
fh
fh
fh
fh
fh
fh
fh
fh
fh
fh
ET
ET
ET
ET
ET
ET
ET
ET
ET
ET
ET
ET
ET
ET
ET
ET
ET
ET
ET
ET
ET
ET
"}
(8,1,1) = {"
ET
ET
ET
ET
ET
ET
ET
Tj
ET
ET
ET
ET
ET
ET
Tj
ET
ET
ET
ET
ET
ET
Tj
ET
ET
ET
ET
ET
Tj
ET
ET
ET
ET
ET
ET
ET
ET
ET
ET
ET
ET
ET
ET
ET
ET
ET
ET
ET
ET
ET
ET
"}
(9,1,1) = {"
ET
ET
ET
ET
ET
ET
ET
ET
ET
ET
ET
ET
ET
ET
ET
ET
ET
ET
ET
ET
ET
ET
ET
ET
ET
ET
ET
ET
ET
ET
ET
ET
ET
ET
ET
ET
ET
ET
ET
ET
ET
ET
ET
ET
ET
ET
ET
ET
ET
ET
"}
(10,1,1) = {"
ET
ET
ET
ET
ET
ET
ET
ET
ET
ET
ET
ET
ET
ET
ET
ET
ET
ET
ET
ET
ET
ET
ET
ET
ET
ET
ET
ET
ET
ET
ET
ET
ET
ET
ET
ET
ET
ET
ET
ET
ET
ET
ET
ET
ET
ET
ET
ET
ET
ET
"}
(11,1,1) = {"
ET
ET
ET
ET
ET
ET
ET
ET
ET
ET
ET
ET
ET
ET
ET
ET
ET
ET
ET
ET
ET
ET
ET
ET
ET
ET
ET
ET
ET
ET
ET
ET
ET
ET
ET
ET
ET
ET
ET
ET
ET
ET
ET
ET
ET
ET
ET
ET
ET
ET
"}
(12,1,1) = {"
ET
ET
ET
ET
ET
ET
ET
ET
ET
ET
ET
ET
ET
ET
ET
ET
ET
ET
ET
ET
ET
ET
ET
ET
ET
ET
ET
ET
ET
ET
ET
ET
ET
ET
ET
ET
ET
ET
ET
ET
ET
ET
ET
ET
ET
ET
ET
ET
ET
ET
"}
(13,1,1) = {"
ET
ET
ET
ET
ET
ET
ET
mU
ET
ET
ET
ET
ET
ET
mU
ET
ET
ET
ET
ET
ET
mU
ET
ET
ET
ET
ET
ET
ET
ET
ET
ET
ET
ET
ET
ET
ET
ET
ET
ET
ET
ET
ET
ET
ET
ET
ET
ET
ET
ET
"}
(14,1,1) = {"
ET
ET
ET
ET
ET
ET
SC
Up
cc
py
Vo
Vo
Vo
Vo
SR
IY
IY
IY
IY
IY
fh
fh
fh
fh
fh
fh
fh
WL
ET
ET
ET
ET
ET
ET
ET
ET
ET
ET
ET
ET
ET
ET
ET
ET
ET
ET
ET
ET
ET
ET
"}
(15,1,1) = {"
ET
ET
ET
ET
ET
ET
ET
Up
py
Vo
Vo
Vo
Vo
Vo
IY
IY
DD
nb
Qu
fh
fh
fh
KO
Tg
dO
mL
VG
VM
ET
ET
ET
ET
ET
ET
ET
ET
ET
ET
ET
ET
ET
ET
ET
ET
ET
ET
ET
ET
ET
ET
"}
(16,1,1) = {"
ET
ET
ET
ET
ET
ET
ET
Up
py
EV
EV
EV
EV
EV
IY
IY
vM
ho
EZ
fh
fh
fh
Ee
Ev
xS
ny
EX
fh
ET
ET
ET
ET
ET
ET
ET
ET
ET
ET
ET
ET
ET
ET
ET
ET
ET
ET
ET
ET
ET
ET
"}
(17,1,1) = {"
ET
ET
ET
ET
ET
ET
ET
wy
wy
ok
ok
wy
ok
ok
rd
fh
Sn
ho
vW
fh
fh
fh
Fb
DV
US
dz
QJ
fh
ET
ET
ET
ET
ET
ET
ET
ET
ET
ET
ET
ET
ET
ET
ET
ET
ET
ET
ET
ET
ET
ET
"}
(18,1,1) = {"
ET
ET
ET
ET
ET
ET
ET
zC
fQ
Xf
ld
ie
dL
Fg
Ms
cM
vx
dA
ho
yu
nC
Af
iv
Fb
Pe
bB
Zc
fh
ET
ET
ET
ET
ET
ET
ET
ET
ET
ET
ET
ET
ET
ET
ET
ET
ET
ET
ET
ET
ET
ET
"}
(19,1,1) = {"
ET
ET
ET
ET
ET
ET
SC
wy
wy
ok
ok
wy
ok
ok
rd
fh
fh
fh
fh
fh
fh
fh
fh
fh
fh
fh
fh
fh
ET
ET
ET
ET
ET
ET
ET
ET
ET
ET
ET
ET
ET
ET
ET
ET
ET
ET
ET
ET
ET
ET
"}
(20,1,1) = {"
ET
ET
ET
ET
ET
ET
ET
Tj
ET
ET
ET
ET
ET
ET
Tj
ET
ET
ET
ET
ET
ET
Tj
ET
ET
ET
ET
ET
Tj
ET
ET
ET
ET
ET
ET
ET
ET
ET
ET
ET
ET
ET
ET
ET
ET
ET
ET
ET
ET
ET
ET
"}
(21,1,1) = {"
ET
ET
ET
ET
ET
ET
ET
ET
ET
ET
ET
ET
ET
ET
ET
ET
ET
ET
ET
ET
ET
ET
ET
ET
ET
ET
ET
ET
ET
ET
ET
ET
ET
ET
ET
ET
ET
ET
ET
ET
ET
ET
ET
ET
ET
ET
ET
ET
ET
ET
"}
(22,1,1) = {"
ET
ET
ET
ET
ET
ET
ET
ET
ET
ET
ET
ET
ET
ET
ET
ET
ET
ET
ET
ET
ET
ET
ET
ET
ET
ET
ET
ET
ET
ET
ET
ET
ET
ET
ET
ET
ET
ET
ET
ET
ET
ET
ET
ET
ET
ET
ET
ET
ET
ET
"}
(23,1,1) = {"
ET
ET
ET
ET
ET
ET
ET
ET
ET
ET
ET
ET
ET
ET
ET
ET
ET
ET
ET
ET
ET
ET
ET
ET
ET
ET
ET
ET
ET
ET
ET
ET
ET
ET
ET
ET
ET
ET
ET
ET
ET
ET
ET
ET
ET
ET
ET
ET
ET
ET
"}
(24,1,1) = {"
ET
ET
ET
ET
ET
ET
ET
ET
ET
ET
ET
ET
ET
ET
ET
ET
ET
ET
ET
ET
ET
ET
ET
ET
ET
ET
ET
ET
ET
ET
ET
ET
ET
ET
ET
ET
ET
ET
ET
ET
ET
ET
ET
ET
ET
ET
ET
ET
ET
ET
"}
(25,1,1) = {"
ET
ET
ET
ET
ET
ET
ET
ET
ET
ET
ET
ET
ET
ET
ET
ET
ET
ET
ET
ET
ET
ET
ET
ET
ET
ET
ET
ET
ET
ET
ET
ET
ET
ET
ET
ET
ET
ET
ET
ET
ET
ET
ET
ET
ET
ET
ET
ET
ET
ET
"}
(26,1,1) = {"
ET
ET
ET
ET
ET
ET
ET
ET
ET
ET
ET
ET
ET
ET
ET
ET
ET
ET
ET
ET
ET
ET
ET
ET
ET
ET
ET
ET
ET
ET
ET
ET
ET
ET
ET
ET
ET
ET
ET
ET
ET
ET
ET
ET
ET
ET
ET
ET
ET
ET
"}
(27,1,1) = {"
ET
ET
ET
ET
ET
ET
ET
ET
ET
ET
ET
ET
ET
ET
ET
ET
ET
ET
ET
ET
ET
ET
ET
ET
ET
ET
ET
ET
ET
ET
ET
ET
ET
ET
ET
ET
ET
ET
ET
ET
ET
ET
ET
ET
ET
ET
ET
ET
ET
ET
"}
(28,1,1) = {"
ET
ET
ET
ET
ET
ET
ET
ET
ET
ET
ET
ET
ET
ET
ET
ET
ET
ET
ET
ET
ET
ET
ET
ET
ET
ET
ET
ET
ET
ET
ET
ET
ET
ET
ET
ET
ET
ET
ET
ET
ET
ET
ET
ET
ET
ET
ET
ET
ET
ET
"}
(29,1,1) = {"
ET
ET
ET
ET
ET
ET
ET
ET
ET
ET
ET
ET
ET
ET
ET
ET
ET
ET
ET
ET
ET
ET
ET
ET
ET
ET
ET
ET
ET
ET
ET
ET
ET
ET
ET
ET
ET
ET
ET
ET
ET
ET
ET
ET
ET
ET
ET
ET
ET
ET
"}
(30,1,1) = {"
ET
ET
ET
ET
ET
ET
ET
ET
ET
ET
ET
ET
ET
ET
ET
ET
ET
ET
ET
ET
ET
ET
ET
ET
ET
ET
ET
ET
ET
ET
ET
ET
ET
ET
ET
ET
ET
ET
ET
ET
ET
ET
ET
ET
ET
ET
ET
ET
ET
ET
"}
(31,1,1) = {"
ET
ET
ET
ET
ET
ET
ET
ET
ET
ET
ET
ET
ET
ET
ET
ET
ET
ET
ET
ET
ET
ET
ET
ET
ET
ET
ET
ET
ET
ET
ET
ET
ET
ET
ET
ET
ET
ET
ET
ET
ET
ET
ET
ET
ET
ET
ET
ET
ET
ET
"}
(32,1,1) = {"
ET
ET
ET
ET
ET
ET
ET
ET
ET
ET
ET
ET
ET
ET
ET
ET
ET
ET
ET
ET
ET
ET
ET
ET
ET
ET
ET
ET
ET
ET
ET
ET
ET
ET
ET
ET
ET
ET
ET
ET
ET
ET
ET
ET
ET
ET
ET
ET
ET
ET
"}
(33,1,1) = {"
ET
ET
ET
ET
ET
ET
ET
ET
ET
ET
ET
ET
ET
ET
ET
ET
ET
ET
ET
ET
ET
ET
ET
ET
ET
ET
ET
ET
ET
ET
ET
ET
ET
ET
ET
ET
ET
ET
ET
ET
ET
ET
ET
ET
ET
ET
ET
ET
ET
ET
"}
(34,1,1) = {"
ET
ET
ET
ET
ET
ET
ET
ET
ET
ET
ET
ET
ET
ET
ET
ET
ET
ET
ET
ET
ET
ET
ET
ET
ET
ET
ET
ET
ET
ET
ET
ET
ET
ET
ET
ET
ET
ET
ET
ET
ET
ET
ET
ET
ET
ET
ET
ET
ET
ET
"}
(35,1,1) = {"
ET
ET
ET
ET
ET
ET
ET
ET
ET
ET
ET
ET
ET
ET
ET
ET
ET
ET
ET
ET
ET
ET
ET
ET
ET
ET
ET
ET
ET
ET
ET
ET
ET
ET
ET
ET
ET
ET
ET
ET
ET
ET
ET
ET
ET
ET
ET
ET
ET
ET
"}
(36,1,1) = {"
ET
ET
ET
ET
ET
ET
ET
ET
ET
ET
ET
ET
ET
ET
ET
ET
ET
ET
ET
ET
ET
ET
ET
ET
ET
ET
ET
ET
ET
ET
ET
ET
ET
ET
ET
ET
ET
ET
ET
ET
ET
ET
ET
ET
ET
ET
ET
ET
ET
ET
"}
(37,1,1) = {"
ET
ET
ET
ET
ET
ET
ET
ET
ET
ET
ET
ET
ET
ET
ET
ET
ET
ET
ET
ET
ET
ET
ET
ET
ET
ET
ET
ET
ET
ET
ET
ET
ET
ET
ET
ET
ET
ET
ET
ET
ET
ET
ET
ET
ET
ET
ET
ET
ET
ET
"}
(38,1,1) = {"
ET
ET
ET
ET
ET
ET
ET
ET
ET
ET
ET
ET
ET
ET
ET
ET
ET
ET
ET
ET
ET
ET
ET
ET
ET
ET
ET
ET
ET
ET
ET
ET
ET
ET
ET
ET
ET
ET
ET
ET
ET
ET
ET
ET
ET
ET
ET
ET
ET
ET
"}
(39,1,1) = {"
ET
ET
ET
ET
ET
ET
ET
ET
ET
ET
ET
ET
ET
ET
ET
ET
ET
ET
ET
ET
ET
ET
ET
ET
ET
ET
ET
ET
ET
ET
ET
ET
ET
ET
ET
ET
ET
ET
ET
ET
ET
ET
ET
ET
ET
ET
ET
ET
ET
ET
"}
(40,1,1) = {"
ET
ET
ET
ET
ET
ET
ET
ET
ET
ET
ET
ET
ET
ET
ET
ET
ET
ET
ET
ET
ET
ET
ET
ET
ET
ET
ET
ET
ET
ET
ET
ET
ET
ET
ET
ET
ET
ET
ET
ET
ET
ET
ET
ET
ET
ET
ET
ET
ET
ET
"}
(41,1,1) = {"
ET
ET
ET
ET
ET
ET
ET
ET
ET
ET
ET
ET
ET
ET
ET
ET
ET
ET
ET
ET
ET
ET
ET
ET
ET
ET
ET
ET
ET
ET
ET
ET
ET
ET
ET
ET
ET
ET
ET
ET
ET
ET
ET
ET
ET
ET
ET
ET
ET
ET
"}
(42,1,1) = {"
ET
ET
ET
ET
ET
ET
ET
ET
ET
ET
ET
ET
ET
ET
ET
ET
ET
ET
ET
ET
ET
ET
ET
ET
ET
ET
ET
ET
ET
ET
ET
ET
ET
ET
ET
ET
ET
ET
ET
ET
ET
ET
ET
ET
ET
ET
ET
ET
ET
ET
"}
(43,1,1) = {"
ET
ET
ET
ET
ET
ET
ET
ET
ET
ET
ET
ET
ET
ET
ET
ET
ET
ET
ET
ET
ET
ET
ET
ET
ET
ET
ET
ET
ET
ET
ET
ET
ET
ET
ET
ET
ET
ET
ET
ET
ET
ET
ET
ET
ET
ET
ET
ET
ET
ET
"}
(44,1,1) = {"
ET
ET
ET
ET
ET
ET
ET
ET
ET
ET
ET
ET
ET
ET
ET
ET
ET
ET
ET
ET
ET
ET
ET
ET
ET
ET
ET
ET
ET
ET
ET
ET
ET
ET
ET
ET
ET
ET
ET
ET
ET
ET
ET
ET
ET
ET
ET
ET
ET
ET
"}
(45,1,1) = {"
ET
ET
ET
ET
ET
ET
ET
ET
ET
ET
ET
ET
ET
ET
ET
ET
ET
ET
ET
ET
ET
ET
ET
ET
ET
ET
ET
ET
ET
ET
ET
ET
ET
ET
ET
ET
ET
ET
ET
ET
ET
ET
ET
ET
ET
ET
ET
ET
ET
ET
"}
(46,1,1) = {"
ET
ET
ET
ET
ET
ET
ET
ET
ET
ET
ET
ET
ET
ET
ET
ET
ET
ET
ET
ET
ET
ET
ET
ET
ET
ET
ET
ET
ET
ET
ET
ET
ET
ET
ET
ET
ET
ET
ET
ET
ET
ET
ET
ET
ET
ET
ET
ET
ET
ET
"}
(47,1,1) = {"
ET
ET
ET
ET
ET
ET
ET
ET
ET
ET
ET
ET
ET
ET
ET
ET
ET
ET
ET
ET
ET
ET
ET
ET
ET
ET
ET
ET
ET
ET
ET
ET
ET
ET
ET
ET
ET
ET
ET
ET
ET
ET
ET
ET
ET
ET
ET
ET
ET
ET
"}
(48,1,1) = {"
ET
ET
ET
ET
ET
ET
ET
ET
ET
ET
ET
ET
ET
ET
ET
ET
ET
ET
ET
ET
ET
ET
ET
ET
ET
ET
ET
ET
ET
ET
ET
ET
ET
ET
ET
ET
ET
ET
ET
ET
ET
ET
ET
ET
ET
ET
ET
ET
ET
ET
"}
(49,1,1) = {"
ET
ET
ET
ET
ET
ET
ET
ET
ET
ET
ET
ET
ET
ET
ET
ET
ET
ET
ET
ET
ET
ET
ET
ET
ET
ET
ET
ET
ET
ET
ET
ET
ET
ET
ET
ET
ET
ET
ET
ET
ET
ET
ET
ET
ET
ET
ET
ET
ET
ET
"}
(50,1,1) = {"
ET
ET
ET
ET
ET
ET
ET
ET
ET
ET
ET
ET
ET
ET
ET
ET
ET
ET
ET
ET
ET
ET
ET
ET
ET
ET
ET
ET
ET
ET
ET
ET
ET
ET
ET
ET
ET
ET
ET
ET
ET
ET
ET
ET
ET
ET
ET
ET
ET
ET
"}
