//MAP CONVERTED BY dmm2tgm.py THIS HEADER COMMENT PREVENTS RECONVERSION, DO NOT REMOVE
"aE" = (
/obj/machinery/doppler_array,
/turf/simulated/floor/plasteel,
/area/space)
"aZ" = (
/obj/machinery/chem_heater,
/turf/simulated/floor/plasteel,
/area/space)
"cT" = (
/obj/machinery/biogenerator,
/turf/simulated/floor/plasteel,
/area/space)
"dW" = (
/obj/machinery/fishtank,
/turf/simulated/floor/plasteel,
/area/space)
"ey" = (
/obj/effect/landmark{
	icon = 'icons/effects/spawner_icons.dmi';
	icon_state = "spooky";
	name = "Observer-Start"
	},
/obj/effect/landmark/spawner/late/crew,
/turf/simulated/floor/plasteel,
/area/space)
"fc" = (
/obj/machinery/door/firedoor,
/turf/simulated/floor/plasteel,
/area/space)
"fj" = (
/obj/machinery/chem_dispenser,
/turf/simulated/floor/plasteel,
/area/space)
"fU" = (
/obj/machinery/economy/vending/wallmed/directional/north,
/turf/simulated/floor/plasteel,
/area/space)
"gG" = (
/turf/simulated/floor/mech_bay_recharge_floor,
/area/space)
"ht" = (
/obj/machinery/atmospherics/pipe/simple/hidden/blue{
	dir = 5
	},
/turf/simulated/floor/plasteel,
/area/space)
"hL" = (
/obj/machinery/bookbinder,
/turf/simulated/floor/plasteel,
/area/space)
"hU" = (
/obj/machinery/economy/vending/atmosdrobe,
/turf/simulated/floor/plasteel,
/area/space)
"ic" = (
/obj/machinery/door/airlock/external,
/turf/simulated/floor/plasteel,
/area/space)
"iC" = (
/obj/machinery/bottler,
/turf/simulated/floor/plasteel,
/area/space)
"ja" = (
/obj/structure/table,
/obj/machinery/cell_charger,
/turf/simulated/floor/plasteel,
/area/space)
"jW" = (
/obj/machinery/optable,
/turf/simulated/floor/plasteel,
/area/space)
"kV" = (
/obj/machinery/computer/emergency_shuttle,
/turf/simulated/floor/plasteel,
/area/space)
"lM" = (
/obj/machinery/computer/guestpass{
	pixel_y = 32
	},
/turf/simulated/floor/plasteel,
/area/space)
"lO" = (
/obj/machinery/atmospherics/pipe/simple/hidden/blue{
	dir = 6
	},
/turf/simulated/floor/plasteel,
/area/space)
"mz" = (
/obj/machinery/computer/med_data/laptop,
/obj/structure/table,
/turf/simulated/floor/plasteel,
/area/space)
"nt" = (
/obj/machinery/atmospherics/pipe/simple/hidden/blue{
	dir = 10
	},
/turf/simulated/floor/plasteel,
/area/space)
"oh" = (
/obj/machinery/atmospherics/unary/tank/oxygen,
/turf/simulated/floor/plasteel,
/area/space)
"px" = (
/obj/machinery/atmospherics/portable/scrubber,
/turf/simulated/floor/plasteel,
/area/space)
"qc" = (
/turf/simulated/floor/plasteel,
/area/space)
"qN" = (
/obj/machinery/cryopod{
	dir = 4
	},
/turf/simulated/floor/plasteel,
/area/space)
"sj" = (
/obj/machinery/sleeper{
	dir = 4
	},
/turf/simulated/floor/plasteel,
/area/space)
"so" = (
/obj/machinery/dna_scannernew,
/turf/simulated/floor/plasteel,
/area/space)
"tn" = (
/obj/machinery/computer/security/telescreen/rd{
	pixel_y = 32
	},
/turf/simulated/floor/plasteel,
/area/space)
"to" = (
/obj/machinery/door/airlock,
/turf/simulated/floor/plasteel,
/area/space)
"tL" = (
/obj/machinery/economy/slot_machine,
/turf/simulated/floor/plasteel,
/area/space)
"vi" = (
/obj/effect/landmark/game_test/top_right_corner,
/turf/simulated/floor/plasteel,
/area/space)
"vL" = (
/obj/effect/landmark/game_test/bottom_left_corner,
/turf/simulated/floor/plasteel,
/area/space)
"ws" = (
/obj/machinery/computer/library,
/turf/simulated/floor/plasteel,
/area/space)
"ye" = (
/obj/machinery/computer/card,
/turf/simulated/floor/plasteel,
/area/space)
"zA" = (
/obj/machinery/computer/communications,
/turf/simulated/floor/plasteel,
/area/space)
"Au" = (
/turf/simulated/wall/r_wall,
/area/space)
"AI" = (
/obj/machinery/door/airlock/external,
/obj/machinery/door/airlock/external,
/turf/simulated/floor/plasteel,
/area/space)
"AM" = (
/obj/machinery/conveyor_switch,
/turf/simulated/floor/plasteel,
/area/space)
"Bi" = (
/obj/machinery/atmospherics/pipe/simple/hidden/blue{
	dir = 9
	},
/turf/simulated/floor/plasteel,
/area/space)
"Bn" = (
/obj/machinery/atmospherics/pipe/simple/hidden/blue{
	dir = 4
	},
/turf/simulated/floor/plasteel,
/area/space)
"Bo" = (
/obj/machinery/r_n_d/circuit_imprinter,
/turf/simulated/floor/plasteel,
/area/space)
"CH" = (
/obj/machinery/clonepod,
/turf/simulated/floor/plasteel,
/area/space)
"EK" = (
/obj/machinery/mech_bay_recharge_port,
/turf/simulated/floor/plasteel,
/area/space)
"Fl" = (
/obj/machinery/compost_bin,
/turf/simulated/floor/plasteel,
/area/space)
"Ge" = (
/obj/machinery/mecha_part_fabricator,
/turf/simulated/floor/plasteel,
/area/space)
"KY" = (
/obj/machinery/computer/mech_bay_power_console,
/turf/simulated/floor/plasteel,
/area/space)
"Lb" = (
/obj/machinery/atmospherics/portable/pump,
/turf/simulated/floor/plasteel,
/area/space)
"LT" = (
/obj/machinery/computer/cloning,
/turf/simulated/floor/plasteel,
/area/space)
"Mh" = (
/obj/machinery/economy/atm/directional/north,
/turf/simulated/floor/plasteel,
/area/space)
"Mr" = (
/obj/machinery/floodlight,
/turf/simulated/floor/plasteel,
/area/space)
"NE" = (
/obj/machinery/alarm/directional/north,
/turf/simulated/floor/plasteel,
/area/space)
"NX" = (
/obj/machinery/disco,
/turf/simulated/floor/plasteel,
/area/space)
"OG" = (
/obj/machinery/cryopod/robot,
/turf/simulated/floor/plasteel,
/area/space)
"Qx" = (
/obj/machinery/computer/arcade,
/turf/simulated/floor/plasteel,
/area/space)
"RD" = (
/obj/machinery/r_n_d/protolathe,
/turf/simulated/floor/plasteel,
/area/space)
"RO" = (
/obj/machinery/computer/operating,
/turf/simulated/floor/plasteel,
/area/space)
"RP" = (
/obj/machinery/autolathe,
/turf/simulated/floor/plasteel,
/area/space)
"SZ" = (
/obj/machinery/button/windowtint,
/turf/simulated/wall/r_wall,
/area/space)
"TH" = (
/obj/machinery/computer/scan_consolenew,
/turf/simulated/floor/plasteel,
/area/space)
"Ua" = (
/obj/machinery/conveyor{
	dir = 4
	},
/turf/simulated/floor/plasteel,
/area/space)
"Uk" = (
/obj/machinery/clonescanner,
/turf/simulated/floor/plasteel,
/area/space)
"VL" = (
/obj/machinery/chem_master,
/turf/simulated/floor/plasteel,
/area/space)
"Xs" = (
/obj/machinery/bodyscanner{
	dir = 4
	},
/turf/simulated/floor/plasteel,
/area/space)
"YO" = (
/obj/machinery/atmospherics/pipe/simple/hidden/blue,
/turf/simulated/floor/plasteel,
/area/space)
"Zk" = (
/obj/machinery/door/firedoor/closed,
/turf/simulated/floor/plasteel,
/area/space)

(1,1,1) = {"
Au
Au
Au
Au
Au
Au
Au
Au
Au
Au
Au
Au
Au
Au
Au
Au
Au
Au
Au
Au
Au
Au
Au
Au
Au
Au
Au
Au
Au
Au
Au
Au
"}
(2,1,1) = {"
Au
qc
qc
qc
qc
qc
qc
qc
qc
qc
qc
qc
qc
qc
qc
qc
qc
qc
qc
qc
qc
qc
qc
qc
qc
qc
qc
qc
qc
qc
qc
Au
"}
(3,1,1) = {"
Au
qc
qc
qc
qc
qc
qc
qc
qc
qc
qc
qc
hL
qc
qc
qc
qc
qc
qc
qc
qc
qc
qc
qc
qc
qc
qc
qc
qc
vL
qc
Au
"}
(4,1,1) = {"
Au
qc
qc
qc
qc
cT
qc
qc
OG
qc
qc
qc
ws
qc
qc
qc
qc
qc
iC
qc
qc
qc
qc
qc
Fl
Qx
qc
qc
qc
qc
qc
Au
"}
(5,1,1) = {"
Au
qc
qc
qc
qc
qc
qc
qc
qc
qc
qc
qc
qc
qc
qc
qc
qc
mz
qc
qc
qc
qc
qc
qc
qc
qc
qc
dW
qc
qc
qc
Au
"}
(6,1,1) = {"
Au
qc
qc
qc
qc
qc
qc
qc
Ge
qc
RP
qc
fj
qc
VL
qc
qc
ja
qc
qc
qc
qc
qc
qc
qc
aE
qc
qc
qc
qc
qc
Au
"}
(7,1,1) = {"
Au
qc
qc
qc
qc
qc
qc
qc
qc
qc
qc
qc
qc
qc
qc
qc
qc
qc
qc
qc
qc
qc
qc
qc
qc
qc
qc
Mr
qc
qc
qc
Au
"}
(8,1,1) = {"
Au
qc
qc
qc
qc
qc
qc
qc
EK
qc
RD
qc
aZ
qc
RO
qc
qc
qc
LT
qc
qc
qc
qc
qc
qc
qc
qc
qc
qc
qc
qc
Au
"}
(9,1,1) = {"
Au
qc
qc
qc
qc
qc
qc
qc
gG
qc
qc
qc
qc
qc
jW
qc
qc
qc
qc
qc
SZ
qc
qc
qc
qc
tL
qc
qc
qc
qc
qc
Au
"}
(10,1,1) = {"
Au
qc
qc
qc
qc
qc
qc
qc
KY
qc
Bo
qc
qc
qc
qc
qc
lO
YO
ht
qc
Au
NE
qc
qc
qc
hU
qc
qc
ey
qc
qc
Au
"}
(11,1,1) = {"
Au
qc
qc
qc
qc
qc
qc
qc
qc
qc
qc
qc
qc
qc
qc
qc
Bn
qc
Bn
qc
Au
tn
Ua
AM
qc
qc
qc
qc
qc
qc
qc
Au
"}
(12,1,1) = {"
Au
qc
qc
qc
qc
qc
qc
qc
qc
qc
qc
qc
qc
qc
qc
qc
nt
YO
Bi
qc
Au
Mh
Ua
qc
qc
qc
qc
qc
qc
qc
qc
Au
"}
(13,1,1) = {"
Au
qc
qc
qc
qc
qc
qc
qc
Xs
qc
qN
qc
CH
qc
Lb
qc
qc
qc
qc
qc
Au
fU
Ua
qc
qc
qc
qc
qc
qc
qc
qc
Au
"}
(14,1,1) = {"
Au
qc
qc
qc
qc
qc
qc
qc
qc
qc
qc
qc
qc
qc
px
qc
qc
qc
qc
qc
Au
lM
Ua
qc
qc
qc
qc
qc
qc
qc
qc
Au
"}
(15,1,1) = {"
Au
qc
qc
qc
qc
qc
qc
qc
sj
qc
RO
qc
Uk
qc
qc
qc
NX
qc
qc
qc
Au
qc
Ua
qc
qc
qc
qc
qc
qc
qc
qc
Au
"}
(16,1,1) = {"
Au
qc
qc
qc
qc
qc
qc
qc
qc
qc
jW
qc
qc
qc
oh
qc
qc
qc
qc
qc
Au
qc
qc
qc
ye
qc
qc
qc
qc
qc
qc
Au
"}
(17,1,1) = {"
Au
qc
qc
qc
qc
qc
qc
qc
qc
qc
qc
qc
so
qc
qc
qc
qc
qc
qc
qc
qc
qc
qc
qc
qc
qc
qc
qc
qc
qc
qc
Au
"}
(18,1,1) = {"
Au
qc
qc
qc
qc
qc
qc
qc
qc
qc
qc
qc
TH
qc
qc
qc
qc
to
qc
ic
qc
Zk
qc
qc
zA
qc
qc
qc
qc
qc
qc
Au
"}
(19,1,1) = {"
Au
qc
qc
qc
qc
qc
qc
qc
qc
qc
qc
qc
qc
qc
qc
qc
qc
to
qc
ic
qc
fc
qc
qc
qc
qc
qc
qc
qc
qc
qc
Au
"}
(20,1,1) = {"
Au
qc
qc
qc
qc
qc
qc
qc
qc
qc
qc
qc
qc
qc
qc
qc
qc
to
qc
ic
qc
qc
qc
qc
kV
qc
qc
qc
qc
qc
qc
Au
"}
(21,1,1) = {"
Au
qc
qc
qc
qc
qc
qc
qc
qc
qc
qc
qc
qc
qc
qc
qc
qc
to
qc
ic
qc
qc
qc
qc
qc
qc
qc
qc
qc
qc
qc
Au
"}
(22,1,1) = {"
Au
qc
qc
qc
qc
qc
qc
qc
qc
qc
qc
qc
qc
qc
qc
qc
qc
to
qc
AI
qc
qc
qc
qc
qc
qc
qc
qc
qc
qc
qc
Au
"}
(23,1,1) = {"
Au
qc
qc
qc
qc
qc
qc
qc
qc
qc
qc
qc
qc
qc
qc
qc
qc
qc
qc
qc
qc
qc
qc
qc
qc
qc
qc
qc
qc
qc
qc
Au
"}
(24,1,1) = {"
Au
qc
qc
qc
qc
qc
qc
qc
qc
qc
qc
qc
qc
qc
qc
qc
qc
qc
qc
qc
qc
qc
qc
qc
qc
qc
qc
qc
qc
qc
qc
Au
"}
(25,1,1) = {"
Au
qc
qc
qc
qc
qc
qc
qc
qc
qc
qc
qc
qc
qc
qc
qc
qc
qc
qc
qc
qc
qc
qc
qc
qc
qc
qc
qc
qc
qc
qc
Au
"}
(26,1,1) = {"
Au
qc
qc
qc
qc
qc
qc
qc
qc
qc
qc
qc
qc
qc
qc
qc
qc
qc
qc
qc
qc
qc
qc
qc
qc
qc
qc
qc
qc
qc
qc
Au
"}
(27,1,1) = {"
Au
qc
qc
qc
qc
qc
qc
qc
qc
qc
qc
qc
qc
qc
qc
qc
qc
qc
qc
qc
qc
qc
qc
qc
qc
qc
qc
qc
qc
qc
qc
Au
"}
(28,1,1) = {"
Au
qc
qc
qc
qc
qc
qc
qc
qc
qc
qc
qc
qc
qc
qc
qc
qc
qc
qc
qc
qc
qc
qc
qc
qc
qc
qc
qc
qc
qc
qc
Au
"}
(29,1,1) = {"
Au
qc
qc
qc
qc
qc
qc
qc
qc
qc
qc
qc
qc
qc
qc
qc
qc
qc
qc
qc
qc
qc
qc
qc
qc
qc
qc
qc
qc
qc
qc
Au
"}
(30,1,1) = {"
Au
qc
vi
qc
qc
qc
qc
qc
qc
qc
qc
qc
qc
qc
qc
qc
qc
qc
qc
qc
qc
qc
qc
qc
qc
qc
qc
qc
qc
qc
qc
Au
"}
(31,1,1) = {"
Au
qc
qc
qc
qc
qc
qc
qc
qc
qc
qc
qc
qc
qc
qc
qc
qc
qc
qc
qc
qc
qc
qc
qc
qc
qc
qc
qc
qc
qc
qc
Au
"}
(32,1,1) = {"
Au
Au
Au
Au
Au
Au
Au
Au
Au
Au
Au
Au
Au
Au
Au
Au
Au
Au
Au
Au
Au
Au
Au
Au
Au
Au
Au
Au
Au
Au
Au
Au
"}
