"a" = (/turf/space,/area/space)
"b" = (/turf/unsimulated/wall/metal,/area/space)
"c" = (/turf/simulated/floor/bluegrid{icon_state = "dark"; name = "Mainframe Floor"; nitrogen = 100; oxygen = 0; temperature = 80},/area/space)
"d" = (/turf/unsimulated/wall/fakeglass{dir = 8; icon_state = "fakewindows3"; tag = "icon-fakewindows (WEST)"},/area/space)
"e" = (/turf/simulated/floor/greengrid,/area/space)
"f" = (/turf/simulated/floor/bluegrid{name = "Mainframe Base"; nitrogen = 100; oxygen = 0; temperature = 80},/area/space)
"g" = (/obj/machinery/telecomms/hub/preset_cent,/turf/simulated/floor/bluegrid{icon_state = "dark"; name = "Mainframe Floor"; nitrogen = 100; oxygen = 0; temperature = 80},/area/space)
"h" = (/turf/simulated/floor/light,/area/space)
"i" = (/turf/unsimulated/wall/fakeglass{dir = 1; icon_state = "fakewindows"; tag = "icon-fakewindows (WEST)"},/area/space)
"j" = (/turf/unsimulated/wall/fakeglass{dir = 0; icon_state = "fakewindows"; tag = "icon-fakewindows (EAST)"},/area/space)
"k" = (/obj/machinery/telecomms/server/presets/centcomm,/turf/simulated/floor/greengrid,/area/space)
"l" = (/obj/machinery/telecomms/relay/preset/centcom,/turf/simulated/floor/greengrid,/area/space)
"m" = (/obj/machinery/computer/mecha,/turf/simulated/floor/bluegrid{icon_state = "dark"; name = "Mainframe Floor"; nitrogen = 100; oxygen = 0; temperature = 80},/area/space)
"n" = (/obj/machinery/telecomms/processor/preset_cent,/turf/simulated/floor/bluegrid{icon_state = "dark"; name = "Mainframe Floor"; nitrogen = 100; oxygen = 0; temperature = 80},/area/space)
"o" = (/turf/unsimulated/wall/fakeglass{icon_state = "fakewindows"; dir = 8},/area/space)
"p" = (/turf/unsimulated/wall/fakeglass{tag = "icon-fakewindows (EAST)"; icon_state = "fakewindows"; dir = 4},/area/space)
"q" = (/obj/effect/landmark{name = "avatarspawn"},/turf/simulated/floor/light,/area/space)
"r" = (/turf/unsimulated/wall/fakeglass,/area/space)

(1,1,1) = {"
aaaaaaaaaaaaaaaaaaaaaaaaaaaaaaaaaaaaaaaaaaaaaaaaaaaaaaaaaaaa
aaaaaaaaaaaaaaaaaaaaaaaaaaaaaaaaaaaaaaaaaaaaaaaaaaaaaaaaaaaa
aaaaaaaaaaaaaaaaaaaaaaaaaaaaaaaaaaaaaaaaaaaaaaaaaaaaaaaaaaaa
aaaaaaaaaaaaaaaaaaaaaaaaaaaaaaaaaaaaaaaaaaaaaaaaaaaaaaaaaaaa
aaaaaaaaaaaaaaaaaaaaaaaaaaaaaaaaaaaaaaaaaaaaaaaaaaaaaaaaaaaa
aaaaaaaaaaaaaaaaaaaaaaaaaaaaaaaaaaaaaaaaaaaaaaaaaaaaaaaaaaaa
aaaaaaaaaaaaaaaaaaaaaaaaaaaaaaaaaaaaaaaaaaaaaaaaaaaaaaaaaaaa
aaaaaaaaaaaaaaaaaaaaaaaaaaaaaaaaaaaaaaaaaaaaaaaaaaaaaaaaaaaa
aaaaaaaaaaaaaaaaaaaaaaaaaaaaaaaaaaaaaaaaaaaaaaaaaaaaaaaaaaaa
aaaaaaaaaaaaaaaaaaaaaaaaaaaaaaaaaaaaaaaaaaaaaaaaaaaaaaaaaaaa
aaaaaaaaaaaaaaaaaaaaaaaaaaaaaaaaaaaaaaaaaaaaaaaaaaaaaaaaaaaa
aaaaaaaaaaaaaaaaaaaaaaaaaaaaaaaaaaaaaaaaaaaaaaaaaaaaaaaaaaaa
aaaaaaaaaaaaaaaaaaaaaaaaaaaaaaaaaaaaaaaaaaaaaaaaaaaaaaaaaaaa
aaaaaaaaaaaaaaaaaaaaaaaaaaaaaaaaaaaaaaaaaaaaaaaaaaaaaaaaaaaa
aaaaaaaaaaaaaaaaaaaaaaaaaaaaaaaaaaaaaaaaaaaaaaaaaaaaaaaaaaaa
aaaaaaaaaaaaaaaaaaaaaaaaaaaaaaaaaaaaaaaaaaaaaaaaaaaaaaaaaaaa
aaaaaaaaaaaaaaaaaaaaaaaaaaaaaaaaaaaaaaaaaaaaaaaaaaaaaaaaaaaa
aaaaaaaaaaaaaaaaaaaaaaaaaaaaaaaaaaaaaaaaaaaaaaaaaaaaaaaaaaaa
aaaaaaaaaaaaaaaaaaaaaaaaaaaaaaaaaaaaaaaaaaaaaaaaaaaaaaaaaaaa
aaaaaaaaaaaaaaaaaaaaaaaaaaaaaaaaaaaaaaaaaaaaaaaaaaaaaaaaaaaa
aaaaaaaaaaaaaaaaaaaaaaaaaaaaaaaaaaaaaaaaaaaaaaaaaaaaaaaaaaaa
aaaaaaaaaaaaaaaaaaaaaaaaaabbbbaaaaaaaaaaaaaaaaaaaaaaaaaaaaaa
aaaaaaaaaaaaaaaaaaaaaaaaabbccbbaaaaaaaaaaaaaaaaaaaaaaaaaaaaa
aaaaaaaaaaaaaaaaaaaaaaabbbdeedbbbaaaaaaaaaaaaaaaaaaaaaaaaaaa
aaaabbbbbbbbbbbbbbbbbbbbffgeegffbbbbaaaaaaaaaaaaaaaaaaaaaaaa
aaaabcccfcfcfcfcfcccbffffhieeihffffbaaaaaaaaaaaaaaaaaaaaaaaa
aaaabcchfhfhfhfhfhccbfhchcjeejchchfbaaaaaaaaaaaaaaaaaaaaaaaa
aaaabbffkflfkflfkffbbfcfffgeegfffcfbbaaaaaaaaaaaaaaaaaaaaaaa
aaaaabchfhfhfhfhfhcbffhfchieeihcfhffbaaaaaaaaaaaaaaaaaaaaaaa
aaaaabbcfcfcfcfcfcbbfhcfhcjeejchfchfbbaaaaaaaaaaaaaaaaaaaaaa
aaaaaabdmdmdmdmdmdbdnopnopbeebopnopndbbaaaaaaaaaaaaaaaaaaaaa
aaaaaabeeeeeeeeeeeceeeeeeeeqqeeeeeeeecbaaaaaaaaaaaaaaaaaaaaa
aaaaaabeeeeeeeeeeeceeeeeeeeqqeeeeeeeecbaaaaaaaaaaaaaaaaaaaaa
aaaaaabbbbbbbbbbbbbdnopnopbeebopnopndbbaaaaaaaaaaaaaaaaaaaaa
aaaaaabaaaaaaaaaaabbfhcfhcieeichfchfbbaaaaaaaaaaaaaaaaaaaaaa
aaaaaaaaaaaaaaaaaaabffhfchreejhcfhffbaaaaaaaaaaaaaaaaaaaaaaa
aaaaaaaaaaaaaaaaaaabbfcfffgeegfffcfbbaaaaaaaaaaaaaaaaaaaaaaa
aaaaaaaaaaaaaaaaaaaabfhchcieeichchfbaaaaaaaaaaaaaaaaaaaaaaaa
aaaaaaaaaaaaaaaaaaaabffffhreejhffffbaaaaaaaaaaaaaaaaaaaaaaaa
aaaaaaaaaaaaaaaaaaaabbbbffgeegffbbbbaaaaaaaaaaaaaaaaaaaaaaaa
aaaaaaaaaaaaaaaaaaaaaaabbbdeedbbbaaaaaaaaaaaaaaaaaaaaaaaaaaa
aaaaaaaaaaaaaaaaaaaaaaaaabbccbbaaaaaaaaaaaaaaaaaaaaaaaaaaaaa
aaaaaaaaaaaaaaaaaaaaaaaaaabbbbaaaaaaaaaaaaaaaaaaaaaaaaaaaaaa
aaaaaaaaaaaaaaaaaaaaaaaaaaaaaaaaaaaaaaaaaaaaaaaaaaaaaaaaaaaa
aaaaaaaaaaaaaaaaaaaaaaaaaaaaaaaaaaaaaaaaaaaaaaaaaaaaaaaaaaaa
aaaaaaaaaaaaaaaaaaaaaaaaaaaaaaaaaaaaaaaaaaaaaaaaaaaaaaaaaaaa
aaaaaaaaaaaaaaaaaaaaaaaaaaaaaaaaaaaaaaaaaaaaaaaaaaaaaaaaaaaa
aaaaaaaaaaaaaaaaaaaaaaaaaaaaaaaaaaaaaaaaaaaaaaaaaaaaaaaaaaaa
aaaaaaaaaaaaaaaaaaaaaaaaaaaaaaaaaaaaaaaaaaaaaaaaaaaaaaaaaaaa
aaaaaaaaaaaaaaaaaaaaaaaaaaaaaaaaaaaaaaaaaaaaaaaaaaaaaaaaaaaa
aaaaaaaaaaaaaaaaaaaaaaaaaaaaaaaaaaaaaaaaaaaaaaaaaaaaaaaaaaaa
aaaaaaaaaaaaaaaaaaaaaaaaaaaaaaaaaaaaaaaaaaaaaaaaaaaaaaaaaaaa
aaaaaaaaaaaaaaaaaaaaaaaaaaaaaaaaaaaaaaaaaaaaaaaaaaaaaaaaaaaa
aaaaaaaaaaaaaaaaaaaaaaaaaaaaaaaaaaaaaaaaaaaaaaaaaaaaaaaaaaaa
aaaaaaaaaaaaaaaaaaaaaaaaaaaaaaaaaaaaaaaaaaaaaaaaaaaaaaaaaaaa
aaaaaaaaaaaaaaaaaaaaaaaaaaaaaaaaaaaaaaaaaaaaaaaaaaaaaaaaaaaa
aaaaaaaaaaaaaaaaaaaaaaaaaaaaaaaaaaaaaaaaaaaaaaaaaaaaaaaaaaaa
aaaaaaaaaaaaaaaaaaaaaaaaaaaaaaaaaaaaaaaaaaaaaaaaaaaaaaaaaaaa
aaaaaaaaaaaaaaaaaaaaaaaaaaaaaaaaaaaaaaaaaaaaaaaaaaaaaaaaaaaa
aaaaaaaaaaaaaaaaaaaaaaaaaaaaaaaaaaaaaaaaaaaaaaaaaaaaaaaaaaaa
"}
