//MAP CONVERTED BY dmm2tgm.py THIS HEADER COMMENT PREVENTS RECONVERSION, DO NOT REMOVE
"a" = (
/turf/simulated/wall/mineral/titanium,
/area/ruin/powered)
"b" = (
/turf/space,
/area/ruin/powered)
"d" = (
/obj/machinery/door/airlock/titanium,
/turf/simulated/floor/mineral/titanium/blue,
/area/ruin/powered)
"g" = (
/obj/effect/spawner/window/shuttle,
/turf/simulated/floor/plating,
/area/ruin/powered)
"h" = (
/turf/simulated/floor/mineral/titanium/blue,
/area/ruin/powered)
"i" = (
/obj/machinery/light,
/turf/simulated/floor/mineral/titanium/blue,
/area/ruin/powered)
"j" = (
/obj/structure/shuttle/engine/heater,
/turf/simulated/floor/plating/airless,
/area/ruin/powered)
"k" = (
/obj/structure/shuttle/engine/propulsion,
/turf/simulated/floor/plating/airless,
/area/ruin/powered)
"m" = (
/obj/structure/chair/comfy/shuttle{
	dir = 4
	},
/turf/simulated/floor/mineral/titanium/blue,
/area/ruin/powered)
"n" = (
/obj/machinery/light{
	dir = 8
	},
/obj/structure/window/reinforced,
/turf/simulated/floor/mineral/titanium/blue,
/area/ruin/powered)
"o" = (
/obj/structure/shuttle/engine/propulsion{
	icon_state = "propulsion_l"
	},
/turf/simulated/floor/plating/airless,
/area/ruin/powered)
"q" = (
/obj/machinery/computer,
/turf/simulated/floor/mineral/titanium/blue,
/area/ruin/powered)
"r" = (
/obj/structure/chair/comfy/shuttle{
	dir = 1
	},
/turf/simulated/floor/mineral/titanium/blue,
/area/ruin/powered)
"u" = (
/obj/structure/chair/comfy/shuttle{
	dir = 8
	},
/turf/simulated/floor/mineral/titanium/blue,
/area/ruin/powered)
"v" = (
/obj/machinery/light{
	dir = 4
	},
/obj/structure/window/reinforced,
/turf/simulated/floor/mineral/titanium/blue,
/area/ruin/powered)
"w" = (
/obj/structure/shuttle/engine/propulsion{
	icon_state = "propulsion_r"
	},
/turf/simulated/floor/plating/airless,
/area/ruin/powered)
"A" = (
/obj/structure/window/reinforced,
/turf/simulated/floor/mineral/titanium/blue,
/area/ruin/powered)
"D" = (
/obj/machinery/door/airlock/titanium,
/turf/simulated/floor/plating,
/area/ruin/powered)

(1,1,1) = {"
b
b
b
a
a
a
D
D
a
a
a
"}
(2,1,1) = {"
a
a
a
a
m
m
h
h
n
j
o
"}
(3,1,1) = {"
g
h
i
a
h
h
h
h
A
j
k
"}
(4,1,1) = {"
g
r
h
d
h
h
h
h
A
j
k
"}
(5,1,1) = {"
g
q
i
a
h
h
h
h
A
j
k
"}
(6,1,1) = {"
a
a
a
a
u
u
h
h
v
j
w
"}
(7,1,1) = {"
b
b
b
a
a
a
D
D
a
a
a
"}
