//MAP CONVERTED BY dmm2tgm.py THIS HEADER COMMENT PREVENTS RECONVERSION, DO NOT REMOVE
"a" = (
/turf/space,
/area/space)
"b" = (
/obj/structure/shuttle/engine/propulsion{
	dir = 8
	},
/turf/simulated/wall/mineral/titanium,
/area/shuttle/transport)
"c" = (
/turf/simulated/wall/mineral/titanium,
/area/shuttle/transport)
"d" = (
/obj/effect/spawner/window/shuttle,
/turf/simulated/floor/plating,
/area/shuttle/transport)
"e" = (
/obj/item/flag/ussp,
/turf/simulated/floor/mineral/plastitanium/red,
/area/shuttle/transport)
"f" = (
/obj/structure/chair/comfy/red{
	dir = 4
	},
/obj/structure/window/reinforced{
	dir = 8
	},
/turf/simulated/floor/carpet/red,
/area/shuttle/transport)
"g" = (
/obj/effect/turf_decal/stripes/corner{
	dir = 1
	},
/obj/effect/turf_decal/stripes/corner{
	dir = 8
	},
/turf/simulated/floor/mineral/plastitanium/red,
/area/shuttle/transport)
"h" = (
/obj/item/flag/ussp,
/obj/machinery/light/directional/north,
/obj/structure/window/reinforced{
	dir = 4
	},
/obj/structure/window/reinforced,
/turf/simulated/floor/mineral/plastitanium/red,
/area/shuttle/transport)
"i" = (
/obj/structure/chair/comfy/shuttle/dark,
/obj/effect/turf_decal/stripes/line{
	dir = 9
	},
/turf/simulated/floor/mineral/plastitanium/red,
/area/shuttle/transport)
"j" = (
/obj/structure/closet/crate,
/obj/item/paper,
/obj/item/paper,
/obj/item/paper,
/obj/item/stamp/ussp,
/obj/item/pen/hos{
	name = "USSP fountain pen";
	desc = "An expensive-looking pen."
	},
/turf/simulated/floor/mineral/plastitanium/red,
/area/shuttle/transport)
"k" = (
/obj/structure/sign/poster/contraband/communist_state{
	pixel_y = 32
	},
/obj/structure/table/wood/fancy/red,
/obj/item/reagent_containers/drinks/bottle/vodka{
	pixel_y = 12;
	pixel_x = -6
	},
/obj/item/reagent_containers/drinks/drinkingglass/shotglass{
	pixel_y = 2
	},
/obj/item/reagent_containers/drinks/drinkingglass/shotglass{
	pixel_y = 9;
	pixel_x = 6
	},
/obj/machinery/light/directional/north,
/turf/simulated/floor/carpet/red,
/area/shuttle/transport)
"l" = (
/obj/machinery/door/airlock/titanium{
	id_tag = "s_docking_airlock";
	name = "Шаттл СССП"
	},
/obj/docking_port/mobile{
	dir = 4;
	dwidth = 2;
	height = 12;
	id = "ferry";
	name = "ferry shuttle";
	roundstart_move = "ferry_away";
	timid = 1;
	width = 5
	},
/turf/simulated/floor/plating,
/area/shuttle/transport)
"m" = (
/turf/simulated/floor/mineral/plastitanium/red,
/area/shuttle/transport)
"n" = (
/obj/machinery/computer/shuttle/ferry/request{
	dir = 8
	},
/turf/simulated/floor/mineral/plastitanium/red,
/area/shuttle/transport)
"o" = (
/obj/effect/turf_decal/stripes/line,
/obj/effect/turf_decal/stripes/line{
	dir = 1
	},
/turf/simulated/floor/mineral/plastitanium/red,
/area/shuttle/transport)
"q" = (
/obj/item/flag/ussp,
/obj/machinery/light/directional/south,
/obj/structure/window/reinforced{
	dir = 4
	},
/obj/structure/window/reinforced{
	dir = 1
	},
/turf/simulated/floor/mineral/plastitanium/red,
/area/shuttle/transport)
"r" = (
/obj/structure/chair/comfy/shuttle/dark{
	dir = 4
	},
/turf/simulated/floor/mineral/plastitanium/red,
/area/shuttle/transport)
"s" = (
/obj/structure/chair/comfy/red{
	dir = 8
	},
/obj/structure/window/reinforced{
	dir = 4
	},
/turf/simulated/floor/carpet/red,
/area/shuttle/transport)
"t" = (
/obj/structure/sign/poster/contraband/communist_state{
	pixel_y = -32
	},
/obj/structure/table/wood/fancy/red,
/obj/item/clothing/mask/cigarette/cigar/cohiba{
	pixel_y = 2
	},
/obj/item/clothing/mask/cigarette/cigar/cohiba{
	pixel_y = 8
	},
/obj/item/radio/phone{
	pixel_y = 8
	},
/obj/machinery/light/directional/south,
/turf/simulated/floor/carpet/red,
/area/shuttle/transport)
"x" = (
/obj/machinery/door/window/reinforced/reversed{
	name = "Reinforced Glass Door";
	dir = 8
	},
/turf/simulated/floor/carpet/red,
/area/shuttle/transport)
"G" = (
/turf/simulated/wall/mineral/titanium/nodiagonal,
/area/shuttle/transport)
"K" = (
/obj/machinery/door/window/reinforced/normal{
	dir = 4;
	name = "Reinforced Glass Door"
	},
/turf/simulated/floor/carpet/red,
/area/shuttle/transport)
"M" = (
/obj/structure/chair/comfy/shuttle/dark,
/obj/effect/turf_decal/stripes/line{
	dir = 5
	},
/turf/simulated/floor/mineral/plastitanium/red,
/area/shuttle/transport)
"N" = (
/obj/structure/closet/crate,
/turf/simulated/floor/mineral/plastitanium/red,
/area/shuttle/transport)
"O" = (
/obj/structure/chair/comfy/shuttle/dark{
	dir = 1
	},
/obj/effect/turf_decal/stripes/line{
	dir = 10
	},
/turf/simulated/floor/mineral/plastitanium/red,
/area/shuttle/transport)
"R" = (
/obj/effect/turf_decal/stripes/line{
	dir = 4
	},
/turf/simulated/floor/mineral/plastitanium/red,
/area/shuttle/transport)
"U" = (
/turf/simulated/floor/carpet/red,
/area/shuttle/transport)
"Y" = (
/obj/structure/chair/comfy/shuttle/dark{
	dir = 1
	},
/obj/effect/turf_decal/stripes/line{
	dir = 6
	},
/turf/simulated/floor/mineral/plastitanium/red,
/area/shuttle/transport)

(1,1,1) = {"
a
b
l
b
a
"}
(2,1,1) = {"
b
G
o
G
b
"}
(3,1,1) = {"
c
h
o
q
c
"}
(4,1,1) = {"
d
i
g
O
d
"}
(5,1,1) = {"
d
M
R
Y
d
"}
(6,1,1) = {"
c
f
x
f
c
"}
(7,1,1) = {"
c
k
U
t
c
"}
(8,1,1) = {"
c
s
K
s
c
"}
(9,1,1) = {"
c
j
m
N
c
"}
(10,1,1) = {"
d
e
r
e
d
"}
(11,1,1) = {"
d
d
n
d
d
"}
(12,1,1) = {"
a
d
d
d
a
"}
