//MAP CONVERTED BY dmm2tgm.py THIS HEADER COMMENT PREVENTS RECONVERSION, DO NOT REMOVE
"aa" = (
/turf/template_noop,
/area/template_noop)
"ab" = (
/obj/machinery/shieldwallgen{
	activated = 1;
	anchored = 1
	},
/obj/structure/cable{
	icon_state = "0-4"
	},
/turf/simulated/floor/plating/airless,
/area/ruin/space/unpowered)
"ac" = (
/obj/structure/cable{
	icon_state = "4-8"
	},
/obj/effect/spawner/window/reinforced/grilled,
/turf/simulated/floor/plating,
/area/ruin/space/unpowered)
"ad" = (
/obj/machinery/shieldwallgen{
	activated = 1;
	anchored = 1
	},
/obj/structure/cable{
	icon_state = "0-2"
	},
/obj/structure/cable{
	icon_state = "2-8"
	},
/turf/simulated/floor/plating/airless,
/area/ruin/space/unpowered)
"ae" = (
/obj/machinery/shieldwallgen{
	activated = 1;
	anchored = 1
	},
/obj/structure/cable{
	icon_state = "2-4"
	},
/obj/structure/cable{
	icon_state = "0-2"
	},
/turf/simulated/floor/plating/airless,
/area/ruin/space/unpowered)
"af" = (
/obj/machinery/shieldwallgen{
	activated = 1;
	anchored = 1
	},
/obj/structure/cable{
	icon_state = "0-8"
	},
/turf/simulated/floor/plating/airless,
/area/ruin/space/unpowered)
"ag" = (
/obj/effect/spawner/window/reinforced/grilled,
/turf/simulated/floor/plating,
/area/ruin/space/unpowered)
"ah" = (
/turf/simulated/mineral,
/area/ruin/space/unpowered)
"ai" = (
/turf/simulated/floor/plating/asteroid/airless,
/area/ruin/space/unpowered)
"aj" = (
/obj/structure/flora/rock,
/turf/simulated/floor/plating/asteroid/airless,
/area/ruin/space/unpowered)
"ak" = (
/obj/structure/cable{
	icon_state = "1-2"
	},
/obj/effect/spawner/window/reinforced/grilled,
/turf/simulated/floor/plating,
/area/ruin/space/unpowered)
"al" = (
/obj/structure/flora/ausbushes/genericbush,
/turf/simulated/floor/grass,
/area/ruin/space/unpowered)
"am" = (
/mob/living/simple_animal/hostile/poison/bees,
/mob/living/simple_animal/hostile/poison/bees,
/mob/living/simple_animal/hostile/poison/bees,
/mob/living/simple_animal/hostile/poison/bees,
/mob/living/simple_animal/hostile/poison/bees,
/mob/living/simple_animal/hostile/poison/bees,
/turf/simulated/floor/grass,
/area/ruin/space/unpowered)
"an" = (
/mob/living/simple_animal/hostile/poison/bees,
/turf/simulated/floor/grass,
/area/ruin/space/unpowered)
"ao" = (
/obj/structure/flora/ausbushes/lavendergrass,
/turf/simulated/floor/grass,
/area/ruin/space/unpowered)
"ap" = (
/mob/living/basic/mining/goldgrub{
	will_burrow = 0
	},
/turf/simulated/floor/plating/asteroid/airless,
/area/ruin/space/unpowered)
"aq" = (
/obj/structure/flora/ausbushes/grassybush,
/turf/simulated/floor/grass,
/area/ruin/space/unpowered)
"ar" = (
/obj/structure/flora/rock/pile,
/turf/simulated/floor/plating/asteroid/airless,
/area/ruin/space/unpowered)
"as" = (
/mob/living/basic/mining/basilisk/space,
/turf/simulated/floor/plating/asteroid/airless,
/area/ruin/space/unpowered)
"at" = (
/turf/simulated/wall/r_wall,
/area/ruin/space/unpowered)
"au" = (
/obj/structure/flora/ausbushes/leafybush,
/mob/living/simple_animal/hostile/poison/bees,
/turf/simulated/floor/grass,
/area/ruin/space/unpowered)
"av" = (
/obj/structure/flora/ausbushes/brflowers,
/turf/simulated/floor/grass,
/area/ruin/space/unpowered)
"aw" = (
/obj/structure/flora/rock,
/obj/machinery/light,
/turf/simulated/floor/plating/asteroid/airless,
/area/ruin/space/unpowered)
"ax" = (
/obj/structure/table/reinforced,
/obj/item/clipboard,
/obj/item/clothing/mask/surgical,
/obj/item/razor,
/obj/machinery/light{
	dir = 8
	},
/turf/simulated/floor/plasteel/dark,
/area/ruin/space/unpowered)
"ay" = (
/turf/simulated/floor/plasteel,
/area/ruin/space/unpowered)
"az" = (
/obj/structure/table/reinforced,
/obj/item/storage/box/syringes{
	pixel_x = 5;
	pixel_y = 5
	},
/obj/item/storage/box/beakers,
/obj/machinery/light{
	dir = 4
	},
/turf/simulated/floor/plasteel/dark,
/area/ruin/space/unpowered)
"aA" = (
/obj/structure/flora/ausbushes/ywflowers,
/turf/simulated/floor/grass,
/area/ruin/space/unpowered)
"aB" = (
/obj/machinery/light,
/mob/living/simple_animal/hostile/poison/bees,
/turf/simulated/floor/grass,
/area/ruin/space/unpowered)
"aC" = (
/obj/structure/flora/ausbushes/ppflowers,
/turf/simulated/floor/grass,
/area/ruin/space/unpowered)
"aD" = (
/obj/structure/cable{
	icon_state = "4-8"
	},
/obj/machinery/door/airlock/highsecurity{
	name = "Bio Containment"
	},
/obj/effect/mapping_helpers/airlock/access/any/science/research,
/turf/simulated/floor/plasteel/dark,
/area/ruin/space/unpowered)
"aE" = (
/obj/machinery/shieldwallgen{
	activated = 1;
	anchored = 1
	},
/obj/structure/cable{
	icon_state = "0-2"
	},
/obj/structure/cable{
	icon_state = "1-2"
	},
/obj/structure/cable{
	icon_state = "2-8"
	},
/obj/structure/cable{
	icon_state = "2-4"
	},
/turf/simulated/floor/plating/airless,
/area/ruin/space/unpowered)
"aF" = (
/obj/structure/cable{
	icon_state = "4-8"
	},
/turf/simulated/wall/r_wall,
/area/ruin/space/unpowered)
"aG" = (
/obj/structure/table/reinforced,
/obj/structure/cable{
	icon_state = "4-8"
	},
/obj/effect/spawner/random/pool/spaceloot/zoo,
/turf/simulated/floor/plasteel/dark,
/area/ruin/space/unpowered)
"aH" = (
/obj/structure/cable{
	icon_state = "4-8"
	},
/turf/simulated/floor/plasteel,
/area/ruin/space/unpowered)
"aI" = (
/obj/structure/table/reinforced,
/obj/machinery/computer/med_data/laptop,
/obj/structure/cable{
	icon_state = "4-8"
	},
/turf/simulated/floor/plasteel/dark,
/area/ruin/space/unpowered)
"aJ" = (
/obj/machinery/shieldwallgen{
	activated = 1;
	anchored = 1
	},
/obj/structure/cable{
	icon_state = "4-8"
	},
/obj/structure/cable{
	icon_state = "1-8"
	},
/obj/structure/cable{
	icon_state = "0-8"
	},
/turf/simulated/floor/plating,
/area/ruin/space/unpowered)
"aK" = (
/obj/structure/window/reinforced{
	dir = 4
	},
/turf/template_noop,
/area/space/nearstation)
"aL" = (
/turf/simulated/floor/plasteel/dark,
/area/ruin/space/unpowered)
"aM" = (
/obj/structure/cable{
	icon_state = "1-2"
	},
/turf/simulated/wall/r_wall,
/area/ruin/space/unpowered)
"aN" = (
/obj/structure/table/reinforced,
/obj/item/folder,
/turf/simulated/floor/plasteel/dark,
/area/ruin/space/unpowered)
"aO" = (
/obj/structure/chair/office{
	dir = 8
	},
/turf/simulated/floor/plasteel,
/area/ruin/space/unpowered)
"aP" = (
/obj/structure/table/reinforced,
/obj/item/reagent_containers/glass/bottle/liver_enhance_virion,
/obj/item/reagent_containers/dropper,
/turf/simulated/floor/plasteel/dark,
/area/ruin/space/unpowered)
"aQ" = (
/obj/structure/window/reinforced{
	dir = 8
	},
/turf/template_noop,
/area/space/nearstation)
"aR" = (
/obj/machinery/light/small{
	dir = 4
	},
/turf/simulated/floor/plasteel/dark,
/area/ruin/space/unpowered)
"aS" = (
/obj/machinery/power/apc/worn_out/directional/west,
/obj/structure/cable{
	icon_state = "0-4"
	},
/obj/structure/rack,
/obj/item/melee/baton/cattleprod,
/obj/effect/spawner/random/maintenance,
/turf/simulated/floor/plasteel/dark,
/area/ruin/space/unpowered)
"aT" = (
/obj/structure/cable{
	icon_state = "2-8"
	},
/obj/structure/cable{
	icon_state = "1-2"
	},
/obj/structure/rack,
/obj/item/mod/control/pre_equipped/medical,
/obj/item/tank/internals/emergency_oxygen/double,
/turf/simulated/floor/plasteel/dark,
/area/ruin/space/unpowered)
"aU" = (
/obj/structure/rack,
/obj/item/crowbar,
/obj/item/shield/riot,
/obj/machinery/light{
	dir = 1
	},
/turf/simulated/floor/plasteel/dark,
/area/ruin/space/unpowered)
"aV" = (
/obj/machinery/smartfridge/secure/chemistry,
/turf/simulated/floor/plasteel/dark,
/area/ruin/space/unpowered)
"aW" = (
/obj/structure/table/reinforced,
/turf/simulated/floor/plasteel/dark,
/area/ruin/space/unpowered)
"aX" = (
/obj/structure/table/reinforced,
/obj/item/grenade/chem_grenade/antiweed{
	pixel_x = 3;
	pixel_y = 5
	},
/obj/item/grenade/chem_grenade/antiweed{
	pixel_x = 4
	},
/obj/item/grenade/chem_grenade/antiweed{
	pixel_x = -3;
	pixel_y = -1
	},
/obj/machinery/light{
	dir = 1
	},
/turf/simulated/floor/plasteel/dark,
/area/ruin/space/unpowered)
"aY" = (
/obj/structure/table/reinforced,
/obj/effect/spawner/random/pool/spaceloot/zoo,
/turf/simulated/floor/plasteel/dark,
/area/ruin/space/unpowered)
"aZ" = (
/obj/structure/table/reinforced,
/obj/item/cultivator,
/obj/item/shovel,
/turf/simulated/floor/plasteel/dark,
/area/ruin/space/unpowered)
"ba" = (
/obj/machinery/light/small{
	dir = 8
	},
/turf/simulated/floor/plasteel/dark,
/area/ruin/space/unpowered)
"bb" = (
/obj/machinery/door/airlock/hatch{
	name = "Bio-Research Station"
	},
/turf/simulated/floor/plasteel,
/area/ruin/space/unpowered)
"bc" = (
/obj/structure/cable{
	icon_state = "1-2"
	},
/turf/simulated/floor/plasteel,
/area/ruin/space/unpowered)
"bd" = (
/obj/machinery/power/terminal,
/obj/structure/cable{
	icon_state = "1-2"
	},
/turf/simulated/floor/plasteel,
/area/ruin/space/unpowered)
"be" = (
/obj/structure/reagent_dispensers/fueltank,
/turf/simulated/floor/plasteel/dark,
/area/ruin/space/unpowered)
"bf" = (
/obj/machinery/power/smes/magical{
	desc = "A high-capacity superconducting magnetic energy storage (SMES) unit.";
	name = "power storage unit"
	},
/obj/structure/cable,
/obj/structure/cable{
	icon_state = "1-2"
	},
/turf/simulated/floor/plasteel/dark,
/area/ruin/space/unpowered)
"bg" = (
/obj/structure/reagent_dispensers/watertank,
/obj/machinery/light,
/turf/simulated/floor/plasteel/dark,
/area/ruin/space/unpowered)
"bh" = (
/obj/machinery/disposal,
/obj/structure/disposalpipe/trunk,
/turf/simulated/floor/plasteel/dark,
/area/ruin/space/unpowered)
"bi" = (
/obj/structure/table/reinforced,
/obj/item/reagent_containers/hypospray/autoinjector/stimpack,
/obj/item/reagent_containers/glass/bottle/mutagen,
/turf/simulated/floor/plasteel/dark,
/area/ruin/space/unpowered)
"bj" = (
/obj/structure/table/reinforced,
/obj/item/surgicaldrill,
/obj/item/hemostat,
/obj/item/scalpel,
/obj/item/surgical_drapes,
/obj/item/retractor,
/obj/item/cautery,
/obj/item/circular_saw,
/obj/machinery/light,
/turf/simulated/floor/plasteel/dark,
/area/ruin/space/unpowered)
"bk" = (
/obj/machinery/optable,
/turf/simulated/floor/plasteel/dark,
/area/ruin/space/unpowered)
"bl" = (
/obj/machinery/computer/operating,
/turf/simulated/floor/plasteel/dark,
/area/ruin/space/unpowered)
"bm" = (
/obj/structure/closet/wardrobe/toxins_white,
/obj/structure/disposalpipe/segment,
/turf/simulated/floor/plasteel/dark,
/area/ruin/space/unpowered)
"bn" = (
/obj/structure/table/reinforced,
/obj/item/food/carrotfries,
/turf/simulated/floor/plasteel/dark,
/area/ruin/space/unpowered)
"bo" = (
/obj/machinery/shieldwallgen{
	activated = 1;
	anchored = 1
	},
/obj/structure/cable{
	icon_state = "1-2"
	},
/obj/structure/cable{
	icon_state = "1-8"
	},
/obj/structure/cable,
/obj/structure/cable{
	icon_state = "1-4"
	},
/turf/simulated/floor/plating,
/area/ruin/space/unpowered)
"bp" = (
/obj/structure/bed,
/obj/item/bedsheet/green,
/obj/structure/disposalpipe/segment,
/turf/simulated/floor/plasteel/dark,
/area/ruin/space/unpowered)
"bq" = (
/obj/item/stack/cable_coil/cut,
/obj/item/stack/tile/plasteel{
	pixel_x = 3;
	pixel_y = -4
	},
/obj/item/wirecutters,
/turf/simulated/floor/plating,
/area/ruin/space/unpowered)
"br" = (
/obj/structure/table/reinforced,
/obj/machinery/kitchen_machine/microwave,
/obj/structure/cable{
	icon_state = "4-8"
	},
/turf/simulated/floor/plasteel/dark,
/area/ruin/space/unpowered)
"bs" = (
/obj/structure/cable{
	icon_state = "4-8"
	},
/obj/structure/cable{
	icon_state = "2-8"
	},
/obj/structure/cable{
	icon_state = "0-8"
	},
/obj/machinery/shieldwallgen,
/turf/simulated/floor/plating,
/area/ruin/space/unpowered)
"bt" = (
/obj/structure/cable{
	icon_state = "0-8"
	},
/obj/machinery/shieldwallgen,
/turf/simulated/floor/plating/airless,
/area/ruin/space/unpowered)
"bu" = (
/obj/structure/flora/ausbushes/sunnybush,
/turf/simulated/floor/plating,
/area/ruin/space/unpowered)
"bv" = (
/turf/simulated/floor/plating,
/area/ruin/space/unpowered)
"bw" = (
/obj/machinery/light{
	dir = 1
	},
/mob/living/basic/carp,
/turf/simulated/floor/plating,
/area/ruin/space/unpowered)
"bx" = (
/obj/structure/flora/ausbushes/palebush,
/turf/simulated/floor/plating,
/area/ruin/space/unpowered)
"by" = (
/obj/structure/disposalpipe/segment/corner{
	dir = 4
	},
/turf/simulated/wall/r_wall,
/area/ruin/space/unpowered)
"bz" = (
/obj/machinery/space_heater,
/obj/structure/disposalpipe/segment/corner{
	dir = 8
	},
/obj/machinery/light{
	dir = 8
	},
/turf/simulated/floor/plasteel/dark,
/area/ruin/space/unpowered)
"bA" = (
/obj/structure/table/reinforced,
/obj/machinery/reagentgrinder,
/turf/simulated/floor/plasteel/dark,
/area/ruin/space/unpowered)
"bC" = (
/obj/structure/alien/weeds/node,
/obj/machinery/light{
	dir = 1
	},
/turf/simulated/floor/plating/airless,
/area/ruin/space/unpowered)
"bD" = (
/obj/item/clothing/mask/facehugger{
	icon_state = "facehugger_dead";
	stat = 2
	},
/turf/simulated/floor/plating/airless,
/area/ruin/space/unpowered)
"bE" = (
/obj/structure/flora/ausbushes/sparsegrass,
/turf/simulated/floor/plating,
/area/ruin/space/unpowered)
"bF" = (
/obj/structure/disposalpipe/segment,
/turf/simulated/wall/r_wall,
/area/ruin/space/unpowered)
"bG" = (
/obj/machinery/door/airlock/external,
/turf/simulated/floor/plasteel,
/area/ruin/space/unpowered)
"bH" = (
/obj/structure/alien/resin/wall,
/turf/simulated/floor/plating,
/area/ruin/space/unpowered)
"bI" = (
/obj/structure/flora/ausbushes/reedbush,
/turf/simulated/floor/plating,
/area/ruin/space/unpowered)
"bJ" = (
/mob/living/basic/crab{
	faction = list("carp")
	},
/turf/simulated/floor/plating,
/area/ruin/space/unpowered)
"bK" = (
/obj/structure/disposalpipe/segment,
/turf/simulated/floor/plating/airless,
/area/space/nearstation)
"bL" = (
/obj/machinery/light/small{
	dir = 8
	},
/turf/simulated/floor/plasteel,
/area/ruin/space/unpowered)
"bM" = (
/obj/machinery/light/small{
	dir = 4
	},
/turf/simulated/floor/plasteel,
/area/ruin/space/unpowered)
"bN" = (
/obj/structure/grille/broken,
/obj/item/shard{
	icon_state = "small"
	},
/turf/simulated/floor/plating/airless,
/area/ruin/space/unpowered)
"bO" = (
/obj/item/shard,
/turf/simulated/floor/plating/airless,
/area/ruin/space/unpowered)
"bP" = (
/obj/structure/lattice,
/turf/template_noop,
/area/space/nearstation)
"bQ" = (
/obj/machinery/shieldwallgen{
	activated = 1;
	anchored = 1
	},
/obj/structure/cable{
	icon_state = "1-8"
	},
/obj/structure/cable,
/turf/simulated/floor/plating/airless,
/area/ruin/space/unpowered)
"bR" = (
/obj/structure/disposalpipe/trunk{
	dir = 1
	},
/obj/structure/disposaloutlet,
/turf/simulated/floor/plating/airless,
/area/space/nearstation)
"bS" = (
/obj/structure/cable{
	icon_state = "1-4"
	},
/obj/structure/cable,
/obj/machinery/shieldwallgen,
/turf/simulated/floor/plating/airless,
/area/ruin/space/unpowered)
"bT" = (
/obj/structure/grille,
/obj/item/shard{
	icon_state = "medium"
	},
/turf/simulated/floor/plating/airless,
/area/ruin/space/unpowered)
"bU" = (
/obj/structure/grille/broken,
/turf/simulated/floor/plating/airless,
/area/ruin/space/unpowered)
"bV" = (
/obj/machinery/shieldwallgen,
/turf/template_noop,
/area/space/nearstation)
"bW" = (
/obj/item/shard,
/turf/template_noop,
/area/space/nearstation)
"ov" = (
/turf/simulated/floor/plating/airless,
/area/ruin/space/unpowered)
"Hv" = (
/obj/item/gps/ruin,
/turf/simulated/wall/r_wall,
/area/ruin/space/unpowered)
"Qh" = (
/obj/structure/alien/weeds,
/turf/simulated/floor/plating/airless,
/area/ruin/space/unpowered)

(1,1,1) = {"
aa
aa
aa
aa
aa
aa
aa
aa
aa
aa
aa
aa
aa
aa
aa
aa
aa
aa
aa
aa
aa
"}
(2,1,1) = {"
aa
ab
ag
ag
ag
ag
ab
aa
aa
aa
aa
aa
aa
ab
ag
ag
ag
ag
ab
aa
aa
"}
(3,1,1) = {"
aa
ac
ah
ai
ar
ah
ac
aK
aK
aK
aK
aK
aK
ac
bu
bv
bI
bv
ac
aa
aa
"}
(4,1,1) = {"
aa
ac
ah
ap
ai
ai
aD
aL
aR
aL
aL
aR
aL
aD
bv
bv
bJ
bv
ac
aa
aa
"}
(5,1,1) = {"
aa
ac
ai
ah
ai
aw
ac
at
at
bb
bb
at
at
ac
bw
bv
bv
bv
ac
aa
aa
"}
(6,1,1) = {"
aa
ac
aj
ai
as
ar
ac
at
aS
ay
ay
be
at
ac
bx
bE
bv
bv
ac
aa
aa
"}
(7,1,1) = {"
aa
ad
ak
ak
ak
ak
aE
aM
aT
bc
bd
bf
aM
bo
ak
ak
ak
ak
bQ
aa
aa
"}
(8,1,1) = {"
aa
aa
aa
aa
at
at
aF
Hv
aU
ay
ay
bg
at
aF
by
bF
bK
bK
bR
aa
aa
"}
(9,1,1) = {"
aa
aa
aa
aa
ag
ax
aG
aN
aV
ay
ay
bh
bm
bp
bz
at
at
at
aa
aa
aa
"}
(10,1,1) = {"
aa
aa
aa
aa
ag
ay
aH
aO
ay
ay
ay
ay
ay
aH
ay
bG
bL
bG
aa
aa
aa
"}
(11,1,1) = {"
aa
aa
aa
aa
ag
ay
aH
ay
ay
ay
ay
ay
ay
bq
ay
bG
bM
bG
aa
aa
aa
"}
(12,1,1) = {"
aa
aa
aa
aa
ag
az
aI
aP
aW
ay
ay
bi
bn
br
bA
at
at
at
aa
aa
aa
"}
(13,1,1) = {"
aa
aa
aa
aa
at
at
aF
at
aX
ay
ay
bj
at
aF
at
at
aa
aa
aa
aa
aa
"}
(14,1,1) = {"
aa
ae
ak
ak
ak
ak
aJ
at
aY
ay
ay
bk
at
bs
ak
ak
ak
ak
bS
aa
aa
"}
(15,1,1) = {"
aa
ac
al
an
an
aA
ac
at
aZ
ay
ay
bl
at
ac
Qh
Qh
bD
bH
ac
aa
aa
"}
(16,1,1) = {"
aa
ac
am
am
ao
aB
ac
at
at
bb
bb
at
at
ac
bC
bH
bH
ov
bT
aa
aa
"}
(17,1,1) = {"
aa
ac
an
aq
au
am
aD
aL
ba
aL
aL
ba
aL
aD
bD
Qh
ov
bO
bU
bW
aa
"}
(18,1,1) = {"
aa
ac
ao
an
av
aC
ac
aQ
aQ
aQ
aQ
aQ
aQ
ac
Qh
Qh
ov
ov
bP
aa
aa
"}
(19,1,1) = {"
aa
af
ak
ak
ak
ak
af
aa
aa
aa
aa
aa
aa
bt
ag
ag
bN
bP
aa
aa
aa
"}
(20,1,1) = {"
aa
aa
aa
aa
aa
aa
aa
aa
aa
aa
aa
aa
aa
aa
aa
aa
aa
aa
bV
aa
aa
"}
(21,1,1) = {"
aa
aa
aa
aa
aa
aa
aa
aa
aa
aa
aa
aa
aa
aa
aa
aa
aa
aa
aa
aa
aa
"}
