//MAP CONVERTED BY dmm2tgm.py THIS HEADER COMMENT PREVENTS RECONVERSION, DO NOT REMOVE
"aa" = (
/turf/space,
/area/space)
"ah" = (
/turf/simulated/mineral,
/area/ruin/space/unpowered)
"ai" = (
/turf/simulated/floor/plating/asteroid/airless,
/area/ruin/space/unpowered)
"aj" = (
/obj/structure/flora/rock,
/turf/simulated/floor/plating/asteroid/airless,
/area/ruin/space/unpowered)
"al" = (
/obj/structure/flora/ausbushes/genericbush,
/turf/simulated/floor/grass,
/area/ruin/space/unpowered)
"am" = (
/mob/living/simple_animal/hostile/poison/bees,
/mob/living/simple_animal/hostile/poison/bees,
/mob/living/simple_animal/hostile/poison/bees,
/mob/living/simple_animal/hostile/poison/bees,
/mob/living/simple_animal/hostile/poison/bees,
/mob/living/simple_animal/hostile/poison/bees,
/turf/simulated/floor/grass,
/area/ruin/space/unpowered)
"an" = (
/mob/living/simple_animal/hostile/poison/bees,
/turf/simulated/floor/grass,
/area/ruin/space/unpowered)
"ao" = (
/obj/structure/flora/ausbushes/lavendergrass,
/turf/simulated/floor/grass,
/area/ruin/space/unpowered)
"ap" = (
/mob/living/simple_animal/hostile/asteroid/goldgrub{
	will_burrow = 0
	},
/turf/simulated/floor/plating/asteroid/airless,
/area/ruin/space/unpowered)
"aq" = (
/obj/structure/flora/ausbushes/grassybush,
/turf/simulated/floor/grass,
/area/ruin/space/unpowered)
"ar" = (
/obj/structure/flora/rock/pile,
/turf/simulated/floor/plating/asteroid/airless,
/area/ruin/space/unpowered)
"as" = (
/mob/living/simple_animal/hostile/asteroid/basilisk,
/turf/simulated/floor/plating/asteroid/airless,
/area/ruin/space/unpowered)
"at" = (
/turf/simulated/wall/r_wall,
/area/ruin/space/unpowered)
"au" = (
/obj/structure/flora/ausbushes/leafybush,
/mob/living/simple_animal/hostile/poison/bees,
/turf/simulated/floor/grass,
/area/ruin/space/unpowered)
"av" = (
/obj/structure/flora/ausbushes/brflowers,
/turf/simulated/floor/grass,
/area/ruin/space/unpowered)
"aw" = (
/obj/structure/flora/rock,
/obj/machinery/light,
/turf/simulated/floor/plating/asteroid/airless,
/area/ruin/space/unpowered)
"ax" = (
/obj/structure/table/reinforced,
/obj/item/clipboard,
/obj/item/clothing/mask/surgical,
/obj/item/razor,
/obj/machinery/light{
	dir = 8
	},
/turf/simulated/floor/plasteel{
	icon_state = "dark"
	},
/area/ruin/space/unpowered)
"ay" = (
/turf/simulated/floor/plasteel,
/area/ruin/space/unpowered)
"az" = (
/obj/structure/table/reinforced,
/obj/item/storage/box/syringes{
	pixel_x = 5;
	pixel_y = 5
	},
/obj/item/storage/box/beakers,
/obj/machinery/light{
	dir = 4
	},
/turf/simulated/floor/plasteel{
	icon_state = "dark"
	},
/area/ruin/space/unpowered)
"aA" = (
/obj/structure/flora/ausbushes/ywflowers,
/turf/simulated/floor/grass,
/area/ruin/space/unpowered)
"aB" = (
/obj/machinery/light,
/mob/living/simple_animal/hostile/poison/bees,
/turf/simulated/floor/grass,
/area/ruin/space/unpowered)
"aC" = (
/obj/structure/flora/ausbushes/ppflowers,
/turf/simulated/floor/grass,
/area/ruin/space/unpowered)
"aF" = (
/obj/structure/cable{
	d1 = 4;
	d2 = 8;
	icon_state = "4-8"
	},
/turf/simulated/wall/r_wall,
/area/ruin/space/unpowered)
"aG" = (
/obj/structure/table/reinforced,
/obj/structure/cable{
	d1 = 4;
	d2 = 8;
	icon_state = "4-8"
	},
/obj/item/gun/energy/floragun,
/turf/simulated/floor/plasteel{
	icon_state = "dark"
	},
/area/ruin/space/unpowered)
"aH" = (
/obj/structure/cable{
	d1 = 4;
	d2 = 8;
	icon_state = "4-8"
	},
/turf/simulated/floor/plasteel,
/area/ruin/space/unpowered)
"aI" = (
/obj/structure/table/reinforced,
/obj/machinery/computer/med_data/laptop,
/obj/structure/cable{
	d1 = 4;
	d2 = 8;
	icon_state = "4-8"
	},
/turf/simulated/floor/plasteel{
	icon_state = "dark"
	},
/area/ruin/space/unpowered)
"aJ" = (
/obj/machinery/shieldwallgen{
	activated = 1;
	anchored = 1
	},
/obj/structure/cable{
	d1 = 4;
	d2 = 8;
	icon_state = "4-8"
	},
/obj/structure/cable{
	d1 = 1;
	d2 = 8;
	icon_state = "1-8";
	tag = ""
	},
/obj/structure/cable{
	d2 = 8;
	icon_state = "0-8"
	},
/turf/simulated/floor/plating,
/area/ruin/space/unpowered)
"aK" = (
/obj/structure/window/reinforced{
	dir = 4
	},
/turf/space,
/area/space/nearstation)
"aL" = (
/turf/simulated/floor/plasteel{
	icon_state = "dark"
	},
/area/ruin/space/unpowered)
"aM" = (
/obj/structure/cable{
	d1 = 1;
	d2 = 2;
	icon_state = "1-2"
	},
/turf/simulated/wall/r_wall,
/area/ruin/space/unpowered)
"aN" = (
/obj/structure/table/reinforced,
/obj/item/folder,
/turf/simulated/floor/plasteel{
	icon_state = "dark"
	},
/area/ruin/space/unpowered)
"aO" = (
/obj/structure/chair/office/light{
	dir = 8
	},
/turf/simulated/floor/plasteel,
/area/ruin/space/unpowered)
"aP" = (
/obj/structure/table/reinforced,
/obj/item/reagent_containers/glass/bottle/liver_enhance_virion,
/obj/item/reagent_containers/dropper,
/turf/simulated/floor/plasteel{
	icon_state = "dark"
	},
/area/ruin/space/unpowered)
"aQ" = (
/obj/structure/window/reinforced{
	dir = 8
	},
/turf/space,
/area/space/nearstation)
"aR" = (
/obj/machinery/light/small{
	dir = 4
	},
/turf/simulated/floor/plasteel{
	icon_state = "dark"
	},
/area/ruin/space/unpowered)
"aS" = (
/obj/machinery/power/apc/worn_out{
	dir = 8;
	pixel_x = -24
	},
/obj/structure/cable{
	d2 = 4;
	icon_state = "0-4"
	},
/obj/structure/rack,
/obj/item/melee/baton/cattleprod,
/obj/effect/spawner/lootdrop/maintenance,
/turf/simulated/floor/plasteel{
	icon_state = "dark"
	},
/area/ruin/space/unpowered)
"aT" = (
/obj/structure/cable{
	d1 = 2;
	d2 = 8;
	icon_state = "2-8"
	},
/obj/structure/cable{
	d1 = 1;
	d2 = 2;
	icon_state = "1-2"
	},
/obj/structure/rack,
/obj/item/mod/control/pre_equipped/medical,
/obj/item/tank/internals/emergency_oxygen/double,
/turf/simulated/floor/plasteel{
	icon_state = "dark"
	},
/area/ruin/space/unpowered)
"aU" = (
/obj/structure/rack,
/obj/item/crowbar,
/obj/item/shield/riot,
/obj/machinery/light{
	dir = 1
	},
/turf/simulated/floor/plasteel{
	icon_state = "dark"
	},
/area/ruin/space/unpowered)
"aV" = (
/obj/machinery/smartfridge/secure/chemistry,
/turf/simulated/floor/plasteel{
	icon_state = "dark"
	},
/area/ruin/space/unpowered)
"aW" = (
/obj/structure/table/reinforced,
/turf/simulated/floor/plasteel{
	icon_state = "dark"
	},
/area/ruin/space/unpowered)
"aX" = (
/obj/structure/table/reinforced,
/obj/item/grenade/chem_grenade/antiweed{
	pixel_x = 3;
	pixel_y = 5
	},
/obj/item/grenade/chem_grenade/antiweed{
	pixel_x = 4
	},
/obj/item/grenade/chem_grenade/antiweed{
	pixel_x = -3;
	pixel_y = -1
	},
/obj/machinery/light{
	dir = 1
	},
/turf/simulated/floor/plasteel{
	icon_state = "dark"
	},
/area/ruin/space/unpowered)
"aY" = (
/obj/structure/table/reinforced,
/obj/item/gun/energy/temperature,
/turf/simulated/floor/plasteel{
	icon_state = "dark"
	},
/area/ruin/space/unpowered)
"aZ" = (
/obj/structure/table/reinforced,
/obj/item/cultivator,
/obj/item/shovel,
/turf/simulated/floor/plasteel{
	icon_state = "dark"
	},
/area/ruin/space/unpowered)
"ba" = (
/obj/machinery/light/small{
	dir = 8
	},
/turf/simulated/floor/plasteel{
	icon_state = "dark"
	},
/area/ruin/space/unpowered)
"bb" = (
/obj/machinery/door/airlock/hatch{
	name = "Bio-Research Station"
	},
/turf/simulated/floor/plasteel,
/area/ruin/space/unpowered)
"bc" = (
/obj/structure/cable{
	d1 = 1;
	d2 = 2;
	icon_state = "1-2"
	},
/turf/simulated/floor/plasteel,
/area/ruin/space/unpowered)
"bd" = (
/obj/machinery/power/terminal,
/obj/structure/cable{
	d1 = 1;
	d2 = 2;
	icon_state = "1-2"
	},
/turf/simulated/floor/plasteel,
/area/ruin/space/unpowered)
"be" = (
/obj/structure/reagent_dispensers/fueltank,
/turf/simulated/floor/plasteel{
	icon_state = "dark"
	},
/area/ruin/space/unpowered)
"bf" = (
/obj/machinery/power/smes/magical{
	desc = "A high-capacity superconducting magnetic energy storage (SMES) unit.";
	name = "power storage unit"
	},
/obj/structure/cable,
/obj/structure/cable{
	d1 = 1;
	d2 = 2;
	icon_state = "1-2"
	},
/turf/simulated/floor/plasteel{
	icon_state = "dark"
	},
/area/ruin/space/unpowered)
"bg" = (
/obj/structure/reagent_dispensers/watertank,
/obj/machinery/light,
/turf/simulated/floor/plasteel{
	icon_state = "dark"
	},
/area/ruin/space/unpowered)
"bh" = (
/obj/machinery/disposal,
/obj/structure/disposalpipe/trunk,
/turf/simulated/floor/plasteel{
	icon_state = "dark"
	},
/area/ruin/space/unpowered)
"bi" = (
/obj/structure/table/reinforced,
/obj/item/reagent_containers/hypospray/autoinjector/stimpack,
/obj/item/reagent_containers/glass/bottle/mutagen,
/turf/simulated/floor/plasteel{
	icon_state = "dark"
	},
/area/ruin/space/unpowered)
"bj" = (
/obj/structure/table/reinforced,
/obj/item/surgicaldrill,
/obj/item/hemostat,
/obj/item/scalpel,
/obj/item/surgical_drapes,
/obj/item/retractor,
/obj/item/cautery,
/obj/item/circular_saw,
/obj/machinery/light,
/turf/simulated/floor/plasteel{
	icon_state = "dark"
	},
/area/ruin/space/unpowered)
"bk" = (
/obj/machinery/optable,
/turf/simulated/floor/plasteel{
	icon_state = "dark"
	},
/area/ruin/space/unpowered)
"bl" = (
/obj/machinery/computer/operating,
/turf/simulated/floor/plasteel{
	icon_state = "dark"
	},
/area/ruin/space/unpowered)
"bm" = (
/obj/structure/closet/wardrobe/toxins_white,
/obj/structure/disposalpipe/segment,
/turf/simulated/floor/plasteel{
	icon_state = "dark"
	},
/area/ruin/space/unpowered)
"bn" = (
/obj/structure/table/reinforced,
/obj/item/reagent_containers/food/snacks/carrotfries,
/turf/simulated/floor/plasteel{
	icon_state = "dark"
	},
/area/ruin/space/unpowered)
"bo" = (
/obj/machinery/shieldwallgen{
	activated = 1;
	anchored = 1
	},
/obj/structure/cable{
	d1 = 1;
	d2 = 2;
	icon_state = "1-2"
	},
/obj/structure/cable{
	d1 = 1;
	d2 = 8;
	icon_state = "1-8";
	tag = ""
	},
/obj/structure/cable,
/obj/structure/cable{
	d1 = 1;
	d2 = 4;
	icon_state = "1-4"
	},
/turf/simulated/floor/plating,
/area/ruin/space/unpowered)
"bp" = (
/obj/structure/bed,
/obj/item/bedsheet/green,
/obj/structure/disposalpipe/segment,
/turf/simulated/floor/plasteel{
	icon_state = "dark"
	},
/area/ruin/space/unpowered)
"bq" = (
/obj/item/stack/cable_coil/cut,
/obj/item/stack/tile/plasteel{
	pixel_x = 3;
	pixel_y = -4
	},
/obj/item/wirecutters,
/turf/simulated/floor/plating,
/area/ruin/space/unpowered)
"br" = (
/obj/structure/table/reinforced,
/obj/machinery/kitchen_machine/microwave,
/obj/structure/cable{
	d1 = 4;
	d2 = 8;
	icon_state = "4-8"
	},
/turf/simulated/floor/plasteel{
	icon_state = "dark"
	},
/area/ruin/space/unpowered)
"bs" = (
/obj/structure/cable{
	d1 = 4;
	d2 = 8;
	icon_state = "4-8"
	},
/obj/structure/cable{
	d1 = 2;
	d2 = 8;
	icon_state = "2-8"
	},
/obj/structure/cable{
	d2 = 8;
	icon_state = "0-8"
	},
/obj/machinery/shieldwallgen,
/turf/simulated/floor/plating,
/area/ruin/space/unpowered)
"bu" = (
/obj/structure/flora/ausbushes/sunnybush,
/turf/simulated/floor/plating,
/area/ruin/space/unpowered)
"bv" = (
/turf/simulated/floor/plating,
/area/ruin/space/unpowered)
"bw" = (
/obj/machinery/light{
	dir = 1
	},
/mob/living/simple_animal/hostile/carp,
/turf/simulated/floor/plating,
/area/ruin/space/unpowered)
"bx" = (
/obj/structure/flora/ausbushes/palebush,
/turf/simulated/floor/plating,
/area/ruin/space/unpowered)
"by" = (
/obj/structure/disposalpipe/segment{
	dir = 4;
	icon_state = "pipe-c"
	},
/turf/simulated/wall/r_wall,
/area/ruin/space/unpowered)
"bz" = (
/obj/machinery/space_heater,
/obj/structure/disposalpipe/segment{
	dir = 8;
	icon_state = "pipe-c"
	},
/obj/machinery/light{
	dir = 8
	},
/turf/simulated/floor/plasteel{
	icon_state = "dark"
	},
/area/ruin/space/unpowered)
"bA" = (
/obj/structure/table/reinforced,
/obj/machinery/reagentgrinder,
/turf/simulated/floor/plasteel{
	icon_state = "dark"
	},
/area/ruin/space/unpowered)
"bE" = (
/obj/structure/flora/ausbushes/sparsegrass,
/turf/simulated/floor/plating,
/area/ruin/space/unpowered)
"bF" = (
/obj/structure/disposalpipe/segment,
/turf/simulated/wall/r_wall,
/area/ruin/space/unpowered)
"bG" = (
/obj/machinery/door/airlock/external,
/turf/simulated/floor/plasteel,
/area/ruin/space/unpowered)
"bH" = (
/obj/structure/alien/resin/wall,
/turf/simulated/floor/plating,
/area/ruin/space/unpowered)
"bI" = (
/obj/structure/flora/ausbushes/reedbush,
/turf/simulated/floor/plating,
/area/ruin/space/unpowered)
"bJ" = (
/mob/living/simple_animal/crab{
	faction = list("carp")
	},
/turf/simulated/floor/plating,
/area/ruin/space/unpowered)
"bL" = (
/obj/machinery/light/small{
	dir = 8
	},
/turf/simulated/floor/plasteel,
/area/ruin/space/unpowered)
"bM" = (
/obj/machinery/light/small{
	dir = 4
	},
/turf/simulated/floor/plasteel,
/area/ruin/space/unpowered)
"bP" = (
/obj/structure/lattice,
/turf/space,
/area/space/nearstation)
"bV" = (
/obj/machinery/shieldwallgen,
/turf/space,
/area/space/nearstation)
"bW" = (
/obj/item/shard,
/turf/space,
/area/space/nearstation)
"cx" = (
/obj/effect/spawner/window/reinforced/grilled,
/turf/simulated/floor/plating,
/area/ruin/space/unpowered)
"eu" = (
/obj/structure/grille/broken,
/turf/simulated/floor/plating/airless,
/area/ruin/space/unpowered)
"gW" = (
/obj/structure/grille,
/obj/item/shard{
	icon_state = "medium"
	},
/turf/simulated/floor/plating/airless,
/area/ruin/space/unpowered)
"iM" = (
/obj/machinery/shieldwallgen{
	activated = 1;
	anchored = 1
	},
/obj/structure/cable{
	d2 = 2;
	icon_state = "0-2"
	},
/obj/structure/cable{
	d1 = 2;
	d2 = 8;
	icon_state = "2-8"
	},
/turf/simulated/floor/plating/airless,
/area/ruin/space/unpowered)
"nK" = (
/obj/machinery/shieldwallgen{
	activated = 1;
	anchored = 1
	},
/obj/structure/cable{
	d2 = 2;
	icon_state = "0-2"
	},
/obj/structure/cable{
	d1 = 1;
	d2 = 2;
	icon_state = "1-2"
	},
/obj/structure/cable{
	d1 = 2;
	d2 = 8;
	icon_state = "2-8"
	},
/obj/structure/cable{
	d1 = 2;
	d2 = 4;
	icon_state = "2-4";
	tag = ""
	},
/turf/simulated/floor/plating/airless,
/area/ruin/space/unpowered)
"pq" = (
/turf/simulated/floor/plating/airless,
/area/ruin/space/unpowered)
"pI" = (
/obj/item/clothing/mask/facehugger{
	icon_state = "facehugger_dead";
	stat = 2
	},
/turf/simulated/floor/plating/airless,
/area/ruin/space/unpowered)
"sk" = (
/obj/item/clothing/mask/facehugger{
	icon_state = "facehugger_dead";
	stat = 2
	},
/mob/living/simple_animal/hostile/alien/drone,
/turf/simulated/floor/plating/airless,
/area/ruin/space/unpowered)
"te" = (
/obj/structure/cable{
	d1 = 1;
	d2 = 2;
	icon_state = "1-2"
	},
/obj/effect/spawner/window/reinforced/grilled,
/turf/simulated/floor/plating,
/area/ruin/space/unpowered)
"wn" = (
/obj/structure/alien/weeds,
/turf/simulated/floor/plating/airless,
/area/ruin/space/unpowered)
"xY" = (
/obj/structure/alien/weeds/node,
/obj/machinery/light{
	dir = 1
	},
/turf/simulated/floor/plating/airless,
/area/ruin/space/unpowered)
"yM" = (
/obj/machinery/shieldwallgen{
	activated = 1;
	anchored = 1
	},
/obj/structure/cable{
	d2 = 4;
	icon_state = "0-4"
	},
/turf/simulated/floor/plating/airless,
/area/ruin/space/unpowered)
"zV" = (
/obj/structure/cable{
	d2 = 8;
	icon_state = "0-8"
	},
/obj/machinery/shieldwallgen,
/turf/simulated/floor/plating/airless,
/area/ruin/space/unpowered)
"Hv" = (
/obj/item/gps/ruin,
/turf/simulated/wall/r_wall,
/area/ruin/space/unpowered)
"Hx" = (
/obj/structure/cable{
	d1 = 4;
	d2 = 8;
	icon_state = "4-8"
	},
/obj/effect/spawner/window/reinforced/grilled,
/turf/simulated/floor/plating,
/area/ruin/space/unpowered)
"JZ" = (
/obj/machinery/shieldwallgen{
	activated = 1;
	anchored = 1
	},
/obj/structure/cable{
	d1 = 1;
	d2 = 8;
	icon_state = "1-8";
	tag = ""
	},
/obj/structure/cable,
/turf/simulated/floor/plating/airless,
/area/ruin/space/unpowered)
"KW" = (
/obj/structure/cable{
	d1 = 1;
	d2 = 4;
	icon_state = "1-4"
	},
/obj/structure/cable,
/obj/machinery/shieldwallgen,
/turf/simulated/floor/plating/airless,
/area/ruin/space/unpowered)
"No" = (
/obj/structure/grille/broken,
/obj/item/shard{
	icon_state = "small"
	},
/turf/simulated/floor/plating/airless,
/area/ruin/space/unpowered)
"QQ" = (
/obj/machinery/shieldwallgen{
	activated = 1;
	anchored = 1
	},
/obj/structure/cable{
	d2 = 8;
	icon_state = "0-8"
	},
/turf/simulated/floor/plating/airless,
/area/ruin/space/unpowered)
"RC" = (
/obj/item/shard,
/turf/simulated/floor/plating/airless,
/area/ruin/space/unpowered)
"Si" = (
/obj/structure/disposalpipe/segment,
/turf/simulated/floor/plating/airless,
/area/space/nearstation)
"Uz" = (
/obj/structure/cable{
	d1 = 4;
	d2 = 8;
	icon_state = "4-8"
	},
/obj/machinery/door/airlock/highsecurity{
	name = "Bio Containment"
	},
/obj/effect/mapping_helpers/airlock/access/any/science/research,
/turf/simulated/floor/plasteel{
	icon_state = "dark"
	},
/area/ruin/space/unpowered)
"UG" = (
/obj/structure/disposalpipe/trunk{
	dir = 1
	},
/obj/structure/disposaloutlet,
/turf/simulated/floor/plating/airless,
/area/space/nearstation)
"YP" = (
/obj/machinery/shieldwallgen{
	activated = 1;
	anchored = 1
	},
/obj/structure/cable{
	d1 = 2;
	d2 = 4;
	icon_state = "2-4";
	tag = ""
	},
/obj/structure/cable{
	d2 = 2;
	icon_state = "0-2"
	},
/turf/simulated/floor/plating/airless,
/area/ruin/space/unpowered)

(1,1,1) = {"
aa
yM
cx
cx
cx
cx
yM
aa
aa
aa
aa
aa
aa
yM
cx
cx
cx
cx
yM
aa
"}
(2,1,1) = {"
aa
Hx
ah
ai
ar
ah
Hx
aK
aK
aK
aK
aK
aK
Hx
bu
bv
bI
bv
Hx
aa
"}
(3,1,1) = {"
aa
Hx
ah
ap
ai
ai
Uz
aL
aR
aL
aL
aR
aL
Uz
bv
bv
bJ
bv
Hx
aa
"}
(4,1,1) = {"
aa
Hx
ai
ah
ai
aw
Hx
at
at
bb
bb
at
at
Hx
bw
bv
bv
bv
Hx
aa
"}
(5,1,1) = {"
aa
Hx
aj
ai
as
ar
Hx
at
aS
ay
ay
be
at
Hx
bx
bE
bv
bv
Hx
aa
"}
(6,1,1) = {"
aa
iM
te
te
te
te
nK
aM
aT
bc
bd
bf
aM
bo
te
te
te
te
JZ
aa
"}
(7,1,1) = {"
aa
aa
aa
aa
at
at
aF
Hv
aU
ay
ay
bg
at
aF
by
bF
Si
Si
UG
aa
"}
(8,1,1) = {"
aa
aa
aa
aa
cx
ax
aG
aN
aV
ay
ay
bh
bm
bp
bz
at
at
at
aa
aa
"}
(9,1,1) = {"
aa
aa
aa
aa
cx
ay
aH
aO
ay
ay
ay
ay
ay
aH
ay
bG
bL
bG
aa
aa
"}
(10,1,1) = {"
aa
aa
aa
aa
cx
ay
aH
ay
ay
ay
ay
ay
ay
bq
ay
bG
bM
bG
aa
aa
"}
(11,1,1) = {"
aa
aa
aa
aa
cx
az
aI
aP
aW
ay
ay
bi
bn
br
bA
at
at
at
aa
aa
"}
(12,1,1) = {"
aa
aa
aa
aa
at
at
aF
at
aX
ay
ay
bj
at
aF
at
at
aa
aa
aa
aa
"}
(13,1,1) = {"
aa
YP
te
te
te
te
aJ
at
aY
ay
ay
bk
at
bs
te
te
te
te
KW
aa
"}
(14,1,1) = {"
aa
Hx
al
an
an
aA
Hx
at
aZ
ay
ay
bl
at
Hx
wn
wn
sk
bH
Hx
aa
"}
(15,1,1) = {"
aa
Hx
am
am
ao
aB
Hx
at
at
bb
bb
at
at
Hx
xY
bH
bH
pq
gW
aa
"}
(16,1,1) = {"
aa
Hx
an
aq
au
am
Uz
aL
ba
aL
aL
ba
aL
Uz
pI
wn
pq
RC
eu
bW
"}
(17,1,1) = {"
aa
Hx
ao
an
av
aC
Hx
aQ
aQ
aQ
aQ
aQ
aQ
Hx
wn
wn
pq
pq
bP
aa
"}
(18,1,1) = {"
aa
QQ
te
te
te
te
QQ
aa
aa
aa
aa
aa
aa
zV
cx
cx
No
bP
aa
aa
"}
(19,1,1) = {"
aa
aa
aa
aa
aa
aa
aa
aa
aa
aa
aa
aa
aa
aa
aa
aa
aa
aa
bV
aa
"}
(20,1,1) = {"
aa
aa
aa
aa
aa
aa
aa
aa
aa
aa
aa
aa
aa
aa
aa
aa
aa
aa
aa
aa
"}
