//MAP CONVERTED BY dmm2tgm.py THIS HEADER COMMENT PREVENTS RECONVERSION, DO NOT REMOVE
"a" = (
/obj/structure/window/reinforced{
	dir = 4
	},
/obj/structure/shuttle/engine/heater{
	dir = 8
	},
/turf/simulated/floor/plating/airless,
/area/ruin/space/sec_shuttle)
"c" = (
/obj/effect/mapping_helpers/airlock/access/all/centcomm/specops,
/obj/machinery/door/airlock/external{
	id_tag = "s_docking_airlock";
	name = "Shuttle Hatch"
	},
/turf/simulated/floor/plasteel/dark/airless,
/area/ruin/space/sec_shuttle)
"d" = (
/obj/structure/chair/comfy/shuttle{
	dir = 4
	},
/mob/living/basic/skeleton/warden{
	dir = 4
	},
/turf/simulated/floor/plasteel/dark/airless,
/area/ruin/space/sec_shuttle)
"e" = (
/obj/structure/shuttle/engine/propulsion{
	dir = 8;
	icon_state = "burst_r"
	},
/turf/simulated/floor/plating/airless,
/area/ruin/space/sec_shuttle)
"f" = (
/turf/simulated/floor/plasteel/dark/airless,
/area/ruin/space/sec_shuttle)
"g" = (
/obj/structure/window/reinforced{
	dir = 4
	},
/obj/structure/shuttle/engine/heater{
	dir = 8
	},
/turf/simulated/floor/plasteel/dark/airless,
/area/ruin/space/sec_shuttle)
"h" = (
/turf/simulated/wall/mineral/plastitanium,
/area/ruin/space/sec_shuttle)
"j" = (
/obj/machinery/computer/nonfunctional{
	dir = 1
	},
/turf/simulated/floor/plasteel/dark/airless,
/area/ruin/space/sec_shuttle)
"m" = (
/obj/effect/decal/cleanable/blood/drip,
/obj/effect/decal/cleanable/blood,
/obj/effect/mob_spawn/human/corpse/skeleton/security_officer,
/turf/simulated/floor/plating/airless,
/area/ruin/space/sec_shuttle)
"n" = (
/obj/effect/decal/cleanable/blood/drip,
/obj/effect/decal/cleanable/blood/drip,
/obj/effect/decal/cleanable/blood,
/turf/simulated/floor/plating/airless,
/area/ruin/space/sec_shuttle)
"t" = (
/obj/effect/decal/cleanable/blood,
/obj/effect/decal/cleanable/blood/footprints,
/turf/simulated/floor/plating/airless,
/area/ruin/space/sec_shuttle)
"w" = (
/obj/structure/chair/comfy/shuttle{
	dir = 1
	},
/turf/simulated/floor/plasteel/dark/airless,
/area/ruin/space/sec_shuttle)
"y" = (
/obj/effect/decal/cleanable/blood,
/turf/simulated/floor/plating/airless,
/area/ruin/space/sec_shuttle)
"z" = (
/turf/template_noop,
/area/template_noop)
"B" = (
/obj/machinery/recharge_station/upgraded,
/turf/simulated/floor/plasteel/dark/airless,
/area/ruin/space/sec_shuttle)
"D" = (
/obj/machinery/computer/nonfunctional,
/turf/simulated/floor/plasteel/dark/airless,
/area/ruin/space/sec_shuttle)
"E" = (
/obj/structure/closet/crate/secure/sec_shuttle_ruin{
	name = "emergency supplies crate"
	},
/obj/item/gun/medbeam/damaged,
/obj/item/gun/projectile/automatic/pistol/enforcer,
/obj/item/grenade/flashbang,
/obj/item/storage/firstaid/regular,
/obj/effect/spawner/random/pool/spaceloot/syndicate/mixed,
/turf/simulated/floor/plating/airless,
/area/ruin/space/sec_shuttle)
"F" = (
/obj/structure/chair/comfy/shuttle{
	dir = 1
	},
/obj/effect/decal/cleanable/blood/footprints,
/turf/simulated/floor/plasteel/dark/airless,
/area/ruin/space/sec_shuttle)
"G" = (
/obj/effect/decal/cleanable/blood/splatter,
/turf/simulated/floor/plating/airless,
/area/ruin/space/sec_shuttle)
"H" = (
/turf/simulated/floor/plating/airless,
/area/ruin/space/sec_shuttle)
"J" = (
/obj/effect/decal/cleanable/blood/drip,
/obj/effect/decal/cleanable/blood/footprints,
/turf/simulated/floor/plating/airless,
/area/ruin/space/sec_shuttle)
"N" = (
/obj/effect/mob_spawn/human/corpse/skeleton/prisoner,
/turf/template_noop,
/area/space/nearstation)
"Q" = (
/obj/structure/chair/comfy/shuttle{
	dir = 1
	},
/obj/effect/mob_spawn/human/corpse/skeleton/security_officer,
/turf/simulated/floor/plasteel/dark/airless,
/area/ruin/space/sec_shuttle)
"R" = (
/obj/structure/chair/comfy/shuttle{
	dir = 1
	},
/turf/simulated/floor/plating/airless,
/area/ruin/space/sec_shuttle)
"S" = (
/obj/machinery/computer/security{
	dir = 1;
	network = list("SS13")
	},
/turf/simulated/floor/plasteel/dark/airless,
/area/ruin/space/sec_shuttle)
"T" = (
/obj/effect/mapping_helpers/airlock/access/all/centcomm/specops,
/obj/machinery/door/airlock/external{
	id_tag = "s_docking_airlock";
	name = "Shuttle Hatch"
	},
/turf/simulated/floor/plating/airless,
/area/ruin/space/sec_shuttle)
"U" = (
/obj/structure/shuttle/engine/propulsion{
	dir = 8
	},
/turf/template_noop,
/area/ruin/space/sec_shuttle)
"V" = (
/obj/structure/shuttle/engine/propulsion{
	dir = 8
	},
/turf/simulated/floor/plating/airless,
/area/ruin/space/sec_shuttle)
"X" = (
/obj/effect/decal/cleanable/blood/drip,
/obj/effect/decal/cleanable/blood,
/obj/effect/decal/cleanable/blood/footprints,
/turf/simulated/floor/plating/airless,
/area/ruin/space/sec_shuttle)
"Y" = (
/obj/structure/shuttle/engine/propulsion{
	dir = 8;
	icon_state = "burst_l"
	},
/turf/template_noop,
/area/ruin/space/sec_shuttle)
"Z" = (
/obj/structure/computerframe,
/turf/simulated/floor/plasteel/dark/airless,
/area/ruin/space/sec_shuttle)

(1,1,1) = {"
z
z
z
z
z
z
z
z
z
z
"}
(2,1,1) = {"
z
z
z
z
Y
U
V
V
e
z
"}
(3,1,1) = {"
z
z
z
z
h
g
g
a
h
z
"}
(4,1,1) = {"
z
z
z
z
h
D
d
j
h
z
"}
(5,1,1) = {"
z
z
z
z
h
Z
f
S
h
z
"}
(6,1,1) = {"
z
z
z
z
h
B
f
Q
h
z
"}
(7,1,1) = {"
z
z
z
z
c
H
H
w
h
z
"}
(8,1,1) = {"
z
z
z
z
c
G
J
F
h
z
"}
(9,1,1) = {"
z
N
z
z
t
X
J
R
h
z
"}
(10,1,1) = {"
z
z
z
z
y
m
n
E
h
z
"}
(11,1,1) = {"
z
z
z
z
h
h
H
h
h
z
"}
(12,1,1) = {"
z
z
z
z
z
h
T
h
z
z
"}
(13,1,1) = {"
z
z
z
z
z
z
z
z
z
z
"}
