//MAP CONVERTED BY dmm2tgm.py THIS HEADER COMMENT PREVENTS RECONVERSION, DO NOT REMOVE
"dk" = (
/obj/structure/cable{
	icon_state = "1-2"
	},
/turf/simulated/floor/plating/abductor,
/area/space)
"et" = (
/turf/simulated/floor/plating/abductor,
/area/space)
"fA" = (
/obj/structure/fans/tiny/invisible,
/obj/machinery/door/airlock/abductor,
/turf/simulated/floor/plating/abductor,
/area/space)
"ky" = (
/obj/structure/cable{
	icon_state = "0-8"
	},
/turf/simulated/floor/plating/abductor,
/area/space)
"mQ" = (
/turf/space,
/area/space)
"Ey" = (
/obj/machinery/power/alien_cache,
/obj/structure/cable{
	icon_state = "0-2"
	},
/turf/simulated/floor/plating/abductor,
/area/space)
"Ha" = (
/turf/simulated/wall/indestructible/abductor,
/area/space)
"OW" = (
/obj/machinery/power/apc/directional/west,
/obj/structure/cable{
	icon_state = "0-4"
	},
/turf/simulated/floor/plating/abductor,
/area/space)
"Ud" = (
/obj/structure/cable{
	icon_state = "1-8"
	},
/obj/structure/cable{
	icon_state = "4-8"
	},
/turf/simulated/floor/plating/abductor,
/area/space)
"XP" = (
/obj/structure/cable{
	icon_state = "4-8"
	},
/turf/simulated/floor/plating/abductor,
/area/space)

(1,1,1) = {"
mQ
mQ
mQ
mQ
mQ
mQ
mQ
mQ
mQ
mQ
mQ
mQ
mQ
mQ
mQ
mQ
mQ
mQ
mQ
mQ
mQ
mQ
mQ
mQ
mQ
mQ
mQ
mQ
mQ
mQ
mQ
mQ
"}
(2,1,1) = {"
mQ
mQ
mQ
mQ
mQ
mQ
mQ
mQ
mQ
mQ
mQ
mQ
mQ
mQ
mQ
mQ
mQ
mQ
mQ
mQ
mQ
mQ
mQ
mQ
mQ
mQ
mQ
mQ
mQ
mQ
mQ
mQ
"}
(3,1,1) = {"
mQ
mQ
mQ
mQ
mQ
mQ
mQ
mQ
mQ
mQ
mQ
mQ
mQ
mQ
mQ
mQ
mQ
mQ
mQ
mQ
mQ
mQ
mQ
mQ
mQ
mQ
mQ
mQ
mQ
mQ
mQ
mQ
"}
(4,1,1) = {"
mQ
mQ
mQ
mQ
mQ
mQ
mQ
mQ
mQ
mQ
mQ
mQ
mQ
mQ
mQ
mQ
mQ
mQ
mQ
mQ
mQ
mQ
mQ
mQ
mQ
mQ
mQ
mQ
mQ
mQ
mQ
mQ
"}
(5,1,1) = {"
mQ
mQ
mQ
mQ
mQ
mQ
mQ
mQ
mQ
mQ
mQ
mQ
mQ
mQ
mQ
mQ
mQ
mQ
mQ
mQ
mQ
mQ
mQ
mQ
mQ
mQ
mQ
mQ
mQ
mQ
mQ
mQ
"}
(6,1,1) = {"
mQ
mQ
mQ
mQ
mQ
mQ
mQ
mQ
mQ
mQ
mQ
mQ
mQ
mQ
mQ
mQ
mQ
mQ
mQ
mQ
mQ
mQ
mQ
mQ
mQ
mQ
mQ
mQ
mQ
mQ
mQ
mQ
"}
(7,1,1) = {"
mQ
mQ
mQ
mQ
mQ
mQ
mQ
mQ
mQ
mQ
mQ
mQ
mQ
mQ
mQ
mQ
mQ
mQ
mQ
mQ
mQ
mQ
mQ
mQ
mQ
mQ
mQ
mQ
mQ
mQ
mQ
mQ
"}
(8,1,1) = {"
mQ
mQ
mQ
mQ
mQ
mQ
mQ
mQ
mQ
mQ
mQ
mQ
mQ
mQ
mQ
mQ
mQ
mQ
mQ
mQ
mQ
mQ
mQ
mQ
mQ
mQ
mQ
mQ
mQ
mQ
mQ
mQ
"}
(9,1,1) = {"
mQ
mQ
mQ
mQ
mQ
mQ
mQ
mQ
mQ
mQ
mQ
mQ
mQ
mQ
mQ
mQ
mQ
mQ
mQ
mQ
mQ
mQ
mQ
mQ
mQ
mQ
mQ
mQ
mQ
mQ
mQ
mQ
"}
(10,1,1) = {"
mQ
mQ
mQ
mQ
mQ
mQ
mQ
mQ
mQ
mQ
mQ
mQ
mQ
mQ
mQ
mQ
mQ
mQ
mQ
mQ
mQ
mQ
mQ
mQ
mQ
mQ
mQ
mQ
mQ
mQ
mQ
mQ
"}
(11,1,1) = {"
mQ
mQ
mQ
mQ
mQ
mQ
mQ
mQ
mQ
mQ
mQ
mQ
mQ
mQ
mQ
mQ
mQ
mQ
mQ
mQ
mQ
mQ
mQ
mQ
mQ
mQ
mQ
mQ
mQ
mQ
mQ
mQ
"}
(12,1,1) = {"
mQ
mQ
mQ
mQ
mQ
mQ
mQ
mQ
mQ
mQ
mQ
mQ
mQ
mQ
mQ
mQ
mQ
mQ
mQ
mQ
mQ
mQ
mQ
mQ
mQ
mQ
mQ
mQ
mQ
mQ
mQ
mQ
"}
(13,1,1) = {"
mQ
mQ
mQ
mQ
mQ
mQ
mQ
mQ
mQ
mQ
mQ
mQ
mQ
mQ
mQ
Ha
Ha
Ha
Ha
Ha
mQ
mQ
mQ
mQ
mQ
mQ
mQ
mQ
mQ
mQ
mQ
mQ
"}
(14,1,1) = {"
mQ
mQ
mQ
mQ
mQ
mQ
mQ
mQ
mQ
mQ
mQ
mQ
mQ
Ha
Ha
Ha
et
OW
et
Ha
Ha
mQ
mQ
mQ
mQ
mQ
mQ
mQ
mQ
mQ
mQ
mQ
"}
(15,1,1) = {"
mQ
mQ
mQ
mQ
mQ
mQ
mQ
mQ
mQ
mQ
mQ
mQ
mQ
Ha
et
et
et
XP
et
et
Ha
mQ
mQ
mQ
mQ
mQ
mQ
mQ
mQ
mQ
mQ
mQ
"}
(16,1,1) = {"
mQ
mQ
mQ
mQ
mQ
mQ
mQ
mQ
mQ
mQ
mQ
mQ
mQ
Ha
Ey
dk
dk
Ud
et
et
fA
mQ
mQ
mQ
mQ
mQ
mQ
mQ
mQ
mQ
mQ
mQ
"}
(17,1,1) = {"
mQ
mQ
mQ
mQ
mQ
mQ
mQ
mQ
mQ
mQ
mQ
mQ
mQ
Ha
et
et
et
XP
et
et
Ha
mQ
mQ
mQ
mQ
mQ
mQ
mQ
mQ
mQ
mQ
mQ
"}
(18,1,1) = {"
mQ
mQ
mQ
mQ
mQ
mQ
mQ
mQ
mQ
mQ
mQ
mQ
mQ
Ha
Ha
Ha
et
ky
et
Ha
Ha
mQ
mQ
mQ
mQ
mQ
mQ
mQ
mQ
mQ
mQ
mQ
"}
(19,1,1) = {"
mQ
mQ
mQ
mQ
mQ
mQ
mQ
mQ
mQ
mQ
mQ
mQ
mQ
mQ
mQ
Ha
Ha
Ha
Ha
Ha
mQ
mQ
mQ
mQ
mQ
mQ
mQ
mQ
mQ
mQ
mQ
mQ
"}
(20,1,1) = {"
mQ
mQ
mQ
mQ
mQ
mQ
mQ
mQ
mQ
mQ
mQ
mQ
mQ
mQ
mQ
mQ
mQ
mQ
mQ
mQ
mQ
mQ
mQ
mQ
mQ
mQ
mQ
mQ
mQ
mQ
mQ
mQ
"}
(21,1,1) = {"
mQ
mQ
mQ
mQ
mQ
mQ
mQ
mQ
mQ
mQ
mQ
mQ
mQ
mQ
mQ
mQ
mQ
mQ
mQ
mQ
mQ
mQ
mQ
mQ
mQ
mQ
mQ
mQ
mQ
mQ
mQ
mQ
"}
(22,1,1) = {"
mQ
mQ
mQ
mQ
mQ
mQ
mQ
mQ
mQ
mQ
mQ
mQ
mQ
mQ
mQ
mQ
mQ
mQ
mQ
mQ
mQ
mQ
mQ
mQ
mQ
mQ
mQ
mQ
mQ
mQ
mQ
mQ
"}
(23,1,1) = {"
mQ
mQ
mQ
mQ
mQ
mQ
mQ
mQ
mQ
mQ
mQ
mQ
mQ
mQ
mQ
mQ
mQ
mQ
mQ
mQ
mQ
mQ
mQ
mQ
mQ
mQ
mQ
mQ
mQ
mQ
mQ
mQ
"}
(24,1,1) = {"
mQ
mQ
mQ
mQ
mQ
mQ
mQ
mQ
mQ
mQ
mQ
mQ
mQ
mQ
mQ
mQ
mQ
mQ
mQ
mQ
mQ
mQ
mQ
mQ
mQ
mQ
mQ
mQ
mQ
mQ
mQ
mQ
"}
(25,1,1) = {"
mQ
mQ
mQ
mQ
mQ
mQ
mQ
mQ
mQ
mQ
mQ
mQ
mQ
mQ
mQ
mQ
mQ
mQ
mQ
mQ
mQ
mQ
mQ
mQ
mQ
mQ
mQ
mQ
mQ
mQ
mQ
mQ
"}
(26,1,1) = {"
mQ
mQ
mQ
mQ
mQ
mQ
mQ
mQ
mQ
mQ
mQ
mQ
mQ
mQ
mQ
mQ
mQ
mQ
mQ
mQ
mQ
mQ
mQ
mQ
mQ
mQ
mQ
mQ
mQ
mQ
mQ
mQ
"}
(27,1,1) = {"
mQ
mQ
mQ
mQ
mQ
mQ
mQ
mQ
mQ
mQ
mQ
mQ
mQ
mQ
mQ
mQ
mQ
mQ
mQ
mQ
mQ
mQ
mQ
mQ
mQ
mQ
mQ
mQ
mQ
mQ
mQ
mQ
"}
(28,1,1) = {"
mQ
mQ
mQ
mQ
mQ
mQ
mQ
mQ
mQ
mQ
mQ
mQ
mQ
mQ
mQ
mQ
mQ
mQ
mQ
mQ
mQ
mQ
mQ
mQ
mQ
mQ
mQ
mQ
mQ
mQ
mQ
mQ
"}
(29,1,1) = {"
mQ
mQ
mQ
mQ
mQ
mQ
mQ
mQ
mQ
mQ
mQ
mQ
mQ
mQ
mQ
mQ
mQ
mQ
mQ
mQ
mQ
mQ
mQ
mQ
mQ
mQ
mQ
mQ
mQ
mQ
mQ
mQ
"}
(30,1,1) = {"
mQ
mQ
mQ
mQ
mQ
mQ
mQ
mQ
mQ
mQ
mQ
mQ
mQ
mQ
mQ
mQ
mQ
mQ
mQ
mQ
mQ
mQ
mQ
mQ
mQ
mQ
mQ
mQ
mQ
mQ
mQ
mQ
"}
(31,1,1) = {"
mQ
mQ
mQ
mQ
mQ
mQ
mQ
mQ
mQ
mQ
mQ
mQ
mQ
mQ
mQ
mQ
mQ
mQ
mQ
mQ
mQ
mQ
mQ
mQ
mQ
mQ
mQ
mQ
mQ
mQ
mQ
mQ
"}
