//MAP CONVERTED BY dmm2tgm.py THIS HEADER COMMENT PREVENTS RECONVERSION, DO NOT REMOVE
"cK" = (
/obj/structure/closet,
/obj/item/soap,
/obj/item/soap,
/obj/item/clothing/under/rank/cargo/expedition/skirt,
/obj/item/clothing/under/rank/cargo/expedition/skirt,
/turf/simulated/floor/plating/abductor,
/area/ruin/space/powered/alien_cache_site)
"dV" = (
/obj/structure/lightable/bonfire,
/turf/simulated/floor/plating/abductor,
/area/ruin/space/powered/alien_cache_site)
"ec" = (
/obj/machinery/hydroponics/soil,
/turf/simulated/floor/plating/abductor,
/area/ruin/space/powered/alien_cache_site)
"en" = (
/obj/structure/table/abductor,
/obj/item/kitchen/knife,
/turf/simulated/floor/plating/abductor,
/area/ruin/space/powered/alien_cache_site)
"et" = (
/turf/simulated/floor/plating/abductor,
/area/ruin/space/powered/alien_cache_site/cache_room)
"eF" = (
/obj/effect/decal/cleanable/dirt,
/obj/item/pickaxe,
/obj/item/weldingtool/largetank,
/turf/simulated/floor/plating/abductor,
/area/ruin/space/powered/alien_cache_site)
"fA" = (
/obj/structure/fans/tiny/invisible,
/obj/machinery/door/airlock/abductor/secure,
/turf/simulated/floor/plating/abductor,
/area/ruin/space/powered/alien_cache_site)
"gf" = (
/obj/effect/spawner/random/glowstick,
/obj/structure/table/abductor,
/obj/effect/spawner/random/engineering/tools,
/turf/simulated/floor/plating/abductor,
/area/ruin/space/powered/alien_cache_site)
"hj" = (
/obj/effect/spawner/random/snacks,
/obj/effect/spawner/random/snacks,
/obj/effect/spawner/random/snacks,
/obj/structure/table/wood,
/turf/simulated/floor/plating/abductor,
/area/ruin/space/powered/alien_cache_site)
"jZ" = (
/obj/item/reagent_containers/glass/bottle/nutrient/empty,
/obj/item/reagent_containers/glass/bucket,
/turf/simulated/floor/plating/abductor,
/area/ruin/space/powered/alien_cache_site)
"kY" = (
/obj/effect/simon_says,
/turf/simulated/floor/plating/abductor,
/area/ruin/space/powered/alien_cache_site)
"ml" = (
/obj/structure/table/abductor,
/obj/item/reagent_containers/glass/bucket,
/turf/simulated/floor/plating/abductor,
/area/ruin/space/powered/alien_cache_site)
"mQ" = (
/turf/space,
/area/space)
"ok" = (
/obj/effect/spawner/random/food_or_drink,
/obj/effect/spawner/random/food_or_drink,
/obj/structure/table/wood,
/turf/simulated/floor/plating/abductor,
/area/ruin/space/powered/alien_cache_site)
"pX" = (
/obj/item/assembly/igniter,
/obj/effect/decal/cleanable/dirt,
/turf/simulated/floor/plating/abductor,
/area/ruin/space/powered/alien_cache_site)
"uD" = (
/obj/structure/bed/abductor,
/turf/simulated/floor/plating/abductor,
/area/ruin/space/powered/alien_cache_site)
"wy" = (
/turf/simulated/floor/plating/abductor,
/area/ruin/space/powered/alien_cache_site)
"zB" = (
/obj/structure/closet,
/obj/item/clothing/under/rank/cargo/expedition,
/obj/item/clothing/under/rank/cargo/expedition,
/obj/item/soap,
/obj/item/reagent_containers/glass/bucket,
/obj/item/reagent_containers/glass/bucket,
/obj/item/reagent_containers/glass/bucket,
/obj/item/gps{
	gpstag = "ALN0";
	tracking = 1
	},
/turf/simulated/floor/plating/abductor,
/area/ruin/space/powered/alien_cache_site)
"Bl" = (
/obj/structure/reagent_dispensers/watertank,
/turf/simulated/floor/plating/abductor,
/area/ruin/space/powered/alien_cache_site)
"CK" = (
/turf/simulated/wall/indestructible/abductor,
/area/ruin/space/powered/alien_cache_site)
"Do" = (
/obj/machinery/shower/directional/east,
/obj/structure/curtain/open/shower,
/turf/simulated/floor/plating/abductor,
/area/ruin/space/powered/alien_cache_site)
"Ey" = (
/obj/machinery/alien_cache,
/turf/simulated/floor/plating/abductor,
/area/ruin/space/powered/alien_cache_site/cache_room)
"Ha" = (
/turf/simulated/wall/indestructible/abductor,
/area/ruin/space/powered/alien_cache_site/cache_room)
"JC" = (
/obj/structure/curtain/open,
/turf/simulated/floor/plating/abductor,
/area/ruin/space/powered/alien_cache_site)
"LK" = (
/obj/effect/mapping_helpers/turfs/damage,
/turf/simulated/wall/indestructible/abductor{
	desc = "Effectively impervious to conventional methods of destruction. It looks like someone tried to break it, but failed"
	},
/area/ruin/space/powered/alien_cache_site)
"TW" = (
/turf/simulated/wall/mineral/wood,
/area/ruin/space/powered/alien_cache_site)
"Yg" = (
/obj/machinery/door/airlock/abductor,
/obj/structure/fans/tiny/invisible,
/turf/simulated/floor/plating/abductor,
/area/ruin/space/powered/alien_cache_site)
"YA" = (
/obj/effect/spawner/random/engineering/toolbox,
/obj/structure/table/abductor,
/turf/simulated/floor/plating/abductor,
/area/ruin/space/powered/alien_cache_site)

(1,1,1) = {"
mQ
mQ
mQ
mQ
mQ
mQ
mQ
mQ
mQ
mQ
mQ
mQ
mQ
mQ
mQ
mQ
mQ
mQ
mQ
mQ
mQ
mQ
mQ
mQ
mQ
mQ
mQ
mQ
mQ
mQ
mQ
mQ
"}
(2,1,1) = {"
mQ
mQ
mQ
mQ
mQ
mQ
mQ
mQ
mQ
mQ
mQ
mQ
mQ
mQ
mQ
mQ
mQ
mQ
mQ
mQ
mQ
mQ
mQ
mQ
mQ
mQ
mQ
mQ
mQ
mQ
mQ
mQ
"}
(3,1,1) = {"
mQ
mQ
mQ
mQ
mQ
mQ
mQ
mQ
mQ
mQ
mQ
mQ
mQ
mQ
mQ
mQ
mQ
mQ
mQ
mQ
mQ
mQ
mQ
mQ
mQ
mQ
mQ
mQ
mQ
mQ
mQ
mQ
"}
(4,1,1) = {"
mQ
mQ
mQ
mQ
mQ
mQ
mQ
mQ
mQ
mQ
mQ
mQ
mQ
mQ
mQ
mQ
mQ
mQ
mQ
mQ
mQ
mQ
mQ
mQ
mQ
mQ
mQ
mQ
mQ
mQ
mQ
mQ
"}
(5,1,1) = {"
mQ
mQ
mQ
mQ
mQ
mQ
mQ
mQ
mQ
mQ
mQ
mQ
mQ
mQ
mQ
mQ
mQ
mQ
mQ
mQ
mQ
mQ
mQ
mQ
mQ
mQ
mQ
mQ
mQ
mQ
mQ
mQ
"}
(6,1,1) = {"
mQ
mQ
mQ
mQ
mQ
mQ
mQ
mQ
mQ
mQ
mQ
mQ
mQ
mQ
mQ
mQ
mQ
mQ
mQ
mQ
mQ
mQ
mQ
mQ
mQ
mQ
mQ
mQ
mQ
mQ
mQ
mQ
"}
(7,1,1) = {"
mQ
mQ
mQ
mQ
mQ
mQ
mQ
mQ
mQ
mQ
mQ
mQ
mQ
mQ
mQ
mQ
mQ
mQ
mQ
mQ
mQ
mQ
mQ
mQ
mQ
mQ
mQ
mQ
mQ
mQ
mQ
mQ
"}
(8,1,1) = {"
mQ
mQ
mQ
mQ
mQ
mQ
mQ
mQ
mQ
mQ
mQ
mQ
mQ
mQ
mQ
mQ
mQ
mQ
mQ
mQ
mQ
mQ
mQ
mQ
mQ
mQ
mQ
mQ
mQ
mQ
mQ
mQ
"}
(9,1,1) = {"
mQ
mQ
mQ
mQ
mQ
mQ
mQ
mQ
mQ
mQ
mQ
mQ
mQ
mQ
mQ
mQ
mQ
mQ
mQ
mQ
mQ
mQ
mQ
mQ
mQ
mQ
mQ
mQ
mQ
mQ
mQ
mQ
"}
(10,1,1) = {"
mQ
mQ
mQ
mQ
mQ
mQ
mQ
mQ
mQ
mQ
mQ
mQ
mQ
mQ
mQ
CK
CK
CK
CK
CK
CK
CK
CK
mQ
mQ
mQ
mQ
mQ
mQ
mQ
mQ
mQ
"}
(11,1,1) = {"
mQ
mQ
mQ
mQ
mQ
mQ
mQ
mQ
mQ
mQ
mQ
mQ
mQ
mQ
CK
CK
wy
wy
hj
ok
pX
dV
CK
CK
mQ
mQ
mQ
mQ
mQ
mQ
mQ
mQ
"}
(12,1,1) = {"
mQ
mQ
mQ
mQ
mQ
mQ
mQ
mQ
mQ
mQ
mQ
mQ
mQ
mQ
CK
gf
wy
wy
wy
wy
wy
wy
ml
CK
mQ
mQ
mQ
mQ
mQ
mQ
mQ
mQ
"}
(13,1,1) = {"
mQ
mQ
mQ
mQ
mQ
mQ
mQ
mQ
mQ
Ha
Ha
Ha
Ha
Ha
CK
YA
wy
wy
wy
wy
wy
wy
en
CK
CK
mQ
mQ
mQ
mQ
mQ
mQ
mQ
"}
(14,1,1) = {"
mQ
mQ
mQ
mQ
mQ
mQ
mQ
Ha
Ha
Ha
et
et
et
Ha
CK
wy
wy
wy
wy
wy
wy
wy
wy
wy
CK
mQ
mQ
mQ
mQ
mQ
mQ
mQ
"}
(15,1,1) = {"
mQ
mQ
mQ
mQ
mQ
mQ
mQ
Ha
et
et
et
et
et
et
LK
eF
wy
wy
wy
wy
wy
wy
wy
wy
CK
mQ
mQ
mQ
mQ
mQ
mQ
mQ
"}
(16,1,1) = {"
mQ
mQ
mQ
mQ
mQ
mQ
mQ
Ha
Ey
et
et
et
et
et
fA
wy
wy
wy
wy
wy
wy
wy
kY
wy
Yg
mQ
mQ
mQ
mQ
mQ
mQ
mQ
"}
(17,1,1) = {"
mQ
mQ
mQ
mQ
mQ
mQ
mQ
Ha
et
et
et
et
et
et
CK
wy
wy
wy
wy
wy
wy
wy
wy
jZ
CK
mQ
mQ
mQ
mQ
mQ
mQ
mQ
"}
(18,1,1) = {"
mQ
mQ
mQ
mQ
mQ
mQ
mQ
Ha
Ha
Ha
et
et
et
Ha
CK
wy
wy
wy
wy
wy
wy
wy
ec
Bl
CK
mQ
mQ
mQ
mQ
mQ
mQ
mQ
"}
(19,1,1) = {"
mQ
mQ
mQ
mQ
mQ
mQ
mQ
mQ
mQ
Ha
Ha
Ha
Ha
Ha
CK
TW
TW
JC
TW
JC
TW
TW
TW
CK
CK
mQ
mQ
mQ
mQ
mQ
mQ
mQ
"}
(20,1,1) = {"
mQ
mQ
mQ
mQ
mQ
mQ
mQ
mQ
mQ
mQ
mQ
mQ
mQ
mQ
CK
zB
wy
wy
TW
wy
wy
wy
Do
CK
mQ
mQ
mQ
mQ
mQ
mQ
mQ
mQ
"}
(21,1,1) = {"
mQ
mQ
mQ
mQ
mQ
mQ
mQ
mQ
mQ
mQ
mQ
mQ
mQ
mQ
CK
CK
uD
uD
TW
uD
uD
cK
CK
CK
mQ
mQ
mQ
mQ
mQ
mQ
mQ
mQ
"}
(22,1,1) = {"
mQ
mQ
mQ
mQ
mQ
mQ
mQ
mQ
mQ
mQ
mQ
mQ
mQ
mQ
mQ
CK
CK
CK
CK
CK
CK
CK
CK
mQ
mQ
mQ
mQ
mQ
mQ
mQ
mQ
mQ
"}
(23,1,1) = {"
mQ
mQ
mQ
mQ
mQ
mQ
mQ
mQ
mQ
mQ
mQ
mQ
mQ
mQ
mQ
mQ
mQ
mQ
mQ
mQ
mQ
mQ
mQ
mQ
mQ
mQ
mQ
mQ
mQ
mQ
mQ
mQ
"}
(24,1,1) = {"
mQ
mQ
mQ
mQ
mQ
mQ
mQ
mQ
mQ
mQ
mQ
mQ
mQ
mQ
mQ
mQ
mQ
mQ
mQ
mQ
mQ
mQ
mQ
mQ
mQ
mQ
mQ
mQ
mQ
mQ
mQ
mQ
"}
(25,1,1) = {"
mQ
mQ
mQ
mQ
mQ
mQ
mQ
mQ
mQ
mQ
mQ
mQ
mQ
mQ
mQ
mQ
mQ
mQ
mQ
mQ
mQ
mQ
mQ
mQ
mQ
mQ
mQ
mQ
mQ
mQ
mQ
mQ
"}
(26,1,1) = {"
mQ
mQ
mQ
mQ
mQ
mQ
mQ
mQ
mQ
mQ
mQ
mQ
mQ
mQ
mQ
mQ
mQ
mQ
mQ
mQ
mQ
mQ
mQ
mQ
mQ
mQ
mQ
mQ
mQ
mQ
mQ
mQ
"}
(27,1,1) = {"
mQ
mQ
mQ
mQ
mQ
mQ
mQ
mQ
mQ
mQ
mQ
mQ
mQ
mQ
mQ
mQ
mQ
mQ
mQ
mQ
mQ
mQ
mQ
mQ
mQ
mQ
mQ
mQ
mQ
mQ
mQ
mQ
"}
(28,1,1) = {"
mQ
mQ
mQ
mQ
mQ
mQ
mQ
mQ
mQ
mQ
mQ
mQ
mQ
mQ
mQ
mQ
mQ
mQ
mQ
mQ
mQ
mQ
mQ
mQ
mQ
mQ
mQ
mQ
mQ
mQ
mQ
mQ
"}
(29,1,1) = {"
mQ
mQ
mQ
mQ
mQ
mQ
mQ
mQ
mQ
mQ
mQ
mQ
mQ
mQ
mQ
mQ
mQ
mQ
mQ
mQ
mQ
mQ
mQ
mQ
mQ
mQ
mQ
mQ
mQ
mQ
mQ
mQ
"}
(30,1,1) = {"
mQ
mQ
mQ
mQ
mQ
mQ
mQ
mQ
mQ
mQ
mQ
mQ
mQ
mQ
mQ
mQ
mQ
mQ
mQ
mQ
mQ
mQ
mQ
mQ
mQ
mQ
mQ
mQ
mQ
mQ
mQ
mQ
"}
(31,1,1) = {"
mQ
mQ
mQ
mQ
mQ
mQ
mQ
mQ
mQ
mQ
mQ
mQ
mQ
mQ
mQ
mQ
mQ
mQ
mQ
mQ
mQ
mQ
mQ
mQ
mQ
mQ
mQ
mQ
mQ
mQ
mQ
mQ
"}
