//MAP CONVERTED BY dmm2tgm.py THIS HEADER COMMENT PREVENTS RECONVERSION, DO NOT REMOVE
"et" = (
/turf/simulated/floor/plating/abductor,
/area/ruin/powered/alien_cache_site/cache_room)
"fA" = (
/obj/structure/fans/tiny/invisible,
/obj/machinery/door/airlock/abductor/secure,
/turf/simulated/floor/plating/abductor,
/area/ruin/powered/alien_cache_site)
"kY" = (
/obj/effect/simon_says,
/turf/simulated/floor/plating/abductor,
/area/ruin/powered/alien_cache_site)
"mQ" = (
/turf/space,
/area/space)
"wy" = (
/turf/simulated/floor/plating/abductor,
/area/ruin/powered/alien_cache_site)
"CK" = (
/turf/simulated/wall/indestructible/abductor,
/area/ruin/powered/alien_cache_site)
"Ey" = (
/obj/machinery/alien_cache,
/turf/simulated/floor/plating/abductor,
/area/ruin/powered/alien_cache_site/cache_room)
"Ha" = (
/turf/simulated/wall/indestructible/abductor,
/area/ruin/powered/alien_cache_site/cache_room)
"Yg" = (
/obj/machinery/door/airlock/abductor,
/turf/simulated/floor/plating/abductor,
/area/ruin/powered/alien_cache_site)

(1,1,1) = {"
mQ
mQ
mQ
mQ
mQ
mQ
mQ
mQ
mQ
mQ
mQ
mQ
mQ
mQ
mQ
mQ
mQ
mQ
mQ
mQ
mQ
mQ
mQ
mQ
mQ
mQ
mQ
mQ
mQ
mQ
mQ
mQ
"}
(2,1,1) = {"
mQ
mQ
mQ
mQ
mQ
mQ
mQ
mQ
mQ
mQ
mQ
mQ
mQ
mQ
mQ
mQ
mQ
mQ
mQ
mQ
mQ
mQ
mQ
mQ
mQ
mQ
mQ
mQ
mQ
mQ
mQ
mQ
"}
(3,1,1) = {"
mQ
mQ
mQ
mQ
mQ
mQ
mQ
mQ
mQ
mQ
mQ
mQ
mQ
mQ
mQ
mQ
mQ
mQ
mQ
mQ
mQ
mQ
mQ
mQ
mQ
mQ
mQ
mQ
mQ
mQ
mQ
mQ
"}
(4,1,1) = {"
mQ
mQ
mQ
mQ
mQ
mQ
mQ
mQ
mQ
mQ
mQ
mQ
mQ
mQ
mQ
mQ
mQ
mQ
mQ
mQ
mQ
mQ
mQ
mQ
mQ
mQ
mQ
mQ
mQ
mQ
mQ
mQ
"}
(5,1,1) = {"
mQ
mQ
mQ
mQ
mQ
mQ
mQ
mQ
mQ
mQ
mQ
mQ
mQ
mQ
mQ
mQ
mQ
mQ
mQ
mQ
mQ
mQ
mQ
mQ
mQ
mQ
mQ
mQ
mQ
mQ
mQ
mQ
"}
(6,1,1) = {"
mQ
mQ
mQ
mQ
mQ
mQ
mQ
mQ
mQ
mQ
mQ
mQ
mQ
mQ
mQ
mQ
mQ
mQ
mQ
mQ
mQ
mQ
mQ
mQ
mQ
mQ
mQ
mQ
mQ
mQ
mQ
mQ
"}
(7,1,1) = {"
mQ
mQ
mQ
mQ
mQ
mQ
mQ
mQ
mQ
mQ
mQ
mQ
mQ
mQ
mQ
mQ
mQ
mQ
mQ
mQ
mQ
mQ
mQ
mQ
mQ
mQ
mQ
mQ
mQ
mQ
mQ
mQ
"}
(8,1,1) = {"
mQ
mQ
mQ
mQ
mQ
mQ
mQ
mQ
mQ
mQ
mQ
mQ
mQ
mQ
mQ
mQ
mQ
mQ
mQ
mQ
mQ
mQ
mQ
mQ
mQ
mQ
mQ
mQ
mQ
mQ
mQ
mQ
"}
(9,1,1) = {"
mQ
mQ
mQ
mQ
mQ
mQ
mQ
mQ
mQ
mQ
mQ
mQ
mQ
mQ
mQ
mQ
mQ
mQ
mQ
mQ
mQ
mQ
mQ
mQ
mQ
mQ
mQ
mQ
mQ
mQ
mQ
mQ
"}
(10,1,1) = {"
mQ
mQ
mQ
mQ
mQ
mQ
mQ
mQ
mQ
mQ
mQ
mQ
mQ
mQ
mQ
mQ
mQ
mQ
mQ
mQ
mQ
mQ
mQ
mQ
mQ
mQ
mQ
mQ
mQ
mQ
mQ
mQ
"}
(11,1,1) = {"
mQ
mQ
mQ
mQ
mQ
mQ
mQ
mQ
mQ
mQ
mQ
mQ
mQ
mQ
mQ
CK
CK
CK
CK
CK
CK
CK
CK
CK
mQ
mQ
mQ
mQ
mQ
mQ
mQ
mQ
"}
(12,1,1) = {"
mQ
mQ
mQ
mQ
mQ
mQ
mQ
mQ
mQ
mQ
mQ
mQ
mQ
mQ
CK
CK
wy
wy
wy
wy
wy
wy
wy
CK
CK
mQ
mQ
mQ
mQ
mQ
mQ
mQ
"}
(13,1,1) = {"
mQ
mQ
mQ
mQ
mQ
mQ
mQ
mQ
mQ
Ha
Ha
Ha
Ha
Ha
CK
wy
wy
wy
wy
wy
wy
wy
wy
wy
CK
mQ
mQ
mQ
mQ
mQ
mQ
mQ
"}
(14,1,1) = {"
mQ
mQ
mQ
mQ
mQ
mQ
mQ
Ha
Ha
Ha
et
et
et
Ha
CK
wy
wy
wy
wy
wy
wy
wy
wy
wy
CK
mQ
mQ
mQ
mQ
mQ
mQ
mQ
"}
(15,1,1) = {"
mQ
mQ
mQ
mQ
mQ
mQ
mQ
Ha
et
et
et
et
et
et
CK
wy
wy
wy
wy
wy
wy
wy
wy
wy
CK
mQ
mQ
mQ
mQ
mQ
mQ
mQ
"}
(16,1,1) = {"
mQ
mQ
mQ
mQ
mQ
mQ
mQ
Ha
Ey
et
et
et
et
et
fA
wy
wy
wy
wy
wy
wy
wy
kY
wy
Yg
mQ
mQ
mQ
mQ
mQ
mQ
mQ
"}
(17,1,1) = {"
mQ
mQ
mQ
mQ
mQ
mQ
mQ
Ha
et
et
et
et
et
et
CK
wy
wy
wy
wy
wy
wy
wy
wy
wy
CK
mQ
mQ
mQ
mQ
mQ
mQ
mQ
"}
(18,1,1) = {"
mQ
mQ
mQ
mQ
mQ
mQ
mQ
Ha
Ha
Ha
et
et
et
Ha
CK
wy
wy
wy
wy
wy
wy
wy
wy
wy
CK
mQ
mQ
mQ
mQ
mQ
mQ
mQ
"}
(19,1,1) = {"
mQ
mQ
mQ
mQ
mQ
mQ
mQ
mQ
mQ
Ha
Ha
Ha
Ha
Ha
CK
wy
wy
wy
wy
wy
wy
wy
wy
wy
CK
mQ
mQ
mQ
mQ
mQ
mQ
mQ
"}
(20,1,1) = {"
mQ
mQ
mQ
mQ
mQ
mQ
mQ
mQ
mQ
mQ
mQ
mQ
mQ
mQ
CK
CK
wy
wy
wy
wy
wy
wy
wy
CK
CK
mQ
mQ
mQ
mQ
mQ
mQ
mQ
"}
(21,1,1) = {"
mQ
mQ
mQ
mQ
mQ
mQ
mQ
mQ
mQ
mQ
mQ
mQ
mQ
mQ
mQ
CK
CK
CK
CK
CK
CK
CK
CK
CK
mQ
mQ
mQ
mQ
mQ
mQ
mQ
mQ
"}
(22,1,1) = {"
mQ
mQ
mQ
mQ
mQ
mQ
mQ
mQ
mQ
mQ
mQ
mQ
mQ
mQ
mQ
mQ
mQ
mQ
mQ
mQ
mQ
mQ
mQ
mQ
mQ
mQ
mQ
mQ
mQ
mQ
mQ
mQ
"}
(23,1,1) = {"
mQ
mQ
mQ
mQ
mQ
mQ
mQ
mQ
mQ
mQ
mQ
mQ
mQ
mQ
mQ
mQ
mQ
mQ
mQ
mQ
mQ
mQ
mQ
mQ
mQ
mQ
mQ
mQ
mQ
mQ
mQ
mQ
"}
(24,1,1) = {"
mQ
mQ
mQ
mQ
mQ
mQ
mQ
mQ
mQ
mQ
mQ
mQ
mQ
mQ
mQ
mQ
mQ
mQ
mQ
mQ
mQ
mQ
mQ
mQ
mQ
mQ
mQ
mQ
mQ
mQ
mQ
mQ
"}
(25,1,1) = {"
mQ
mQ
mQ
mQ
mQ
mQ
mQ
mQ
mQ
mQ
mQ
mQ
mQ
mQ
mQ
mQ
mQ
mQ
mQ
mQ
mQ
mQ
mQ
mQ
mQ
mQ
mQ
mQ
mQ
mQ
mQ
mQ
"}
(26,1,1) = {"
mQ
mQ
mQ
mQ
mQ
mQ
mQ
mQ
mQ
mQ
mQ
mQ
mQ
mQ
mQ
mQ
mQ
mQ
mQ
mQ
mQ
mQ
mQ
mQ
mQ
mQ
mQ
mQ
mQ
mQ
mQ
mQ
"}
(27,1,1) = {"
mQ
mQ
mQ
mQ
mQ
mQ
mQ
mQ
mQ
mQ
mQ
mQ
mQ
mQ
mQ
mQ
mQ
mQ
mQ
mQ
mQ
mQ
mQ
mQ
mQ
mQ
mQ
mQ
mQ
mQ
mQ
mQ
"}
(28,1,1) = {"
mQ
mQ
mQ
mQ
mQ
mQ
mQ
mQ
mQ
mQ
mQ
mQ
mQ
mQ
mQ
mQ
mQ
mQ
mQ
mQ
mQ
mQ
mQ
mQ
mQ
mQ
mQ
mQ
mQ
mQ
mQ
mQ
"}
(29,1,1) = {"
mQ
mQ
mQ
mQ
mQ
mQ
mQ
mQ
mQ
mQ
mQ
mQ
mQ
mQ
mQ
mQ
mQ
mQ
mQ
mQ
mQ
mQ
mQ
mQ
mQ
mQ
mQ
mQ
mQ
mQ
mQ
mQ
"}
(30,1,1) = {"
mQ
mQ
mQ
mQ
mQ
mQ
mQ
mQ
mQ
mQ
mQ
mQ
mQ
mQ
mQ
mQ
mQ
mQ
mQ
mQ
mQ
mQ
mQ
mQ
mQ
mQ
mQ
mQ
mQ
mQ
mQ
mQ
"}
(31,1,1) = {"
mQ
mQ
mQ
mQ
mQ
mQ
mQ
mQ
mQ
mQ
mQ
mQ
mQ
mQ
mQ
mQ
mQ
mQ
mQ
mQ
mQ
mQ
mQ
mQ
mQ
mQ
mQ
mQ
mQ
mQ
mQ
mQ
"}
