//MAP CONVERTED BY dmm2tgm.py THIS HEADER COMMENT PREVENTS RECONVERSION, DO NOT REMOVE
"a" = (
/turf/template_noop,
/area/template_noop)
"b" = (
/turf/simulated/floor/plating/asteroid/airless,
/area/ruin/space/unpowered)
"c" = (
/turf/simulated/mineral,
/area/ruin/space/unpowered)
"d" = (
/turf/simulated/mineral/random/high_chance/space,
/area/ruin/space/unpowered)
"t" = (
/obj/structure/spawner/mining/basilisk/space,
/turf/simulated/floor/plating/asteroid/airless,
/area/ruin/space/unpowered)
"C" = (
/obj/effect/spawner/random/pool/spaceloot/syndicate/mixed,
/turf/simulated/floor/plating/asteroid/airless,
/area/ruin/space/unpowered)
"R" = (
/obj/structure/spawner/mining/goliath/space,
/turf/simulated/floor/plating/asteroid/airless,
/area/ruin/space/unpowered)
"V" = (
/mob/living/basic/carp,
/turf/template_noop,
/area/template_noop)

(1,1,1) = {"
a
a
a
a
a
a
a
a
a
a
a
a
a
a
a
a
a
a
a
a
a
"}
(2,1,1) = {"
a
a
a
a
a
a
a
a
a
a
a
a
a
a
a
a
a
a
b
a
a
"}
(3,1,1) = {"
a
a
a
a
a
b
b
b
b
a
a
a
a
a
a
a
a
a
a
a
a
"}
(4,1,1) = {"
a
a
a
a
b
b
b
b
b
a
b
b
b
b
a
a
a
a
a
a
a
"}
(5,1,1) = {"
a
a
a
b
b
b
b
b
b
b
b
b
b
b
b
a
a
b
a
a
a
"}
(6,1,1) = {"
a
a
a
b
t
b
c
c
c
c
b
b
b
b
b
b
a
a
a
a
a
"}
(7,1,1) = {"
a
a
b
b
b
b
c
c
c
c
d
d
d
d
d
b
a
a
a
a
a
"}
(8,1,1) = {"
a
a
b
b
b
c
c
c
c
c
d
d
d
d
d
b
b
b
a
a
a
"}
(9,1,1) = {"
a
a
b
b
c
c
c
c
d
c
c
C
c
c
c
b
b
b
a
a
a
"}
(10,1,1) = {"
a
a
b
b
b
c
c
c
d
c
c
c
c
d
d
d
c
b
b
a
a
"}
(11,1,1) = {"
a
a
a
b
b
b
c
c
d
d
c
c
d
d
c
c
c
b
b
a
a
"}
(12,1,1) = {"
a
a
a
b
b
b
c
c
c
d
d
d
d
d
c
c
c
b
b
a
a
"}
(13,1,1) = {"
a
a
a
a
b
b
d
d
c
d
d
d
d
c
c
c
d
c
b
a
a
"}
(14,1,1) = {"
a
a
a
a
b
b
d
d
d
c
c
c
c
C
c
c
c
c
b
b
a
"}
(15,1,1) = {"
a
a
a
a
b
b
b
b
b
c
c
c
c
c
c
d
c
c
c
b
a
"}
(16,1,1) = {"
a
a
a
a
a
a
b
b
b
c
d
c
c
d
d
d
c
c
c
b
a
"}
(17,1,1) = {"
a
a
a
a
a
a
a
a
b
b
b
c
c
d
d
d
b
b
b
b
a
"}
(18,1,1) = {"
a
a
V
b
a
a
a
a
b
b
b
b
b
b
b
b
b
b
a
a
a
"}
(19,1,1) = {"
a
V
V
b
b
a
a
a
a
a
b
b
b
R
b
b
b
a
a
a
a
"}
(20,1,1) = {"
a
a
a
a
V
a
a
a
a
a
b
b
b
b
b
b
b
a
a
a
a
"}
(21,1,1) = {"
a
a
b
a
a
a
a
a
a
a
a
a
a
a
a
a
a
a
a
a
a
"}
(22,1,1) = {"
a
a
a
a
a
a
a
a
a
a
a
a
a
a
a
a
a
a
a
a
a
"}
