//MAP CONVERTED BY dmm2tgm.py THIS HEADER COMMENT PREVENTS RECONVERSION, DO NOT REMOVE
"a" = (
/turf/template_noop,
/area/template_noop)
"b" = (
/turf/simulated/floor/plating/asteroid/airless,
/area/ruin/space/unpowered)
"c" = (
/turf/simulated/mineral,
/area/ruin/space/unpowered)
"d" = (
/turf/simulated/mineral/random/high_chance/space,
/area/ruin/space/unpowered)
"e" = (
/obj/effect/decal/remains/human,
/turf/simulated/floor/plating/asteroid/airless,
/area/ruin/space/unpowered)
"f" = (
/obj/item/pickaxe/diamond,
/turf/simulated/floor/plating/asteroid/airless,
/area/ruin/space/unpowered)
"q" = (
/turf/simulated/mineral/random/low_chance/space,
/area/ruin/space/unpowered)
"r" = (
/obj/effect/spawner/random/pool/spaceloot/syndicate/mixed,
/turf/simulated/floor/plating/asteroid/airless,
/area/ruin/space/unpowered)
"v" = (
/obj/structure/spawner/mining/basilisk/space,
/turf/simulated/floor/plating/asteroid/airless,
/area/ruin/space/unpowered)
"N" = (
/obj/structure/spawner/mining/hivelord/space,
/turf/simulated/floor/plating/asteroid/airless,
/area/ruin/space/unpowered)

(1,1,1) = {"
a
a
a
a
a
a
a
a
a
a
a
a
a
a
a
a
a
a
a
a
"}
(2,1,1) = {"
a
a
a
b
a
a
a
a
a
b
c
c
c
c
b
a
a
a
a
a
"}
(3,1,1) = {"
a
a
a
a
a
a
a
a
b
b
d
d
c
c
c
c
c
a
a
a
"}
(4,1,1) = {"
a
b
b
a
b
b
b
a
b
b
d
d
c
q
d
d
d
b
a
a
"}
(5,1,1) = {"
a
b
b
b
b
c
c
b
b
c
d
d
c
q
q
d
d
b
a
a
"}
(6,1,1) = {"
a
b
b
c
c
q
q
c
c
c
c
c
c
q
q
q
d
c
a
a
"}
(7,1,1) = {"
a
a
b
c
c
q
q
q
c
c
c
r
c
c
q
c
c
b
a
a
"}
(8,1,1) = {"
a
a
a
b
r
c
d
c
c
b
b
b
b
c
c
c
c
b
a
a
"}
(9,1,1) = {"
a
a
b
b
c
c
c
c
b
b
b
f
b
b
c
c
v
b
b
a
"}
(10,1,1) = {"
a
a
b
b
c
c
c
c
b
N
e
b
b
b
c
c
c
b
b
a
"}
(11,1,1) = {"
a
a
b
b
c
c
b
b
b
b
b
b
b
c
c
c
c
c
b
a
"}
(12,1,1) = {"
a
a
b
b
c
c
c
c
c
b
b
c
c
c
c
d
d
b
b
a
"}
(13,1,1) = {"
a
a
a
b
d
d
c
c
c
c
c
c
q
q
c
d
d
b
b
a
"}
(14,1,1) = {"
a
a
a
b
d
d
q
q
c
d
c
q
q
q
c
c
b
b
a
a
"}
(15,1,1) = {"
a
a
a
b
d
d
q
q
q
q
q
q
c
c
b
b
b
a
a
a
"}
(16,1,1) = {"
a
b
a
b
c
c
c
q
q
q
q
c
c
c
b
a
a
a
b
a
"}
(17,1,1) = {"
a
a
a
b
b
b
c
c
c
c
c
c
b
b
a
a
a
a
a
a
"}
(18,1,1) = {"
a
a
a
a
b
b
c
c
d
d
c
c
b
b
a
a
a
a
a
a
"}
(19,1,1) = {"
a
a
a
a
a
a
a
c
d
d
a
a
a
a
a
a
a
a
a
a
"}
(20,1,1) = {"
a
a
a
b
a
a
a
a
a
a
a
a
a
b
a
a
a
b
a
a
"}
(21,1,1) = {"
a
a
a
a
a
a
a
a
a
a
a
a
a
a
a
a
a
a
a
a
"}
