//MAP CONVERTED BY dmm2tgm.py THIS HEADER COMMENT PREVENTS RECONVERSION, DO NOT REMOVE
"a" = (
/turf/simulated/mineral/random/low_chance/space,
/area/ruin/space/unpowered)
"c" = (
/turf/simulated/mineral/random/high_chance/space,
/area/ruin/space/unpowered)
"h" = (
/turf/space,
/area/space)
"J" = (
/turf/simulated/mineral,
/area/ruin/space/unpowered)
"T" = (
/turf/simulated/mineral/random/space,
/area/ruin/space/unpowered)

(1,1,1) = {"
h
h
h
h
h
h
h
h
h
h
h
h
h
h
h
h
h
h
h
h
h
h
h
h
h
h
h
h
h
h
h
h
h
h
h
h
h
h
h
h
"}
(2,1,1) = {"
h
h
h
h
h
h
h
h
J
J
J
J
J
J
J
h
h
h
h
h
h
h
h
h
h
h
h
h
h
h
h
h
h
h
h
J
J
J
J
h
"}
(3,1,1) = {"
h
h
h
h
h
h
J
J
J
a
a
a
a
a
J
J
h
h
h
h
h
h
h
h
h
h
h
h
h
h
h
h
h
J
J
J
a
a
J
h
"}
(4,1,1) = {"
h
h
h
h
h
J
J
a
a
a
c
c
c
a
a
a
J
J
h
h
h
h
h
h
h
h
h
h
h
h
h
h
J
J
a
a
a
a
a
J
"}
(5,1,1) = {"
h
h
h
h
h
h
J
J
J
a
a
a
a
a
a
a
a
a
J
h
h
h
h
h
h
h
h
h
h
h
J
T
T
a
a
a
a
a
a
J
"}
(6,1,1) = {"
h
h
h
h
h
h
h
h
h
J
J
J
a
a
a
a
a
a
J
J
J
J
h
h
h
J
J
J
J
J
J
a
a
a
a
a
a
a
a
J
"}
(7,1,1) = {"
h
h
h
h
h
h
h
h
h
h
h
h
J
a
a
T
a
a
a
a
a
a
J
J
J
J
J
J
a
a
a
a
a
T
T
T
a
a
a
J
"}
(8,1,1) = {"
h
h
h
h
h
h
h
h
h
h
J
J
J
a
a
T
T
a
a
a
a
a
a
a
a
a
a
a
a
a
a
a
T
T
T
T
a
a
a
J
"}
(9,1,1) = {"
h
h
h
h
h
h
h
J
J
J
J
a
a
a
a
T
T
T
T
T
T
a
a
a
a
a
a
a
a
J
J
T
c
c
T
T
a
a
a
J
"}
(10,1,1) = {"
h
h
h
h
h
h
J
J
a
a
a
a
a
a
T
T
T
T
T
T
T
T
T
T
T
T
T
T
T
T
T
T
c
c
T
T
a
a
a
J
"}
(11,1,1) = {"
h
h
h
h
h
J
a
a
a
a
a
a
T
T
T
T
c
T
T
T
T
T
T
T
T
T
T
T
T
T
T
c
c
c
T
T
a
a
J
J
"}
(12,1,1) = {"
h
h
h
h
J
a
a
a
T
T
T
T
T
T
c
c
c
T
T
T
T
T
T
T
T
T
c
c
c
T
T
c
c
c
T
T
a
a
J
h
"}
(13,1,1) = {"
h
h
J
J
J
a
a
T
T
T
T
T
T
T
c
c
c
T
T
T
T
c
T
T
T
T
c
c
c
T
T
T
c
c
c
T
a
a
J
h
"}
(14,1,1) = {"
J
J
J
a
a
a
T
c
c
c
T
T
T
T
c
T
c
T
T
c
c
c
c
c
T
c
c
T
T
c
T
T
T
T
T
a
a
a
J
h
"}
(15,1,1) = {"
J
J
a
a
a
c
c
c
T
T
T
c
T
c
T
T
T
T
T
c
c
c
T
T
T
T
T
c
T
T
T
T
T
T
T
a
a
a
J
h
"}
(16,1,1) = {"
h
J
J
a
a
T
T
T
T
T
T
T
T
T
T
T
T
T
T
c
T
T
T
T
T
T
T
T
T
T
T
T
T
T
T
a
a
J
h
h
"}
(17,1,1) = {"
h
h
J
a
a
T
T
c
c
T
T
T
T
T
T
T
T
T
T
T
T
T
T
T
T
T
T
a
a
a
a
a
a
a
a
a
a
J
h
h
"}
(18,1,1) = {"
h
h
J
a
a
T
T
c
c
T
c
T
T
T
T
T
c
T
T
T
T
a
a
a
a
a
a
a
a
a
a
a
a
a
a
a
a
J
h
h
"}
(19,1,1) = {"
h
h
J
a
a
c
T
c
c
T
T
T
T
c
c
c
c
c
T
T
T
a
a
a
a
a
a
a
a
J
J
J
J
J
J
J
J
J
h
h
"}
(20,1,1) = {"
h
J
J
a
a
T
c
c
T
T
T
T
T
c
c
c
c
c
T
T
a
a
a
J
a
a
a
J
J
J
h
h
h
h
h
h
J
h
h
h
"}
(21,1,1) = {"
h
J
J
a
a
T
T
T
T
T
T
T
T
T
T
c
c
T
T
J
a
a
a
J
J
J
J
J
h
h
h
h
h
h
h
h
h
h
h
h
"}
(22,1,1) = {"
h
h
J
a
a
T
T
c
c
T
T
T
T
T
T
T
T
c
T
a
a
a
J
J
h
h
h
h
h
h
h
h
h
h
h
h
h
h
h
h
"}
(23,1,1) = {"
h
h
J
a
a
c
c
T
c
c
T
T
c
c
T
T
T
T
T
a
a
a
J
h
h
h
h
h
h
h
h
h
J
J
J
h
h
h
h
h
"}
(24,1,1) = {"
h
h
J
a
a
a
T
T
T
T
T
T
c
c
T
T
J
T
T
a
a
J
J
h
h
h
h
h
h
h
h
h
J
a
J
J
h
h
h
h
"}
(25,1,1) = {"
h
h
h
J
a
a
a
a
T
a
a
a
a
a
a
a
a
T
T
a
a
J
h
h
h
h
h
h
h
h
h
h
J
J
c
J
J
J
h
h
"}
(26,1,1) = {"
h
h
h
J
J
a
a
a
a
a
a
a
a
a
a
a
a
a
a
a
J
J
h
h
h
h
h
h
h
h
h
h
h
J
J
a
a
J
h
h
"}
(27,1,1) = {"
h
h
h
h
J
J
a
a
a
a
a
J
J
J
J
a
a
a
a
a
J
h
h
h
h
h
h
h
h
h
h
h
h
h
J
J
J
J
h
h
"}
(28,1,1) = {"
h
h
h
h
h
h
J
J
J
J
J
J
h
h
h
J
J
J
J
J
J
h
h
h
h
h
h
h
h
h
h
h
h
h
h
h
J
h
h
h
"}
(29,1,1) = {"
h
h
h
h
h
h
h
h
h
h
h
h
h
h
h
h
h
h
h
h
h
h
h
h
h
h
h
h
h
h
h
h
h
h
h
h
h
h
h
h
"}
(30,1,1) = {"
h
h
h
h
h
h
h
h
h
h
h
h
h
h
h
h
h
h
h
h
h
h
h
h
h
h
h
h
h
h
h
h
h
h
h
h
h
h
h
h
"}
