//MAP CONVERTED BY dmm2tgm.py THIS HEADER COMMENT PREVENTS RECONVERSION, DO NOT REMOVE
"a" = (
/turf/simulated/mineral,
/area/space)
"d" = (
/turf/simulated/mineral/random/low_chance/space,
/area/space)
"h" = (
/turf/simulated/mineral/random/high_chance/space,
/area/space)
"n" = (
/turf/simulated/mineral/random/low_chance,
/area/space)
"s" = (
/obj/structure/spawner/mining/hivelord,
/turf/simulated/floor/plating/asteroid,
/area/space)
"w" = (
/mob/living/simple_animal/hostile/asteroid/basilisk,
/turf/simulated/floor/plating/asteroid/airless,
/area/space)
"y" = (
/turf/simulated/floor/plating/asteroid/airless,
/area/space)
"E" = (
/obj/structure/spawner/mining/basilisk,
/turf/simulated/floor/plating/asteroid/airless,
/area/space)
"Q" = (
/turf/space,
/area/space)
"V" = (
/turf/simulated/floor/plating/asteroid,
/area/space)
"Y" = (
/turf/simulated/mineral/random/space,
/area/space)

(1,1,1) = {"
Q
Q
Q
Q
Q
Q
Q
Q
Q
Q
Q
Q
Q
Q
Q
Q
Q
Q
Q
Q
Q
Q
Q
Q
Q
Q
Q
Q
Q
Q
Q
Q
Q
Q
Q
Q
Q
Q
Q
Q
"}
(2,1,1) = {"
Q
Q
y
y
a
a
a
a
a
a
a
a
a
a
a
y
y
y
y
Q
Q
Q
Q
Q
Q
Q
Q
Q
Q
Q
Q
Q
Q
Q
Q
Q
Q
Q
Q
Q
"}
(3,1,1) = {"
Q
Q
y
y
a
d
d
d
a
a
a
a
a
a
a
a
a
a
y
y
y
Q
Q
Q
Q
Q
Q
Q
Q
Q
Q
Q
Q
Q
Q
Q
Q
Q
Q
Q
"}
(4,1,1) = {"
Q
Q
y
y
a
a
d
d
d
d
d
d
d
d
d
a
a
a
y
y
y
y
Q
Q
Q
Q
a
a
Q
Q
Q
Q
Q
Q
Q
Q
Q
Q
Q
Q
"}
(5,1,1) = {"
Q
Q
y
y
y
a
a
a
a
a
a
a
a
d
d
d
a
a
y
Q
Q
Q
Q
Q
Q
a
n
n
a
Q
Q
Q
Q
Q
Q
Q
Q
Q
Q
Q
"}
(6,1,1) = {"
Q
y
y
y
y
y
a
a
a
a
a
a
a
a
a
a
a
y
Q
Q
Q
Q
Q
a
a
n
n
n
a
a
y
y
y
y
y
y
y
Q
Q
Q
"}
(7,1,1) = {"
Q
y
y
y
y
y
y
y
y
y
y
y
y
y
y
y
y
y
Q
V
V
V
a
n
n
n
n
Y
d
d
a
y
y
y
y
a
a
a
Q
Q
"}
(8,1,1) = {"
Q
V
V
V
V
V
V
V
V
V
Q
Q
Q
Q
Q
Q
Q
V
V
V
a
a
n
n
n
n
Y
d
d
d
d
a
a
a
a
a
d
a
Q
Q
"}
(9,1,1) = {"
V
V
a
a
a
a
a
a
a
V
V
V
Q
Q
Q
Q
V
V
V
a
n
n
n
n
n
Y
Y
Y
d
d
d
d
d
d
d
d
d
a
a
Q
"}
(10,1,1) = {"
V
a
n
n
n
n
n
n
a
a
a
V
V
Q
Q
V
V
V
a
n
n
n
n
Y
Y
Y
Y
Y
d
d
d
d
d
d
d
d
n
n
a
Q
"}
(11,1,1) = {"
V
a
n
n
n
n
n
n
n
n
n
a
V
V
V
V
a
a
a
n
n
Y
Y
Y
h
h
h
h
h
Y
Y
Y
Y
Y
Y
Y
n
n
a
Q
"}
(12,1,1) = {"
V
a
n
n
n
h
h
h
n
n
n
n
a
a
a
a
n
n
n
n
n
Y
Y
h
h
h
h
h
h
h
h
Y
Y
Y
Y
Y
n
n
a
Q
"}
(13,1,1) = {"
V
V
a
a
n
n
n
h
h
a
n
n
a
n
n
n
n
n
n
Y
Y
Y
h
h
h
h
h
h
h
h
h
h
h
Y
Y
Y
n
n
a
Q
"}
(14,1,1) = {"
Q
V
V
a
a
n
n
n
h
Y
Y
n
n
n
n
n
n
n
Y
Y
Y
h
h
h
y
y
y
y
y
h
h
h
h
Y
Y
h
n
n
a
Q
"}
(15,1,1) = {"
Q
Q
V
V
a
a
n
n
n
n
n
Y
Y
Y
Y
Y
Y
Y
Y
Y
Y
h
h
y
h
h
h
h
h
y
y
h
h
Y
Y
h
n
n
Y
a
"}
(16,1,1) = {"
Q
Q
Q
V
V
a
a
n
n
n
n
n
Y
Y
Y
Y
Y
Y
h
h
h
h
h
y
h
y
y
y
y
E
y
h
h
Y
Y
h
n
n
n
a
"}
(17,1,1) = {"
Q
Q
Q
Q
V
V
V
a
Y
n
n
n
Y
Y
Y
Y
Y
h
h
h
h
h
y
E
y
y
y
w
y
y
y
h
h
Y
Y
h
n
n
Y
a
"}
(18,1,1) = {"
Q
Q
Q
Q
Q
Q
V
s
a
n
n
n
n
Y
Y
Y
h
h
h
y
y
y
y
y
y
y
y
y
y
y
y
h
h
Y
Y
Y
n
n
a
Q
"}
(19,1,1) = {"
Q
Q
Q
Q
Q
Q
V
V
V
a
a
n
n
n
Y
Y
h
h
y
y
w
y
y
y
y
y
y
y
y
y
y
h
h
Y
Y
Y
n
n
a
Q
"}
(20,1,1) = {"
Q
Q
Q
Q
Q
Q
Q
V
V
V
a
n
n
n
Y
h
h
h
y
E
y
y
y
y
y
y
y
y
y
y
y
h
h
Y
Y
Y
n
n
a
Q
"}
(21,1,1) = {"
Q
Q
Q
Q
Q
Q
Q
Q
V
V
a
a
n
n
Y
h
h
y
y
y
y
h
y
y
w
h
y
y
y
h
h
h
h
Y
Y
Y
n
n
a
Q
"}
(22,1,1) = {"
Q
Q
Q
Q
Q
Q
Q
Q
V
V
V
a
n
n
Y
h
h
y
h
y
y
h
h
y
y
h
y
h
h
h
h
h
Y
Y
Y
Y
n
n
a
Q
"}
(23,1,1) = {"
Q
Q
Q
Q
Q
Q
Q
Q
V
V
V
a
n
n
Y
h
h
y
h
y
y
h
h
y
y
h
y
h
h
h
Y
Y
Y
d
d
d
n
n
a
Q
"}
(24,1,1) = {"
Q
Q
Q
Q
Q
Q
Q
Q
V
V
V
a
n
n
Y
h
h
y
h
y
y
h
h
y
y
y
y
h
h
Y
Y
d
d
d
d
d
d
d
a
Q
"}
(25,1,1) = {"
Q
Q
Q
Q
Q
Q
Q
V
V
V
s
a
n
n
Y
h
h
y
y
y
y
h
y
E
y
y
h
h
h
Y
d
d
d
a
a
a
a
a
y
Q
"}
(26,1,1) = {"
Q
Q
Q
Q
Q
Q
Q
V
V
V
a
n
n
n
Y
Y
h
h
y
E
y
y
w
y
y
h
h
h
Y
Y
d
d
a
a
y
y
y
y
y
Q
"}
(27,1,1) = {"
Q
Q
Q
Q
Q
Q
Q
V
V
a
n
n
n
a
Y
Y
h
h
h
y
y
y
y
y
y
h
h
h
Y
Y
d
d
a
y
y
Q
Q
Q
Q
Q
"}
(28,1,1) = {"
Q
Q
Q
Q
Q
Q
Q
a
a
n
n
Y
a
a
Y
Y
Y
h
h
h
y
h
h
y
y
h
h
Y
Y
Y
d
n
a
y
Q
Q
Q
Q
Q
Q
"}
(29,1,1) = {"
Q
Q
Q
Q
Q
a
a
n
n
Y
Y
Y
a
Y
Y
Y
Y
Y
h
h
h
y
y
y
h
h
h
Y
Y
Y
n
n
a
y
Q
Q
Q
Q
Q
Q
"}
(30,1,1) = {"
Q
Q
Q
a
a
n
n
n
Y
d
d
Y
a
Y
Y
Y
Y
Y
h
h
h
h
h
h
h
h
Y
Y
Y
n
n
a
y
Q
Q
Q
y
Q
Q
Q
"}
(31,1,1) = {"
Q
Q
a
Y
n
n
Y
Y
d
d
d
d
d
Y
Y
Y
Y
Y
Y
h
h
h
h
h
h
h
Y
n
n
n
a
y
Q
Q
Q
y
y
y
Q
Q
"}
(32,1,1) = {"
Q
a
Y
n
n
Y
d
d
a
a
a
d
d
Y
Y
Y
Y
Y
Y
Y
Y
Y
Y
Y
Y
Y
n
n
Y
a
y
Q
Q
Q
a
a
a
Q
Q
Q
"}
(33,1,1) = {"
a
n
n
n
Y
h
d
d
a
y
y
a
n
n
n
Y
Y
Y
Y
Y
Y
Y
Y
Y
Y
Y
n
n
a
y
y
y
a
a
a
a
a
a
Q
Q
"}
(34,1,1) = {"
a
n
Y
Y
h
d
d
n
a
y
y
a
n
n
n
n
n
n
Y
Y
Y
Y
Y
Y
Y
Y
n
n
a
y
y
y
a
a
a
a
a
a
Q
Q
"}
(35,1,1) = {"
a
n
n
n
n
n
n
n
a
y
y
y
a
a
Y
n
n
n
n
Y
Y
Y
h
h
h
Y
n
n
a
y
y
y
a
a
a
a
a
a
Q
Q
"}
(36,1,1) = {"
a
a
Y
n
n
n
Y
a
a
y
Q
y
y
a
a
Y
n
n
n
n
Y
Y
Y
Y
h
Y
n
n
n
a
y
E
a
a
a
a
a
Q
Q
Q
"}
(37,1,1) = {"
Q
a
Y
n
n
n
a
a
y
y
Q
Q
y
y
a
a
n
n
n
n
n
n
Y
h
h
Y
n
n
n
a
y
y
a
a
a
a
a
Q
Q
Q
"}
(38,1,1) = {"
Q
Q
a
a
a
a
y
y
y
Q
Q
Q
Q
y
y
a
a
a
n
n
n
n
n
n
Y
Y
n
n
n
a
y
y
y
a
a
a
Q
Q
Q
Q
"}
(39,1,1) = {"
Q
Q
Q
Q
Q
Q
Q
Q
Q
Q
Q
Q
Q
Q
y
y
y
a
a
a
a
n
n
n
n
n
n
n
n
a
y
y
y
y
a
Q
Q
Q
Q
Q
"}
(40,1,1) = {"
Q
Q
Q
Q
Q
Q
Q
Q
Q
Q
Q
Q
Q
Q
Q
Q
Q
Q
Q
Q
a
a
a
a
a
a
a
a
a
Q
Q
Q
Q
Q
Q
Q
Q
Q
Q
Q
"}
