//MAP CONVERTED BY dmm2tgm.py THIS HEADER COMMENT PREVENTS RECONVERSION, DO NOT REMOVE
"a" = (
/turf/simulated/mineral/random/high_chance/space,
/area/ruin)
"c" = (
/turf/simulated/mineral/ancient,
/area/ruin)
"d" = (
/obj/structure/chair/comfy/shuttle{
	dir = 1
	},
/turf/simulated/floor/engine,
/area/ruin/powered)
"e" = (
/obj/structure/closet/crate/miningcar{
	name = "mining car"
	},
/obj/effect/spawner/random/uncommon_ore,
/turf/simulated/floor/plating/asteroid/airless,
/area/ruin)
"f" = (
/obj/structure/chair/comfy/shuttle,
/obj/effect/decal/cleanable/dirt,
/turf/simulated/floor/engine,
/area/ruin/powered)
"g" = (
/obj/structure/chair/comfy/shuttle,
/turf/simulated/floor/engine,
/area/ruin/powered)
"h" = (
/mob/living/basic/vox_miner/foreman,
/turf/simulated/floor/plating/asteroid/airless,
/area/ruin)
"j" = (
/obj/machinery/door/airlock/titanium,
/obj/effect/decal/cleanable/dirt,
/obj/structure/fans/tiny,
/turf/simulated/floor/plasteel,
/area/ruin/powered)
"k" = (
/turf/simulated/mineral/random/low_chance/space,
/area/ruin)
"m" = (
/obj/structure/closet/crate/miningcar{
	name = "mining car"
	},
/obj/effect/spawner/random/rare_ore,
/obj/effect/spawner/random/rare_ore,
/turf/simulated/floor/plating/asteroid/airless,
/area/ruin)
"n" = (
/obj/structure/chair/comfy/shuttle,
/turf/simulated/floor/plasteel,
/area/ruin/powered)
"o" = (
/obj/structure/closet/crate/miningcar{
	name = "mining car"
	},
/obj/effect/spawner/random/common_ore,
/turf/simulated/floor/plating/asteroid/airless,
/area/ruin)
"r" = (
/obj/structure/chair/comfy/shuttle,
/obj/effect/decal/cleanable/dirt,
/turf/simulated/floor/plasteel,
/area/ruin/powered)
"s" = (
/obj/structure/closet/crate,
/obj/effect/spawner/random/pool/spaceloot/syndicate/mixed,
/obj/effect/spawner/random/trash,
/obj/effect/spawner/random/trash,
/obj/effect/spawner/random/trash,
/obj/effect/spawner/random/trash,
/obj/effect/spawner/random/trash,
/obj/effect/spawner/random/bluespace_tap/clothes_uncommon,
/obj/effect/spawner/random/bluespace_tap/clothes_uncommon,
/obj/effect/spawner/random/bluespace_tap/food_uncommon,
/obj/effect/spawner/random/bluespace_tap/food_uncommon,
/obj/effect/spawner/random/bluespace_tap/food_uncommon,
/obj/effect/spawner/random/engineering/toolbox,
/turf/simulated/floor/engine,
/area/ruin/powered)
"t" = (
/obj/structure/shuttle/engine/propulsion{
	dir = 1
	},
/turf/simulated/floor/plating,
/area/ruin/powered)
"u" = (
/obj/effect/decal/cleanable/dirt,
/obj/machinery/computer/nonfunctional,
/turf/simulated/floor/plasteel,
/area/ruin/powered)
"v" = (
/obj/structure/chair/comfy/shuttle{
	dir = 1
	},
/turf/simulated/floor/plasteel,
/area/ruin/powered)
"w" = (
/obj/effect/spawner/random/pool/spaceloot/syndicate/mixed,
/turf/simulated/floor/plating/asteroid/airless,
/area/ruin)
"x" = (
/obj/effect/decal/cleanable/dirt,
/obj/effect/decal/cleanable/dirt,
/turf/simulated/floor/engine,
/area/ruin/powered)
"z" = (
/obj/effect/decal/cleanable/blood/vox,
/turf/simulated/floor/plating/asteroid/airless,
/area/ruin)
"A" = (
/turf/simulated/wall/mineral/titanium,
/area/ruin/powered)
"C" = (
/obj/effect/spawner/random/loot_crate,
/turf/simulated/floor/plating/asteroid/airless,
/area/ruin)
"F" = (
/turf/simulated/floor/plating/asteroid/airless,
/area/ruin)
"G" = (
/turf/simulated/mineral/random/space,
/area/ruin)
"H" = (
/obj/effect/spawner/window/shuttle,
/turf/simulated/floor/plating,
/area/ruin/powered)
"I" = (
/obj/structure/table/reinforced,
/turf/simulated/floor/engine,
/area/ruin/powered)
"J" = (
/obj/structure/shuttle/engine/router,
/obj/structure/window/plasmareinforced,
/turf/simulated/floor/engine,
/area/ruin/powered)
"K" = (
/obj/structure/chair/comfy/shuttle,
/obj/effect/mob_spawn/human/corpse/vox_miner,
/turf/simulated/floor/engine,
/area/ruin/powered)
"M" = (
/turf/space,
/area/space)
"N" = (
/obj/machinery/computer/nonfunctional{
	dir = 1
	},
/turf/simulated/floor/plasteel,
/area/ruin/powered)
"O" = (
/mob/living/basic/vox_miner,
/turf/simulated/floor/plating/asteroid/airless,
/area/ruin)
"P" = (
/obj/effect/decal/cleanable/dirt,
/turf/simulated/floor/plasteel,
/area/ruin/powered)
"R" = (
/obj/machinery/door/airlock/titanium,
/obj/structure/fans/tiny,
/turf/simulated/floor/plasteel,
/area/ruin/powered)
"S" = (
/obj/structure/shuttle/engine/heater{
	dir = 1
	},
/obj/structure/window/plasmareinforced,
/turf/simulated/floor/engine,
/area/ruin/powered)
"T" = (
/obj/structure/ore_box,
/turf/simulated/floor/plating/asteroid/airless,
/area/ruin)
"U" = (
/obj/effect/decal/cleanable/dirt,
/turf/simulated/floor/engine,
/area/ruin/powered)
"V" = (
/obj/structure/chair/comfy/shuttle,
/obj/effect/spawner/random/cobweb/right,
/turf/simulated/floor/plasteel,
/area/ruin/powered)
"W" = (
/obj/structure/table/reinforced,
/turf/simulated/floor/plasteel,
/area/ruin/powered)
"X" = (
/obj/machinery/economy/vending/wallmed/directional/west,
/obj/structure/chair/comfy/shuttle,
/turf/simulated/floor/engine,
/area/ruin/powered)
"Y" = (
/obj/effect/decal/cleanable/dirt,
/obj/machinery/computer/nonfunctional,
/turf/simulated/floor/engine,
/area/ruin/powered)
"Z" = (
/obj/structure/flora/ash/rock/style_random,
/turf/simulated/floor/plating/asteroid/airless,
/area/ruin)

(1,1,1) = {"
M
M
M
M
M
M
M
M
M
M
M
M
M
M
M
M
M
M
M
M
M
M
M
M
M
M
M
M
M
M
"}
(2,1,1) = {"
M
M
M
M
M
M
M
M
M
M
M
M
M
M
M
M
M
M
M
M
M
M
M
M
M
M
M
M
M
M
"}
(3,1,1) = {"
M
M
M
M
M
M
M
M
M
M
M
M
M
G
G
G
G
G
M
M
M
M
M
M
M
M
M
M
M
M
"}
(4,1,1) = {"
M
M
M
M
M
M
M
M
M
G
G
G
G
G
G
G
G
G
G
M
M
M
M
M
M
M
M
M
M
M
"}
(5,1,1) = {"
M
M
M
M
M
M
M
M
G
G
G
G
a
a
G
G
G
G
G
G
M
M
M
M
M
M
M
M
M
M
"}
(6,1,1) = {"
M
M
M
M
M
G
G
G
G
G
G
a
a
a
a
a
a
G
G
G
G
M
M
M
M
M
M
M
M
M
"}
(7,1,1) = {"
M
M
M
M
G
G
G
G
G
G
a
a
a
a
a
a
G
G
G
G
G
M
M
M
M
M
M
M
M
M
"}
(8,1,1) = {"
M
M
M
G
G
k
k
k
k
G
a
a
a
a
a
a
G
G
G
G
G
G
M
M
M
M
M
M
M
M
"}
(9,1,1) = {"
M
M
G
G
k
k
k
k
k
G
G
G
G
G
G
G
G
G
G
G
G
G
G
M
M
M
M
M
M
M
"}
(10,1,1) = {"
M
M
G
k
k
k
k
k
G
G
G
G
G
G
G
G
G
G
G
a
G
G
G
M
M
M
M
M
M
M
"}
(11,1,1) = {"
M
M
G
k
k
k
G
G
F
F
F
F
F
F
G
G
G
G
a
a
G
G
G
G
M
M
M
M
M
M
"}
(12,1,1) = {"
M
M
G
G
k
G
G
F
F
F
F
F
F
F
F
G
G
G
G
a
a
G
G
G
M
M
M
M
M
M
"}
(13,1,1) = {"
M
M
G
k
k
G
F
F
O
F
Z
F
F
F
F
F
F
G
G
a
a
a
G
G
G
M
M
M
M
M
"}
(14,1,1) = {"
M
M
G
k
k
G
o
F
F
F
F
F
F
F
F
F
F
F
G
G
a
a
G
G
G
M
M
M
M
M
"}
(15,1,1) = {"
M
M
k
k
k
G
w
F
F
F
F
F
F
G
k
G
F
F
G
G
a
a
G
G
G
M
M
M
M
M
"}
(16,1,1) = {"
M
M
G
k
k
G
G
G
T
F
F
F
G
k
k
G
F
F
G
G
G
c
k
k
G
M
M
M
M
M
"}
(17,1,1) = {"
M
M
G
G
k
k
G
G
G
G
z
F
k
k
k
G
F
F
F
G
C
G
c
k
k
G
M
M
M
M
"}
(18,1,1) = {"
M
M
M
G
G
G
G
G
G
G
F
F
G
k
k
G
F
F
F
F
F
F
c
k
k
G
M
M
M
M
"}
(19,1,1) = {"
M
M
M
G
G
G
Z
F
F
F
Z
F
F
F
G
c
G
F
F
F
F
F
G
c
k
k
G
M
M
M
"}
(20,1,1) = {"
M
M
M
M
M
F
F
F
F
F
F
F
F
F
F
G
c
G
F
F
F
F
G
k
c
k
G
M
M
M
"}
(21,1,1) = {"
M
M
M
M
M
F
F
F
F
F
F
F
F
F
F
k
c
G
F
F
F
O
F
k
c
k
k
G
M
M
"}
(22,1,1) = {"
M
M
M
M
M
Z
F
F
F
F
F
F
F
F
F
F
c
T
F
F
F
Z
F
G
k
c
k
G
M
M
"}
(23,1,1) = {"
M
M
M
M
M
F
F
F
F
F
Z
F
F
F
Z
F
c
F
F
O
F
F
F
G
k
c
k
G
M
M
"}
(24,1,1) = {"
M
t
A
A
H
A
j
A
H
A
A
F
F
F
F
F
c
F
F
F
F
F
F
G
k
c
k
G
M
M
"}
(25,1,1) = {"
M
t
A
g
U
X
U
Y
d
I
A
Z
F
F
F
F
c
G
F
Z
F
F
e
G
k
c
k
G
M
M
"}
(26,1,1) = {"
M
t
S
K
U
g
U
U
f
N
H
F
F
F
F
k
c
G
F
F
F
F
F
G
k
c
k
G
M
M
"}
(27,1,1) = {"
M
A
J
s
P
U
U
x
r
N
H
F
F
F
F
G
c
F
F
F
F
F
F
G
k
c
k
G
M
M
"}
(28,1,1) = {"
M
t
S
n
P
n
U
P
r
N
H
F
F
F
G
c
c
F
z
F
F
F
F
G
k
c
k
G
M
M
"}
(29,1,1) = {"
M
t
A
V
P
n
P
u
v
W
A
F
Z
k
c
G
G
F
F
F
F
F
G
c
c
c
G
G
M
M
"}
(30,1,1) = {"
M
t
A
A
H
A
R
A
H
A
A
k
k
c
a
G
G
F
F
G
G
G
G
c
k
k
G
G
M
M
"}
(31,1,1) = {"
M
M
M
M
M
M
M
M
G
G
c
c
c
a
a
G
F
F
F
G
G
G
G
c
k
G
G
G
M
M
"}
(32,1,1) = {"
M
M
M
M
M
M
M
G
G
c
c
F
F
F
F
F
F
F
F
G
G
G
c
a
a
G
G
G
M
M
"}
(33,1,1) = {"
M
M
M
M
M
M
G
G
c
C
F
F
F
Z
F
F
F
F
G
G
G
a
c
a
k
G
G
M
M
M
"}
(34,1,1) = {"
M
M
M
M
M
G
G
c
w
F
O
F
F
F
F
F
F
F
a
a
a
a
c
k
k
G
G
M
M
M
"}
(35,1,1) = {"
M
M
M
M
M
G
c
m
h
F
F
F
F
Z
F
F
F
a
a
a
a
c
k
G
G
G
G
M
M
M
"}
(36,1,1) = {"
M
M
M
M
M
G
c
G
T
F
F
Z
F
F
F
G
G
a
a
a
c
k
G
G
G
G
M
M
M
M
"}
(37,1,1) = {"
M
M
M
M
M
M
G
c
c
F
F
F
F
a
a
a
a
c
c
c
k
G
G
G
G
M
M
M
M
M
"}
(38,1,1) = {"
M
M
M
M
M
M
M
M
G
c
c
c
c
a
a
a
a
c
k
G
G
G
M
M
M
M
M
M
M
M
"}
(39,1,1) = {"
M
M
M
M
M
M
M
M
M
M
G
G
G
c
c
c
c
G
G
M
M
M
M
M
M
M
M
M
M
M
"}
(40,1,1) = {"
M
M
M
M
M
M
M
M
M
M
M
M
M
M
M
M
M
M
M
M
M
M
M
M
M
M
M
M
M
M
"}
