//MAP CONVERTED BY dmm2tgm.py THIS HEADER COMMENT PREVENTS RECONVERSION, DO NOT REMOVE
"a" = (
/turf/simulated/floor/plating/asteroid/airless,
/area/ruin/space/unpowered)
"c" = (
/obj/structure/ore_box,
/turf/simulated/floor/plating/asteroid/airless,
/area/ruin/space/unpowered)
"d" = (
/obj/item/pickaxe/gold,
/obj/structure/rack,
/obj/item/t_scanner/adv_mining_scanner,
/obj/item/storage/bag/ore,
/turf/simulated/floor/plating/asteroid/airless,
/area/ruin/space/unpowered)
"g" = (
/turf/simulated/mineral/random/high_chance/space,
/area/ruin/space/unpowered)
"u" = (
/obj/item/flashlight/lantern,
/turf/simulated/floor/plating/asteroid/airless,
/area/ruin/space/unpowered)
"z" = (
/turf/template_noop,
/area/template_noop)
"D" = (
/turf/simulated/mineral,
/area/ruin/space/unpowered)
"K" = (
/obj/structure/spawner/mining/goliath/space,
/turf/simulated/floor/plating/asteroid/airless,
/area/ruin/space/unpowered)

(1,1,1) = {"
z
z
z
z
z
z
z
z
z
z
D
D
D
D
D
D
z
z
z
z
"}
(2,1,1) = {"
z
z
z
z
z
z
z
z
D
D
g
g
g
g
g
D
D
D
D
z
"}
(3,1,1) = {"
z
z
z
z
z
z
z
D
g
g
g
g
g
g
g
D
g
g
D
z
"}
(4,1,1) = {"
g
a
z
z
z
z
D
g
g
g
D
a
a
a
a
D
D
D
D
D
"}
(5,1,1) = {"
z
g
z
z
z
D
g
g
D
a
a
a
a
a
a
a
D
D
g
D
"}
(6,1,1) = {"
z
z
z
z
z
D
g
D
a
a
a
a
a
a
a
a
d
D
g
D
"}
(7,1,1) = {"
z
z
z
z
D
D
D
a
a
a
a
a
a
a
a
a
c
g
g
D
"}
(8,1,1) = {"
z
z
z
z
g
D
D
a
a
a
a
a
a
a
a
a
a
g
D
D
"}
(9,1,1) = {"
z
z
z
z
g
g
D
a
a
a
a
K
a
a
a
a
a
g
D
D
"}
(10,1,1) = {"
z
z
z
z
z
g
D
a
a
a
a
a
a
a
a
a
a
D
g
D
"}
(11,1,1) = {"
z
z
z
z
z
z
a
a
a
a
a
a
a
a
a
a
u
g
g
z
"}
(12,1,1) = {"
z
z
z
z
z
z
a
a
a
a
a
a
a
a
a
D
D
g
g
z
"}
(13,1,1) = {"
z
z
a
z
z
z
a
a
a
a
a
a
a
a
D
D
g
g
g
z
"}
(14,1,1) = {"
z
a
g
a
z
z
z
a
a
a
a
u
D
D
D
D
z
z
z
z
"}
(15,1,1) = {"
z
z
a
z
z
z
z
D
D
D
g
g
g
g
D
z
z
z
z
z
"}
(16,1,1) = {"
z
z
z
z
z
z
z
z
z
g
g
g
D
D
z
z
z
z
z
z
"}
(17,1,1) = {"
z
z
z
z
z
z
z
z
z
z
z
z
z
z
z
z
g
a
z
z
"}
(18,1,1) = {"
z
z
z
z
z
z
z
z
z
z
z
z
z
z
z
z
g
z
z
z
"}
(19,1,1) = {"
z
z
z
g
z
z
z
z
z
z
z
z
z
z
z
a
a
z
z
z
"}
(20,1,1) = {"
z
z
z
a
g
z
z
z
z
z
z
z
z
z
z
z
z
z
z
z
"}
