//MAP CONVERTED BY dmm2tgm.py THIS HEADER COMMENT PREVENTS RECONVERSION, DO NOT REMOVE
"a" = (
/turf/template_noop,
/area/template_noop)
"k" = (
/turf/simulated/floor/plating/asteroid/airless,
/area/ruin/space/unpowered)
"o" = (
/obj/effect/spawner/random/pool/spaceloot/syndicate/mixed,
/turf/simulated/floor/plating/asteroid/airless,
/area/ruin/space/unpowered)
"w" = (
/turf/simulated/mineral/random/high_chance/space,
/area/ruin/space/unpowered)
"z" = (
/mob/living/basic/carp,
/turf/template_noop,
/area/template_noop)
"B" = (
/turf/simulated/mineral,
/area/ruin/space/unpowered)

(1,1,1) = {"
a
a
a
a
a
a
a
a
a
a
a
a
a
a
a
a
a
a
a
a
"}
(2,1,1) = {"
a
a
a
z
a
a
a
a
a
a
a
a
a
k
k
k
k
a
a
a
"}
(3,1,1) = {"
a
k
k
a
a
a
a
a
a
a
a
a
a
a
a
k
k
a
a
a
"}
(4,1,1) = {"
z
k
a
a
a
a
a
a
a
a
a
a
a
a
a
a
k
a
a
a
"}
(5,1,1) = {"
a
a
a
a
k
k
k
k
k
k
a
a
a
k
k
a
a
a
a
a
"}
(6,1,1) = {"
a
a
z
k
k
w
B
k
k
k
k
a
k
k
k
k
a
a
a
a
"}
(7,1,1) = {"
a
a
k
k
w
w
w
k
B
B
B
k
k
w
w
k
a
a
z
a
"}
(8,1,1) = {"
a
a
k
k
B
B
B
B
w
B
B
B
B
B
B
k
k
a
a
a
"}
(9,1,1) = {"
a
a
a
k
k
B
B
w
w
B
B
B
w
w
B
B
k
k
a
a
"}
(10,1,1) = {"
a
a
a
a
k
B
w
w
B
B
o
B
B
w
B
B
k
k
a
a
"}
(11,1,1) = {"
a
a
a
k
k
w
B
B
B
B
B
B
w
w
B
B
k
k
a
a
"}
(12,1,1) = {"
a
a
a
k
k
w
B
B
w
w
B
w
w
B
B
B
B
k
k
a
"}
(13,1,1) = {"
a
a
a
k
k
k
k
k
B
w
w
w
B
B
o
w
w
k
k
a
"}
(14,1,1) = {"
a
a
a
a
k
k
a
k
k
B
B
B
B
B
B
w
B
k
k
a
"}
(15,1,1) = {"
a
a
k
a
a
a
a
a
k
k
k
k
B
B
B
B
k
k
a
a
"}
(16,1,1) = {"
a
a
k
k
a
a
a
a
a
a
a
k
k
k
k
k
k
a
a
a
"}
(17,1,1) = {"
a
a
k
k
k
a
a
a
a
a
a
k
k
k
a
a
a
a
k
a
"}
(18,1,1) = {"
a
a
a
a
a
a
a
a
a
a
a
a
a
a
a
a
a
a
a
a
"}
(19,1,1) = {"
a
a
a
a
a
a
a
a
z
a
a
a
k
a
a
a
a
a
a
a
"}
(20,1,1) = {"
a
a
a
a
a
a
a
a
a
a
a
a
a
a
a
a
a
a
a
a
"}
