//MAP CONVERTED BY dmm2tgm.py THIS HEADER COMMENT PREVENTS RECONVERSION, DO NOT REMOVE
"a" = (
/turf/space,
/area/space)
"b" = (
/obj/structure/chair/comfy/shuttle,
/obj/effect/decal/cleanable/dirt,
/turf/simulated/floor/engine,
/area/ruin/powered)
"c" = (
/obj/structure/chair/comfy/shuttle,
/obj/effect/spawner/random/cobweb/right,
/turf/simulated/floor/plasteel,
/area/ruin/powered)
"d" = (
/obj/structure/chair/comfy/shuttle,
/turf/simulated/floor/plasteel,
/area/ruin/powered)
"e" = (
/obj/machinery/door/airlock/titanium,
/obj/effect/decal/cleanable/dirt,
/turf/simulated/floor/plasteel,
/area/ruin/powered)
"g" = (
/obj/machinery/computer/nonfunctional{
	dir = 1
	},
/turf/simulated/floor/plasteel,
/area/ruin/powered)
"h" = (
/obj/structure/chair/comfy/shuttle,
/obj/effect/mob_spawn/human/corpse/vox_miner,
/turf/simulated/floor/engine,
/area/ruin/powered)
"j" = (
/obj/structure/shuttle/engine/router,
/obj/structure/window/plasmareinforced,
/turf/simulated/floor/engine,
/area/ruin/powered)
"l" = (
/obj/structure/chair/comfy/shuttle{
	dir = 1
	},
/turf/simulated/floor/plasteel,
/area/ruin/powered)
"n" = (
/obj/structure/chair/comfy/shuttle{
	dir = 1
	},
/turf/simulated/floor/engine,
/area/ruin/powered)
"o" = (
/obj/effect/spawner/random/pool/spaceloot/syndicate/mixed,
/turf/simulated/floor/plating/asteroid/airless,
/area/ruin)
"p" = (
/turf/simulated/floor/plating/asteroid/airless,
/area/ruin)
"q" = (
/mob/living/basic/vox_miner,
/turf/simulated/floor/plating/asteroid/airless,
/area/ruin)
"t" = (
/obj/structure/closet/crate,
/obj/effect/spawner/random/pool/spaceloot/syndicate/mixed,
/obj/effect/spawner/random/trash,
/obj/effect/spawner/random/trash,
/obj/effect/spawner/random/trash,
/obj/effect/spawner/random/trash,
/obj/effect/spawner/random/trash,
/obj/effect/spawner/random/bluespace_tap/clothes_uncommon,
/obj/effect/spawner/random/bluespace_tap/clothes_uncommon,
/obj/effect/spawner/random/bluespace_tap/food_uncommon,
/obj/effect/spawner/random/bluespace_tap/food_uncommon,
/obj/effect/spawner/random/bluespace_tap/food_uncommon,
/obj/effect/spawner/random/engineering/toolbox,
/turf/simulated/floor/engine,
/area/ruin/powered)
"u" = (
/mob/living/basic/vox_miner/foreman,
/turf/simulated/floor/plating/asteroid/airless,
/area/ruin)
"w" = (
/obj/effect/decal/cleanable/dirt,
/obj/machinery/computer/nonfunctional,
/turf/simulated/floor/plasteel,
/area/ruin/powered)
"x" = (
/obj/structure/closet/crate/miningcar{
	name = "mining car"
	},
/obj/effect/spawner/random/common_ore,
/turf/simulated/floor/plating/asteroid/airless,
/area/ruin)
"y" = (
/obj/structure/table/reinforced,
/turf/simulated/floor/plasteel,
/area/ruin/powered)
"z" = (
/turf/simulated/mineral/random/high_chance/space,
/area/ruin)
"B" = (
/obj/structure/shuttle/engine/propulsion{
	dir = 1
	},
/turf/simulated/floor/plating,
/area/ruin/powered)
"C" = (
/obj/effect/spawner/random/loot_crate,
/turf/simulated/floor/plating/asteroid/airless,
/area/ruin)
"D" = (
/obj/structure/flora/ash/rock/style_random,
/turf/simulated/floor/plating/asteroid/airless,
/area/ruin)
"E" = (
/obj/effect/decal/cleanable/dirt,
/turf/simulated/floor/engine,
/area/ruin/powered)
"F" = (
/obj/structure/closet/crate/miningcar{
	name = "mining car"
	},
/obj/effect/spawner/random/uncommon_ore,
/turf/simulated/floor/plating/asteroid/airless,
/area/ruin)
"G" = (
/obj/structure/shuttle/engine/heater{
	dir = 1
	},
/obj/structure/window/plasmareinforced,
/turf/simulated/floor/engine,
/area/ruin/powered)
"H" = (
/obj/structure/table/reinforced,
/turf/simulated/floor/engine,
/area/ruin/powered)
"I" = (
/obj/effect/decal/cleanable/blood/vox,
/turf/simulated/floor/plating/asteroid/airless,
/area/ruin)
"J" = (
/turf/simulated/mineral/random/space,
/area/ruin)
"K" = (
/turf/simulated/mineral/random/low_chance/space,
/area/ruin)
"M" = (
/obj/structure/ore_box,
/turf/simulated/floor/plating/asteroid/airless,
/area/ruin)
"N" = (
/obj/structure/closet/crate/miningcar{
	name = "mining car"
	},
/obj/effect/spawner/random/rare_ore,
/turf/simulated/floor/plating/asteroid/airless,
/area/ruin)
"O" = (
/turf/simulated/wall/mineral/titanium,
/area/ruin/powered)
"Q" = (
/obj/structure/chair/comfy/shuttle,
/obj/effect/decal/cleanable/dirt,
/turf/simulated/floor/plasteel,
/area/ruin/powered)
"R" = (
/obj/machinery/door/airlock/titanium,
/turf/simulated/floor/plasteel,
/area/ruin/powered)
"S" = (
/obj/effect/decal/cleanable/dirt,
/turf/simulated/floor/plasteel,
/area/ruin/powered)
"U" = (
/obj/effect/spawner/window/shuttle,
/turf/simulated/floor/plating,
/area/ruin/powered)
"V" = (
/obj/machinery/economy/vending/wallmed/directional/west,
/obj/structure/chair/comfy/shuttle,
/turf/simulated/floor/engine,
/area/ruin/powered)
"W" = (
/obj/effect/decal/cleanable/dirt,
/obj/effect/decal/cleanable/dirt,
/turf/simulated/floor/engine,
/area/ruin/powered)
"Y" = (
/obj/effect/decal/cleanable/dirt,
/obj/machinery/computer/nonfunctional,
/turf/simulated/floor/engine,
/area/ruin/powered)
"Z" = (
/obj/structure/chair/comfy/shuttle,
/turf/simulated/floor/engine,
/area/ruin/powered)

(1,1,1) = {"
a
a
a
a
a
a
a
a
a
a
a
a
a
a
a
a
a
a
a
a
a
a
a
a
a
a
a
a
a
a
"}
(2,1,1) = {"
a
a
a
a
a
a
a
a
a
a
a
a
a
a
a
a
a
a
a
a
a
a
a
a
a
a
a
a
a
a
"}
(3,1,1) = {"
a
a
a
a
a
a
a
a
a
a
a
a
a
J
J
J
J
J
a
a
a
a
a
a
a
a
a
a
a
a
"}
(4,1,1) = {"
a
a
a
a
a
a
a
a
a
J
J
J
J
J
J
J
J
J
J
a
a
a
a
a
a
a
a
a
a
a
"}
(5,1,1) = {"
a
a
a
a
a
a
a
a
J
J
J
J
z
z
J
J
J
J
J
J
a
a
a
a
a
a
a
a
a
a
"}
(6,1,1) = {"
a
a
a
a
a
J
J
J
J
J
J
z
z
z
z
z
z
J
J
J
J
a
a
a
a
a
a
a
a
a
"}
(7,1,1) = {"
a
a
a
a
J
J
J
J
J
J
z
z
z
z
z
z
J
J
J
J
J
a
a
a
a
a
a
a
a
a
"}
(8,1,1) = {"
a
a
a
J
J
K
K
K
K
J
z
z
z
z
z
z
J
J
J
J
J
J
a
a
a
a
a
a
a
a
"}
(9,1,1) = {"
a
a
J
J
K
K
K
K
K
J
J
J
J
J
J
J
J
J
J
J
J
J
J
a
a
a
a
a
a
a
"}
(10,1,1) = {"
a
a
J
K
K
K
K
K
J
J
J
J
J
J
J
J
J
J
J
z
J
J
J
a
a
a
a
a
a
a
"}
(11,1,1) = {"
a
a
J
K
K
K
J
J
p
p
q
p
p
p
J
J
J
J
z
z
J
J
J
J
a
a
a
a
a
a
"}
(12,1,1) = {"
a
a
J
J
K
J
J
p
p
p
p
p
p
p
p
J
J
J
J
z
z
J
J
J
a
a
a
a
a
a
"}
(13,1,1) = {"
a
a
J
K
K
J
p
p
q
p
D
p
p
p
p
p
p
J
J
z
z
z
J
J
J
a
a
a
a
a
"}
(14,1,1) = {"
a
a
J
K
K
J
x
p
p
p
p
p
p
p
p
p
p
p
J
J
z
z
J
J
J
a
a
a
a
a
"}
(15,1,1) = {"
a
a
K
K
K
J
o
p
p
p
p
p
p
J
K
J
p
p
J
J
z
z
J
J
J
a
a
a
a
a
"}
(16,1,1) = {"
a
a
J
K
K
J
J
J
M
p
p
p
J
K
K
J
p
p
J
J
J
J
K
K
J
a
a
a
a
a
"}
(17,1,1) = {"
a
a
J
J
K
K
J
J
J
J
I
p
K
K
K
J
p
p
p
J
C
J
J
K
K
J
a
a
a
a
"}
(18,1,1) = {"
a
a
a
J
J
J
J
J
J
J
p
p
J
K
K
J
p
p
p
p
p
p
J
K
K
J
a
a
a
a
"}
(19,1,1) = {"
a
a
a
J
J
J
D
p
p
p
D
p
p
p
J
J
J
p
p
p
p
p
J
K
K
K
J
a
a
a
"}
(20,1,1) = {"
a
a
a
a
a
p
p
p
p
p
p
p
p
p
p
J
J
J
p
p
p
p
J
K
K
K
J
a
a
a
"}
(21,1,1) = {"
a
a
a
a
a
p
p
p
p
p
p
p
p
p
p
K
K
J
p
p
p
q
p
K
K
K
K
J
a
a
"}
(22,1,1) = {"
a
a
a
a
a
D
p
p
p
p
p
p
p
p
p
p
K
M
p
p
p
D
p
J
K
K
K
J
a
a
"}
(23,1,1) = {"
a
a
a
a
a
p
p
p
p
p
p
p
p
p
D
p
K
p
p
q
p
p
q
J
K
K
K
J
a
a
"}
(24,1,1) = {"
a
B
O
O
U
O
e
O
U
O
D
p
p
p
p
p
K
p
p
p
p
p
p
J
K
K
K
J
a
a
"}
(25,1,1) = {"
a
B
O
Z
E
V
E
Y
n
H
O
D
p
p
p
p
K
J
p
D
p
p
F
J
K
K
K
J
a
a
"}
(26,1,1) = {"
a
B
G
h
E
Z
E
E
b
g
U
p
p
p
p
K
J
J
p
p
p
p
p
J
K
K
K
J
a
a
"}
(27,1,1) = {"
a
O
j
t
S
E
E
W
Q
g
U
p
p
p
p
J
J
C
p
p
p
p
p
J
K
K
K
J
a
a
"}
(28,1,1) = {"
a
B
G
d
S
d
E
S
Q
g
U
p
p
p
J
J
J
p
I
p
p
p
p
J
K
K
K
J
a
a
"}
(29,1,1) = {"
a
B
O
c
S
d
S
w
l
y
O
p
D
K
J
J
J
p
p
p
p
p
J
J
K
K
J
J
a
a
"}
(30,1,1) = {"
a
B
O
O
U
O
R
O
U
O
p
K
K
K
z
J
J
p
p
J
J
J
J
J
K
K
J
J
a
a
"}
(31,1,1) = {"
a
a
a
a
a
a
a
a
J
J
K
K
z
z
z
J
p
p
p
J
J
J
J
J
K
J
J
J
a
a
"}
(32,1,1) = {"
a
a
a
a
a
a
a
J
J
J
J
p
p
p
p
p
p
p
p
J
J
J
z
z
z
J
J
J
a
a
"}
(33,1,1) = {"
a
a
a
a
a
a
J
J
J
p
p
p
p
D
p
p
p
p
J
J
J
z
z
z
K
J
J
a
a
a
"}
(34,1,1) = {"
a
a
a
a
a
J
J
J
o
p
q
p
p
p
p
p
p
p
z
z
z
z
z
K
K
J
J
a
a
a
"}
(35,1,1) = {"
a
a
a
a
a
J
J
N
u
p
p
p
p
D
p
p
p
z
z
z
z
z
K
J
J
J
J
a
a
a
"}
(36,1,1) = {"
a
a
a
a
a
J
J
J
M
p
p
D
p
p
p
J
J
z
z
z
K
K
J
J
J
J
a
a
a
a
"}
(37,1,1) = {"
a
a
a
a
a
a
J
J
J
p
p
p
p
z
z
z
z
K
K
K
K
J
J
J
J
a
a
a
a
a
"}
(38,1,1) = {"
a
a
a
a
a
a
a
a
J
J
J
J
J
z
z
z
z
K
K
J
J
J
a
a
a
a
a
a
a
a
"}
(39,1,1) = {"
a
a
a
a
a
a
a
a
a
a
J
J
J
J
J
J
J
J
J
a
a
a
a
a
a
a
a
a
a
a
"}
(40,1,1) = {"
a
a
a
a
a
a
a
a
a
a
a
a
a
a
a
a
a
a
a
a
a
a
a
a
a
a
a
a
a
a
"}
