//MAP CONVERTED BY dmm2tgm.py THIS HEADER COMMENT PREVENTS RECONVERSION, DO NOT REMOVE
"a" = (
/turf/simulated/mineral,
/area/space)
"d" = (
/turf/simulated/mineral/random/low_chance/space,
/area/ruin/space/unpowered)
"f" = (
/obj/effect/spawner/random/pool/spaceloot/syndicate/mixed,
/turf/simulated/floor/plating/asteroid/airless,
/area/ruin/space/unpowered)
"h" = (
/turf/simulated/mineral/random/high_chance/space,
/area/ruin/space/unpowered)
"n" = (
/turf/simulated/mineral/random/low_chance,
/area/ruin/space/unpowered)
"o" = (
/turf/space,
/area/ruin/space/unpowered)
"s" = (
/obj/structure/spawner/mining/hivelord/space,
/turf/simulated/floor/plating/asteroid,
/area/ruin/space/unpowered)
"w" = (
/mob/living/basic/mining/basilisk/space,
/turf/simulated/floor/plating/asteroid/airless,
/area/ruin/space/unpowered)
"y" = (
/turf/simulated/floor/plating/asteroid/airless,
/area/ruin/space/unpowered)
"A" = (
/obj/effect/spawner/random/pool/spaceloot/syndicate/mixed,
/turf/simulated/floor/plating/asteroid,
/area/ruin/space/unpowered)
"E" = (
/obj/structure/spawner/mining/basilisk/space,
/turf/simulated/floor/plating/asteroid/airless,
/area/ruin/space/unpowered)
"L" = (
/turf/simulated/mineral,
/area/ruin/space/unpowered)
"Q" = (
/turf/space,
/area/space)
"V" = (
/turf/simulated/floor/plating/asteroid,
/area/ruin/space/unpowered)
"Y" = (
/turf/simulated/mineral/random/space,
/area/ruin/space/unpowered)

(1,1,1) = {"
Q
Q
Q
Q
Q
Q
Q
Q
Q
Q
Q
Q
Q
Q
Q
Q
Q
Q
Q
Q
Q
Q
Q
Q
Q
Q
Q
Q
Q
Q
Q
Q
Q
Q
Q
Q
Q
Q
Q
Q
"}
(2,1,1) = {"
Q
Q
y
y
L
L
L
L
L
L
L
L
L
L
L
y
y
y
y
Q
Q
Q
Q
Q
Q
Q
Q
Q
Q
Q
Q
Q
Q
Q
Q
Q
Q
Q
Q
Q
"}
(3,1,1) = {"
Q
Q
y
y
L
d
d
d
L
L
L
L
L
L
L
L
L
L
y
y
y
Q
Q
Q
Q
Q
Q
Q
Q
Q
Q
Q
Q
Q
Q
Q
Q
Q
Q
Q
"}
(4,1,1) = {"
Q
Q
y
y
L
L
d
d
d
d
d
d
d
d
d
L
L
L
y
y
y
y
Q
Q
Q
Q
L
L
Q
Q
Q
Q
Q
Q
Q
Q
Q
Q
Q
Q
"}
(5,1,1) = {"
Q
Q
y
y
y
L
L
L
L
L
L
L
L
d
d
d
L
L
y
Q
Q
Q
Q
Q
Q
L
n
n
L
Q
Q
Q
Q
Q
Q
Q
Q
Q
Q
Q
"}
(6,1,1) = {"
Q
y
y
y
y
y
L
L
L
L
L
L
L
L
L
L
L
y
Q
Q
Q
Q
Q
L
L
n
n
n
L
L
y
y
y
y
y
y
y
Q
Q
Q
"}
(7,1,1) = {"
Q
y
y
y
y
y
y
y
y
y
y
y
y
y
y
y
y
y
Q
V
V
V
L
n
n
n
n
Y
d
d
L
y
y
y
y
L
L
L
Q
Q
"}
(8,1,1) = {"
Q
V
V
V
V
V
V
V
V
V
Q
Q
Q
Q
Q
Q
Q
V
V
V
L
L
n
n
n
n
Y
d
d
d
d
L
L
L
L
L
d
L
Q
Q
"}
(9,1,1) = {"
V
V
L
L
L
L
L
L
L
V
V
V
o
o
o
o
V
V
V
L
n
n
n
n
n
Y
Y
Y
d
d
d
d
d
d
d
d
d
L
L
Q
"}
(10,1,1) = {"
V
L
n
n
n
n
n
n
L
L
L
V
V
o
o
V
V
V
L
n
n
n
n
Y
Y
Y
Y
Y
d
d
d
d
d
d
d
d
n
n
L
Q
"}
(11,1,1) = {"
V
L
n
n
n
n
n
n
n
n
n
L
V
A
V
V
L
L
L
n
n
Y
Y
Y
h
h
h
h
h
Y
Y
Y
Y
Y
Y
Y
n
n
L
Q
"}
(12,1,1) = {"
V
L
n
n
n
h
h
h
n
n
n
n
L
L
L
L
n
n
n
n
n
Y
Y
h
h
h
h
h
h
h
h
Y
Y
Y
Y
Y
n
n
L
Q
"}
(13,1,1) = {"
V
V
L
L
n
n
n
h
h
L
n
n
L
n
n
n
n
n
n
Y
Y
Y
h
h
h
h
h
h
h
h
h
h
h
Y
Y
Y
n
n
L
Q
"}
(14,1,1) = {"
Q
V
V
L
L
n
n
n
h
Y
Y
n
n
n
n
n
n
n
Y
Y
Y
h
h
h
y
y
y
y
y
h
h
h
h
Y
Y
h
n
n
L
Q
"}
(15,1,1) = {"
Q
Q
V
V
L
L
n
n
n
n
n
Y
Y
Y
Y
Y
Y
Y
Y
Y
Y
h
h
y
h
h
h
h
h
y
y
h
h
Y
Y
h
n
n
Y
L
"}
(16,1,1) = {"
Q
Q
Q
V
V
L
L
n
n
n
n
n
Y
Y
Y
Y
Y
Y
h
h
h
h
h
y
h
y
y
y
y
E
y
h
h
Y
Y
h
n
n
n
L
"}
(17,1,1) = {"
Q
Q
Q
Q
V
V
V
L
Y
n
n
n
Y
Y
Y
Y
Y
h
h
h
h
h
y
E
y
y
y
w
y
y
y
h
h
Y
Y
h
n
n
Y
L
"}
(18,1,1) = {"
Q
Q
Q
Q
Q
Q
V
s
L
n
n
n
n
Y
Y
Y
h
h
h
y
y
y
y
y
y
f
y
y
y
y
y
h
h
Y
Y
Y
n
n
L
Q
"}
(19,1,1) = {"
Q
Q
Q
Q
Q
Q
V
V
V
L
L
n
n
n
Y
Y
h
h
y
y
w
y
y
y
y
y
y
y
y
y
y
h
h
Y
Y
Y
n
n
L
Q
"}
(20,1,1) = {"
Q
Q
Q
Q
Q
Q
Q
V
V
V
L
n
n
n
Y
h
h
h
y
E
y
y
y
y
y
y
y
y
y
y
y
h
h
Y
Y
Y
n
n
L
Q
"}
(21,1,1) = {"
Q
Q
Q
Q
Q
Q
Q
Q
V
V
L
L
n
n
Y
h
h
y
y
y
y
h
y
y
w
h
y
y
y
h
h
h
h
Y
Y
Y
n
n
L
Q
"}
(22,1,1) = {"
Q
Q
Q
Q
Q
Q
Q
Q
V
V
V
L
n
n
Y
h
h
y
h
y
y
h
h
y
y
h
y
h
h
h
h
h
Y
Y
Y
Y
n
n
L
Q
"}
(23,1,1) = {"
Q
Q
Q
Q
Q
Q
Q
Q
V
V
V
L
n
n
Y
h
h
y
h
y
y
h
h
y
y
h
y
h
h
h
Y
Y
Y
d
d
d
n
n
L
Q
"}
(24,1,1) = {"
Q
Q
Q
Q
Q
Q
Q
Q
V
V
V
L
n
n
Y
h
h
y
h
y
y
h
h
y
y
y
y
h
h
Y
Y
d
d
d
d
d
d
d
L
Q
"}
(25,1,1) = {"
Q
Q
Q
Q
Q
Q
Q
V
V
V
s
L
n
n
Y
h
h
y
y
y
y
h
y
E
y
y
h
h
h
Y
d
d
d
L
L
L
L
L
y
Q
"}
(26,1,1) = {"
Q
Q
Q
Q
Q
Q
Q
V
V
V
L
n
n
n
Y
Y
h
h
y
E
y
y
w
y
y
h
h
h
Y
Y
d
d
L
L
y
y
y
y
y
Q
"}
(27,1,1) = {"
Q
Q
Q
Q
Q
Q
Q
V
V
L
n
n
n
L
Y
Y
h
h
h
y
y
y
y
y
y
h
h
h
Y
Y
d
d
L
y
y
Q
Q
Q
Q
Q
"}
(28,1,1) = {"
Q
Q
Q
Q
Q
Q
Q
L
L
n
n
Y
L
L
Y
Y
Y
h
h
h
y
h
h
y
y
h
h
Y
Y
Y
d
n
L
y
Q
Q
Q
Q
Q
Q
"}
(29,1,1) = {"
Q
Q
Q
Q
Q
L
L
n
n
Y
Y
Y
L
Y
Y
Y
Y
Y
h
h
h
y
y
y
h
h
h
Y
Y
Y
n
n
L
y
Q
Q
Q
Q
Q
Q
"}
(30,1,1) = {"
Q
Q
Q
L
L
n
n
n
Y
d
d
Y
L
Y
Y
Y
Y
Y
h
h
h
h
h
h
h
h
Y
Y
Y
n
n
L
y
Q
Q
Q
y
Q
Q
Q
"}
(31,1,1) = {"
Q
Q
L
Y
n
n
Y
Y
d
d
d
d
d
Y
Y
Y
Y
Y
Y
h
h
h
h
h
h
h
Y
n
n
n
L
y
Q
Q
Q
y
y
y
Q
Q
"}
(32,1,1) = {"
Q
L
Y
n
n
Y
d
d
L
L
L
d
d
Y
Y
Y
Y
Y
Y
Y
Y
Y
Y
Y
Y
Y
n
n
Y
L
y
Q
Q
Q
L
L
L
Q
Q
Q
"}
(33,1,1) = {"
L
n
n
n
Y
h
d
d
L
f
y
L
n
n
n
Y
Y
Y
Y
Y
Y
Y
Y
Y
Y
Y
n
n
L
y
y
y
L
L
L
L
L
L
Q
Q
"}
(34,1,1) = {"
L
n
Y
Y
h
d
d
n
L
y
y
L
n
n
n
n
n
n
Y
Y
Y
Y
Y
Y
Y
Y
n
n
L
y
y
y
L
L
L
L
L
L
Q
Q
"}
(35,1,1) = {"
L
n
n
n
n
n
n
n
L
y
y
y
L
L
Y
n
n
n
n
Y
Y
Y
h
h
h
Y
n
n
L
y
y
y
L
L
L
L
L
L
Q
Q
"}
(36,1,1) = {"
L
L
Y
n
n
n
Y
L
L
y
Q
y
y
L
L
Y
n
n
n
n
Y
Y
Y
Y
h
Y
n
n
n
L
y
E
L
L
L
L
L
Q
Q
Q
"}
(37,1,1) = {"
Q
a
Y
n
n
n
L
L
y
y
Q
Q
y
y
L
L
n
n
n
n
n
n
Y
h
h
Y
n
n
n
L
y
y
L
L
L
L
L
Q
Q
Q
"}
(38,1,1) = {"
Q
Q
L
L
L
L
y
y
y
Q
Q
Q
Q
y
y
L
L
L
n
n
n
n
n
n
Y
Y
n
n
n
L
y
y
y
L
L
L
Q
Q
Q
Q
"}
(39,1,1) = {"
Q
Q
Q
Q
Q
Q
Q
Q
Q
Q
Q
Q
Q
Q
y
y
y
L
L
L
L
n
n
n
n
n
n
n
n
L
y
y
y
y
L
Q
Q
Q
Q
Q
"}
(40,1,1) = {"
Q
Q
Q
Q
Q
Q
Q
Q
Q
Q
Q
Q
Q
Q
Q
Q
Q
Q
Q
Q
L
L
L
L
L
L
L
L
L
Q
Q
Q
Q
Q
Q
Q
Q
Q
Q
Q
"}
