//MAP CONVERTED BY dmm2tgm.py THIS HEADER COMMENT PREVENTS RECONVERSION, DO NOT REMOVE
"ab" = (
/obj/structure/computerframe,
/obj/effect/turf_decal/stripes/line{
	dir = 5
	},
/turf/simulated/floor/plasteel,
/area/ruin/space/tcommsat)
"ad" = (
/obj/effect/turf_decal/stripes/line{
	dir = 10
	},
/obj/structure/closet/emcloset,
/turf/simulated/floor/plasteel,
/area/ruin/space/tcommsat)
"al" = (
/obj/structure/lattice,
/turf/template_noop,
/area/ruin/space/tcommsat)
"au" = (
/obj/structure/disposalpipe/segment{
	dir = 4
	},
/obj/structure/kitchenspike,
/obj/effect/decal/cleanable/blood,
/turf/simulated/floor/plating/airless,
/area/ruin/space/tcommsat)
"ax" = (
/turf/simulated/mineral/volcanic,
/area/space/nearstation)
"bc" = (
/obj/structure/bed,
/turf/simulated/floor/plating/airless,
/area/ruin/space/tcommsat)
"bg" = (
/obj/effect/turf_decal/stripes/corner{
	dir = 4
	},
/turf/simulated/floor/plasteel,
/area/ruin/space/tcommsat)
"bx" = (
/obj/machinery/disposal,
/obj/structure/disposalpipe/trunk{
	dir = 4
	},
/turf/simulated/floor/plating/airless,
/area/ruin/space/tcommsat)
"cM" = (
/obj/effect/decal/cleanable/blood/writing{
	dir = 8
	},
/turf/simulated/floor/plating/airless,
/area/ruin/space/tcommsat)
"dM" = (
/obj/machinery/economy/vending/cola{
	tilted = 1
	},
/turf/simulated/floor/plating/airless,
/area/ruin/space/tcommsat)
"eu" = (
/obj/effect/turf_decal/stripes/line{
	dir = 1
	},
/turf/simulated/floor/plasteel,
/area/ruin/space/tcommsat)
"eM" = (
/obj/structure/window/reinforced{
	dir = 8
	},
/obj/structure/window/reinforced,
/obj/effect/decal/cleanable/dirt,
/turf/simulated/floor/plating/airless,
/area/ruin/space/tcommsat)
"fh" = (
/obj/structure/window/reinforced{
	dir = 1
	},
/obj/structure/window/reinforced{
	dir = 4
	},
/turf/simulated/floor/plating/airless,
/area/ruin/space/tcommsat)
"fD" = (
/obj/effect/decal/remains/human,
/turf/simulated/floor/plating/airless,
/area/ruin/space/tcommsat)
"fI" = (
/obj/structure/window/reinforced{
	dir = 1
	},
/obj/effect/decal/cleanable/dirt,
/turf/simulated/floor/plating/airless,
/area/ruin/space/tcommsat)
"fS" = (
/obj/structure/rack,
/turf/simulated/floor/plasteel/airless{
	icon_state = "dark"
	},
/area/ruin/space/tcommsat)
"gg" = (
/obj/structure/chair{
	dir = 8
	},
/obj/effect/decal/cleanable/blood,
/turf/simulated/floor/plating/airless,
/area/ruin/space/tcommsat)
"hg" = (
/obj/item/camera_assembly,
/turf/simulated/floor/plating/airless,
/area/ruin/space/tcommsat)
"hk" = (
/obj/structure/disposalpipe/segment{
	dir = 4
	},
/obj/effect/decal/cleanable/blood/writing{
	dir = 9
	},
/turf/simulated/floor/plating/airless,
/area/ruin/space/tcommsat)
"hO" = (
/obj/structure/window/reinforced{
	dir = 1
	},
/obj/structure/window/reinforced{
	dir = 4
	},
/turf/template_noop,
/area/template_noop)
"hQ" = (
/obj/effect/decal/cleanable/dirt,
/obj/structure/table,
/obj/item/stack/tape_roll,
/turf/simulated/floor/plating/airless,
/area/ruin/space/tcommsat)
"ii" = (
/obj/structure/disposalpipe/segment{
	dir = 4
	},
/turf/simulated/floor/plating/airless,
/area/ruin/space/tcommsat)
"jd" = (
/obj/machinery/light/small{
	dir = 8
	},
/obj/effect/decal/cleanable/dirt,
/turf/simulated/floor/plasteel,
/area/ruin/space/tcommsat)
"jk" = (
/obj/structure/door_assembly/door_assembly_hatch,
/obj/item/airlock_electronics,
/turf/simulated/floor/plating/airless,
/area/ruin/space/tcommsat)
"jv" = (
/obj/structure/table,
/obj/item/reagent_containers/syringe/lethal{
	pixel_y = 4
	},
/turf/simulated/floor/plating/airless,
/area/ruin/space/tcommsat)
"kc" = (
/obj/structure/disposalpipe/segment{
	dir = 4
	},
/turf/simulated/wall/r_wall,
/area/ruin/space/tcommsat)
"ko" = (
/obj/structure/chair,
/turf/simulated/floor/plating/airless,
/area/ruin/space/tcommsat)
"kx" = (
/obj/structure/lattice,
/obj/structure/grille,
/obj/structure/grille,
/turf/template_noop,
/area/space/nearstation)
"kP" = (
/obj/effect/turf_decal/stripes/line{
	dir = 8
	},
/turf/simulated/floor/plasteel,
/area/ruin/space/tcommsat)
"le" = (
/obj/structure/rack,
/obj/item/storage/toolbox/syndicate,
/turf/simulated/floor/plasteel/airless{
	icon_state = "dark"
	},
/area/ruin/space/tcommsat)
"lk" = (
/obj/structure/window/reinforced{
	dir = 1
	},
/turf/template_noop,
/area/template_noop)
"lo" = (
/obj/structure/closet/crate,
/obj/item/clothing/glasses/night,
/turf/simulated/floor/plasteel{
	icon_state = "dark"
	},
/area/ruin/space/tcommsat)
"my" = (
/obj/structure/window/reinforced{
	dir = 4
	},
/obj/structure/window/reinforced{
	dir = 1
	},
/turf/template_noop,
/area/template_noop)
"mL" = (
/turf/simulated/floor/plasteel,
/area/ruin/space/tcommsat)
"nk" = (
/obj/structure/rack,
/obj/item/wirerod,
/turf/simulated/floor/plasteel{
	icon_state = "dark"
	},
/area/ruin/space/tcommsat)
"nv" = (
/obj/effect/turf_decal/stripes/corner{
	dir = 8
	},
/turf/simulated/floor/plasteel,
/area/ruin/space/tcommsat)
"nG" = (
/obj/structure/window/reinforced{
	dir = 4
	},
/obj/structure/window/reinforced{
	dir = 1
	},
/turf/template_noop,
/area/space/nearstation)
"nX" = (
/turf/template_noop,
/area/template_noop)
"oh" = (
/obj/structure/table,
/obj/item/taperecorder,
/turf/simulated/floor/plating/airless,
/area/ruin/space/tcommsat)
"ok" = (
/obj/item/gps/ruin{
	gpstag = "Faint Radio Signal"
	},
/turf/simulated/wall/r_wall,
/area/ruin/space/tcommsat)
"ot" = (
/obj/effect/spawner/random_spawners/wall_rusted_always,
/turf/simulated/wall/r_wall,
/area/ruin/space/tcommsat)
"oZ" = (
/obj/structure/rack,
/obj/item/circuitboard/teleporter,
/turf/simulated/floor/plasteel/airless{
	icon_state = "dark"
	},
/area/ruin/space/tcommsat)
"pg" = (
/obj/machinery/economy/vending/snack,
/turf/simulated/floor/plating/airless,
/area/ruin/space/tcommsat)
"pt" = (
/obj/structure/window/reinforced{
	dir = 4
	},
/obj/structure/window/reinforced,
/turf/template_noop,
/area/space/nearstation)
"qA" = (
/obj/structure/window/reinforced,
/obj/structure/window/reinforced{
	dir = 1
	},
/turf/simulated/floor/plating/airless,
/area/ruin/space/tcommsat)
"qT" = (
/obj/structure/lattice,
/turf/simulated/mineral/volcanic,
/area/space/nearstation)
"rc" = (
/obj/structure/window/reinforced{
	dir = 4
	},
/obj/structure/window/reinforced{
	dir = 8
	},
/turf/simulated/floor/plating/airless,
/area/ruin/space/tcommsat)
"rg" = (
/obj/effect/spawner/window/reinforced{
	useFull = 0
	},
/obj/structure/disposalpipe/segment{
	dir = 4
	},
/turf/simulated/floor/plating/airless,
/area/ruin/space/tcommsat)
"rs" = (
/obj/structure/window/reinforced{
	dir = 4
	},
/obj/structure/window/reinforced,
/obj/effect/decal/cleanable/dirt,
/turf/simulated/floor/plating/airless,
/area/ruin/space/tcommsat)
"rM" = (
/obj/structure/table,
/obj/item/radio/off,
/turf/simulated/floor/plating/airless,
/area/ruin/space/tcommsat)
"sb" = (
/turf/simulated/floor/plasteel{
	icon_state = "dark"
	},
/area/ruin/space/tcommsat)
"sm" = (
/obj/structure/chair{
	dir = 1
	},
/turf/simulated/floor/plating/airless,
/area/ruin/space/tcommsat)
"sy" = (
/turf/simulated/floor/plating/airless,
/area/space/nearstation)
"sD" = (
/obj/structure/grille,
/obj/structure/disposalpipe/segment{
	dir = 4
	},
/turf/simulated/floor/plating/airless,
/area/space/nearstation)
"sL" = (
/obj/structure/grille/broken,
/obj/structure/lattice,
/turf/template_noop,
/area/space/nearstation)
"tr" = (
/obj/effect/turf_decal/stripes/corner{
	dir = 2
	},
/obj/effect/decal/cleanable/dirt,
/turf/simulated/floor/plasteel,
/area/ruin/space/tcommsat)
"tE" = (
/obj/structure/window/reinforced{
	dir = 4
	},
/obj/structure/window/reinforced,
/turf/simulated/floor/plating/airless,
/area/ruin/space/tcommsat)
"vl" = (
/obj/effect/turf_decal/stripes/line{
	dir = 6
	},
/turf/simulated/floor/plasteel,
/area/ruin/space/tcommsat)
"wO" = (
/obj/structure/lattice,
/obj/structure/grille/broken,
/turf/template_noop,
/area/space/nearstation)
"xm" = (
/obj/structure/table,
/obj/item/paper_bin,
/obj/item/pen/blue,
/turf/simulated/floor/plating/airless,
/area/ruin/space/tcommsat)
"yM" = (
/obj/machinery/atmospherics/portable/canister/air,
/turf/simulated/floor/plating/airless,
/area/ruin/space/tcommsat)
"zE" = (
/turf/simulated/wall/r_wall,
/area/space/nearstation)
"zO" = (
/obj/structure/window/reinforced,
/obj/structure/window/reinforced{
	dir = 4
	},
/obj/effect/decal/cleanable/dirt,
/turf/simulated/floor/plating/airless,
/area/ruin/space/tcommsat)
"zT" = (
/obj/structure/window/reinforced{
	dir = 8
	},
/obj/structure/window/reinforced,
/turf/template_noop,
/area/space/nearstation)
"Ac" = (
/obj/structure/window/reinforced{
	dir = 1
	},
/obj/structure/window/reinforced{
	dir = 8
	},
/turf/simulated/floor/plating/airless,
/area/ruin/space/tcommsat)
"Av" = (
/obj/machinery/door/airlock/external,
/turf/simulated/floor/plating/airless,
/area/ruin/space/tcommsat)
"AV" = (
/obj/structure/table,
/obj/item/hemostat,
/turf/simulated/floor/plating/airless,
/area/ruin/space/tcommsat)
"Bq" = (
/obj/item/paper/crumpled,
/turf/simulated/floor/plating/airless,
/area/ruin/space/tcommsat)
"BD" = (
/obj/effect/decal/cleanable/dirt,
/turf/simulated/floor/plasteel,
/area/ruin/space/tcommsat)
"Cq" = (
/obj/machinery/door/airlock/hatch/syndicate{
	locked = 1
	},
/turf/simulated/floor/plating/airless,
/area/ruin/space/tcommsat)
"CC" = (
/obj/structure/window/reinforced{
	dir = 4
	},
/obj/structure/window/reinforced,
/obj/structure/lattice,
/turf/template_noop,
/area/space/nearstation)
"CZ" = (
/obj/structure/table,
/obj/item/storage/fancy/cigarettes,
/turf/simulated/floor/plating/airless,
/area/ruin/space/tcommsat)
"Ds" = (
/obj/structure/window/reinforced,
/obj/structure/window/reinforced{
	dir = 8
	},
/turf/template_noop,
/area/space/nearstation)
"DH" = (
/obj/structure/table,
/obj/item/circular_saw,
/turf/simulated/floor/plating/airless,
/area/ruin/space/tcommsat)
"Ef" = (
/obj/structure/grille,
/obj/structure/lattice,
/turf/template_noop,
/area/space/nearstation)
"Em" = (
/obj/item/stack/cable_coil/cut{
	amount = 1
	},
/turf/simulated/floor/plating/airless,
/area/ruin/space/tcommsat)
"EC" = (
/obj/structure/table,
/obj/item/paper/crumpled,
/turf/simulated/floor/plating/airless,
/area/ruin/space/tcommsat)
"FK" = (
/obj/structure/window/reinforced,
/obj/structure/window/reinforced{
	dir = 8
	},
/turf/simulated/floor/plating/airless,
/area/ruin/space/tcommsat)
"Go" = (
/obj/structure/table,
/turf/simulated/floor/plating/airless,
/area/ruin/space/tcommsat)
"GG" = (
/obj/machinery/light/small{
	dir = 4
	},
/turf/simulated/floor/plasteel,
/area/ruin/space/tcommsat)
"GV" = (
/obj/structure/door_assembly/door_assembly_hatch,
/turf/simulated/floor/plating/airless,
/area/ruin/space/tcommsat)
"HW" = (
/obj/structure/window/reinforced,
/obj/structure/window/reinforced{
	dir = 8
	},
/obj/structure/lattice,
/turf/template_noop,
/area/space/nearstation)
"Ie" = (
/obj/item/stack/sheet/plasteel,
/turf/simulated/floor/plating/airless,
/area/ruin/space/tcommsat)
"If" = (
/obj/structure/table,
/obj/item/scalpel/laser/laser2,
/turf/simulated/floor/plating/airless,
/area/ruin/space/tcommsat)
"Is" = (
/obj/effect/decal/cleanable/dirt,
/turf/simulated/floor/plating/airless,
/area/ruin/space/tcommsat)
"IG" = (
/obj/effect/decal/cleanable/blood,
/turf/simulated/floor/plating/airless,
/area/ruin/space/tcommsat)
"Jr" = (
/obj/structure/lattice,
/obj/structure/grille,
/turf/template_noop,
/area/space/nearstation)
"JH" = (
/obj/structure/window/reinforced{
	dir = 8
	},
/obj/structure/window/reinforced{
	dir = 1
	},
/turf/simulated/floor/plating/airless,
/area/ruin/space/tcommsat)
"JQ" = (
/obj/structure/window/reinforced{
	dir = 8
	},
/turf/template_noop,
/area/template_noop)
"KD" = (
/obj/machinery/teleport/station,
/obj/effect/turf_decal/stripes/line{
	dir = 4
	},
/turf/simulated/floor/plasteel,
/area/ruin/space/tcommsat)
"KH" = (
/obj/structure/window/reinforced{
	dir = 1
	},
/obj/structure/window/reinforced{
	dir = 8
	},
/obj/structure/lattice,
/turf/template_noop,
/area/space/nearstation)
"KR" = (
/obj/structure/computerframe{
	dir = 1
	},
/turf/simulated/floor/plating/airless,
/area/ruin/space/tcommsat)
"KX" = (
/obj/structure/cable{
	d1 = 1;
	d2 = 2;
	icon_state = "1-2"
	},
/turf/simulated/floor/plating/airless,
/area/ruin/space/tcommsat)
"Mt" = (
/obj/effect/decal/cleanable/dirt,
/obj/effect/decal/cleanable/blood/writing{
	dir = 6
	},
/turf/simulated/floor/plating/airless,
/area/ruin/space/tcommsat)
"MC" = (
/obj/structure/window/reinforced{
	dir = 4
	},
/obj/structure/window/reinforced{
	dir = 8
	},
/obj/item/airlock_electronics,
/turf/simulated/floor/plating/airless,
/area/ruin/space/tcommsat)
"Nb" = (
/obj/structure/disposalpipe/segment{
	dir = 4
	},
/turf/simulated/wall/r_wall,
/area/space/nearstation)
"Nw" = (
/obj/item/reagent_containers/food/snacks/xenomeatbreadslice{
	name = "green mold bread slice"
	},
/turf/simulated/floor/plating/airless,
/area/ruin/space/tcommsat)
"NJ" = (
/obj/structure/disposaloutlet{
	dir = 4
	},
/obj/structure/disposalpipe/trunk{
	dir = 8
	},
/turf/simulated/floor/plating/airless,
/area/space/nearstation)
"Or" = (
/obj/machinery/door/airlock/hatch,
/turf/simulated/floor/plating/airless,
/area/ruin/space/tcommsat)
"OY" = (
/obj/structure/window/reinforced{
	dir = 8
	},
/obj/structure/window/reinforced{
	dir = 1
	},
/obj/effect/decal/cleanable/dirt,
/turf/simulated/floor/plating/airless,
/area/ruin/space/tcommsat)
"Pn" = (
/obj/structure/window/reinforced{
	dir = 8
	},
/obj/structure/window/reinforced{
	dir = 4
	},
/turf/simulated/floor/plating/airless,
/area/ruin/space/tcommsat)
"PO" = (
/obj/structure/lattice,
/turf/template_noop,
/area/space/nearstation)
"PP" = (
/obj/effect/turf_decal/stripes/line{
	dir = 8
	},
/obj/structure/closet/firecloset,
/turf/simulated/floor/plasteel,
/area/ruin/space/tcommsat)
"PZ" = (
/obj/structure/closet,
/obj/item/stock_parts/cell/high,
/obj/item/wrench,
/turf/simulated/floor/plating/airless,
/area/ruin/space/tcommsat)
"Qd" = (
/obj/structure/window/reinforced,
/obj/structure/window/reinforced{
	dir = 4
	},
/turf/simulated/floor/plating/airless,
/area/ruin/space/tcommsat)
"Qe" = (
/obj/structure/chair,
/obj/effect/decal/cleanable/blood,
/obj/effect/decal/remains/human,
/obj/item/clothing/under/rank/centcom,
/obj/item/restraints/handcuffs,
/turf/simulated/floor/plating/airless,
/area/ruin/space/tcommsat)
"Qm" = (
/obj/structure/window/reinforced,
/obj/structure/window/reinforced{
	dir = 4
	},
/turf/template_noop,
/area/space/nearstation)
"QN" = (
/obj/effect/spawner/window/reinforced{
	useFull = 0
	},
/turf/simulated/floor/plating/airless,
/area/ruin/space/tcommsat)
"QT" = (
/obj/structure/window/reinforced{
	dir = 8
	},
/obj/structure/window/reinforced,
/turf/simulated/floor/plating/airless,
/area/ruin/space/tcommsat)
"QY" = (
/obj/structure/window/reinforced{
	dir = 4
	},
/obj/structure/window/reinforced{
	dir = 1
	},
/obj/effect/decal/cleanable/dirt,
/turf/simulated/floor/plating/airless,
/area/ruin/space/tcommsat)
"Rc" = (
/obj/effect/turf_decal/stripes/corner{
	dir = 1
	},
/turf/simulated/floor/plasteel,
/area/ruin/space/tcommsat)
"Sp" = (
/obj/effect/landmark/damageturf,
/turf/simulated/floor/plating/airless,
/area/ruin/space/tcommsat)
"St" = (
/obj/structure/window/reinforced,
/turf/simulated/floor/plating/airless,
/area/ruin/space/tcommsat)
"SS" = (
/obj/structure/window/reinforced{
	dir = 1
	},
/turf/simulated/floor/plating/airless,
/area/ruin/space/tcommsat)
"Th" = (
/obj/effect/spawner/window/reinforced/grilled,
/turf/simulated/floor/plating/airless,
/area/ruin/space/tcommsat)
"Tt" = (
/obj/structure/kitchenspike,
/obj/effect/decal/cleanable/blood,
/turf/simulated/floor/plating/airless,
/area/ruin/space/tcommsat)
"Tz" = (
/obj/item/radio/off,
/turf/simulated/floor/plating/airless,
/area/ruin/space/tcommsat)
"TW" = (
/obj/structure/window/reinforced{
	dir = 1
	},
/obj/structure/window/reinforced{
	dir = 8
	},
/turf/template_noop,
/area/space/nearstation)
"Ua" = (
/obj/effect/decal/cleanable/blood/writing,
/turf/simulated/floor/plating/airless,
/area/ruin/space/tcommsat)
"Up" = (
/obj/structure/table,
/obj/item/folder/yellow,
/turf/simulated/floor/plating/airless,
/area/ruin/space/tcommsat)
"Ur" = (
/obj/structure/computerframe,
/turf/simulated/floor/plating/airless,
/area/ruin/space/tcommsat)
"UC" = (
/obj/structure/window/reinforced{
	dir = 4
	},
/obj/structure/window/reinforced{
	dir = 8
	},
/obj/effect/decal/cleanable/dirt,
/turf/simulated/floor/plating/airless,
/area/ruin/space/tcommsat)
"UK" = (
/turf/simulated/floor/plasteel/airless{
	icon_state = "dark"
	},
/area/ruin/space/tcommsat)
"UP" = (
/obj/structure/window/reinforced{
	dir = 8
	},
/obj/structure/window/reinforced,
/obj/structure/window/reinforced{
	dir = 4
	},
/obj/structure/lattice,
/turf/template_noop,
/area/space/nearstation)
"Vf" = (
/obj/structure/door_assembly/door_assembly_ext,
/turf/simulated/floor/plating/airless,
/area/ruin/space/tcommsat)
"Vh" = (
/obj/effect/turf_decal/stripes/line{
	dir = 9
	},
/turf/simulated/floor/plasteel,
/area/ruin/space/tcommsat)
"Vx" = (
/obj/structure/window/reinforced{
	dir = 4
	},
/obj/structure/window/reinforced{
	dir = 1
	},
/obj/structure/lattice,
/turf/template_noop,
/area/space/nearstation)
"VH" = (
/obj/item/assembly/signaler,
/turf/simulated/floor/plating/airless,
/area/ruin/space/tcommsat)
"Wc" = (
/turf/simulated/floor/plating/airless,
/area/ruin/space/tcommsat)
"Wr" = (
/turf/simulated/wall/r_wall,
/area/ruin/space/tcommsat)
"WC" = (
/obj/item/cigbutt,
/turf/simulated/floor/plating/airless,
/area/ruin/space/tcommsat)
"WD" = (
/obj/item/trash/tapetrash,
/turf/simulated/floor/plating/airless,
/area/ruin/space/tcommsat)
"WP" = (
/obj/structure/table,
/obj/item/shard,
/turf/simulated/floor/plating/airless,
/area/ruin/space/tcommsat)
"Ye" = (
/obj/structure/lattice/catwalk,
/turf/template_noop,
/area/space/nearstation)
"Yt" = (
/obj/effect/turf_decal/stripes/line{
	dir = 2
	},
/turf/simulated/floor/plasteel,
/area/ruin/space/tcommsat)
"Yu" = (
/obj/item/electropack,
/turf/simulated/floor/plating/airless,
/area/ruin/space/tcommsat)
"YM" = (
/obj/structure/table,
/obj/item/paper,
/turf/simulated/floor/plating/airless,
/area/ruin/space/tcommsat)
"YN" = (
/obj/machinery/power/apc{
	dir = 1;
	name = "Worn-out APC";
	pixel_y = 24
	},
/obj/structure/cable{
	d2 = 4;
	icon_state = "0-2"
	},
/turf/simulated/floor/plating/airless,
/area/ruin/space/tcommsat)
"YT" = (
/obj/structure/table,
/obj/item/flashlight/lamp,
/turf/simulated/floor/plating/airless,
/area/ruin/space/tcommsat)
"YW" = (
/obj/structure/sign/securearea,
/turf/simulated/wall/r_wall,
/area/ruin/space/tcommsat)
"YZ" = (
/obj/effect/landmark/damageturf,
/obj/structure/door_assembly/door_assembly_hatch,
/turf/simulated/floor/plating/airless,
/area/ruin/space/tcommsat)
"Za" = (
/obj/machinery/teleport/hub,
/obj/effect/turf_decal/stripes/line{
	dir = 4
	},
/turf/simulated/floor/plasteel,
/area/ruin/space/tcommsat)
"Zd" = (
/obj/structure/closet/malf/suits,
/turf/simulated/floor/plasteel{
	icon_state = "dark"
	},
/area/ruin/space/tcommsat)
"Zi" = (
/obj/structure/window/reinforced{
	dir = 1
	},
/obj/structure/window/reinforced,
/turf/simulated/floor/plating/airless,
/area/ruin/space/tcommsat)
"Zs" = (
/obj/structure/window/reinforced{
	dir = 1
	},
/obj/structure/window/reinforced,
/obj/effect/decal/cleanable/dirt,
/turf/simulated/floor/plating/airless,
/area/ruin/space/tcommsat)

(1,1,1) = {"
nX
nX
nX
nX
nX
nX
nX
nX
nX
nX
nX
nX
nX
nX
nX
nX
nX
nX
PO
PO
Jr
Jr
Jr
PO
wO
Jr
Jr
Jr
Jr
Jr
PO
nX
zE
nX
nX
PO
nX
ax
nX
nX
nX
nX
nX
nX
nX
nX
nX
nX
nX
nX
nX
nX
"}
(2,1,1) = {"
nX
nX
nX
nX
nX
nX
nX
nX
nX
nX
nX
nX
nX
nX
PO
PO
wO
Jr
Jr
Jr
Jr
Jr
Jr
Jr
Jr
Jr
Jr
Jr
Jr
Jr
Jr
PO
wO
ax
wO
ax
nX
nX
wO
nX
nX
nX
nX
nX
nX
nX
nX
nX
nX
nX
nX
nX
"}
(3,1,1) = {"
nX
nX
nX
nX
nX
nX
nX
nX
nX
nX
nX
nX
PO
Jr
Jr
Jr
Jr
Jr
Jr
zE
zE
zE
zE
zE
zE
zE
zE
zE
zE
zE
zE
Jr
ax
zE
ax
qT
Jr
PO
nX
nX
nX
nX
nX
nX
nX
nX
nX
nX
nX
nX
nX
nX
"}
(4,1,1) = {"
nX
nX
nX
Jr
nX
nX
zE
nX
nX
nX
nX
PO
wO
Jr
zE
zE
zE
zE
zE
zE
Wr
Wr
ot
Wr
Wr
ot
Wr
Wr
ot
Wr
zE
zE
zE
qT
ax
zE
Jr
Jr
PO
nX
nX
nX
nX
nX
nX
nX
nX
nX
nX
nX
nX
nX
"}
(5,1,1) = {"
nX
nX
nX
nX
PO
nX
nX
nX
nX
nX
nX
Jr
zE
zE
zE
zE
zE
zE
zE
zE
ot
Zd
sb
Wr
Is
Wc
Wr
UK
le
Wr
zE
zE
zE
zE
zE
zE
zE
zE
Jr
nX
nX
nX
nX
nX
nX
nX
nX
nX
nX
nX
nX
nX
"}
(6,1,1) = {"
wO
zE
nX
wO
Jr
nX
nX
nX
nX
nX
Jr
zE
zE
zE
zE
nX
PO
nX
nX
Jr
Wr
Zd
sb
Wr
Wc
Is
ot
UK
fS
Wr
Jr
nX
PO
nX
nX
zE
zE
zE
zE
Jr
nX
nX
nX
nX
nX
nX
nX
nX
nX
nX
nX
nX
"}
(7,1,1) = {"
nX
nX
nX
Jr
Jr
zE
Jr
nX
PO
zE
zE
zE
zE
nX
nX
nX
PO
nX
nX
Jr
ot
nk
sb
Cq
Sp
Wc
jk
UK
oZ
ot
Jr
nX
PO
nX
nX
nX
nX
zE
zE
zE
zE
PO
nX
nX
nX
nX
nX
nX
nX
nX
nX
nX
"}
(8,1,1) = {"
nX
wO
Jr
zE
zE
nX
zE
nX
nX
nX
nX
PO
nX
nX
nX
nX
PO
nX
nX
Jr
Wr
lo
sb
Wr
Is
Sp
Wr
UK
fS
Wr
Jr
nX
PO
nX
nX
nX
nX
nX
PO
nX
nX
nX
nX
nX
nX
nX
nX
nX
nX
nX
nX
nX
"}
(9,1,1) = {"
nX
Jr
nX
zE
zE
PO
nX
nX
nX
nX
nX
PO
nX
nX
nX
nX
PO
nX
nX
Jr
Wr
Wr
Wr
Wr
GV
Sp
Wr
Wr
ot
Wr
Jr
nX
PO
nX
nX
nX
nX
PO
wO
Ef
Ef
Ef
Ef
nX
nX
nX
nX
nX
nX
nX
nX
nX
"}
(10,1,1) = {"
nX
Jr
zE
nX
nX
wO
Jr
PO
nX
nX
nX
PO
nX
nX
nX
nX
PO
pt
Ac
rc
Cq
Wc
Wc
Wc
Sp
Is
Sp
Wc
Wc
Or
Pn
FK
Vx
nX
nX
nX
nX
nX
Ef
Ef
Ef
Ef
Ef
PO
wO
Ef
nX
nX
nX
nX
nX
nX
"}
(11,1,1) = {"
nX
sL
Ef
nX
nX
PO
nX
nX
Jr
Jr
PO
PO
PO
PO
PO
PO
PO
Ac
rs
TW
ot
Wc
Is
Is
Wc
Wc
Is
Wc
Is
Wr
zT
QY
FK
PO
PO
PO
sy
sy
zE
zE
zE
zE
zE
Ef
Ef
Ef
Ef
Ef
nX
nX
nX
nX
"}
(12,1,1) = {"
nX
nX
PO
zE
nX
nX
nX
nX
zE
nX
nX
PO
nX
nX
nX
nX
CC
Zi
TW
nX
Wr
Wr
Wr
ot
Wr
Wr
Wr
ot
Wr
Wr
nX
zT
qA
nX
nX
nX
nX
nX
nX
sy
sy
sy
zE
zE
zE
zE
Ef
Ef
wO
Ef
Ef
PO
"}
(13,1,1) = {"
nX
Jr
nX
nX
wO
nX
nX
zE
nX
nX
nX
PO
nX
nX
nX
nX
Ac
tE
nX
nX
nX
PO
nX
nX
nX
nX
nX
nX
PO
nX
nX
nX
qA
nG
nX
nX
nX
nX
nX
nX
nX
PO
sy
sy
sy
zE
zE
zE
sy
sy
nX
nX
"}
(14,1,1) = {"
nX
wO
zE
PO
zE
nX
nX
nX
Jr
Jr
wO
PO
nX
nX
nX
nX
Zs
TW
nX
nX
nX
wO
Jr
Jr
Jr
Jr
Jr
PO
wO
Jr
PO
PO
QY
FK
nX
nX
nX
nX
nX
nX
nX
PO
nX
nX
nX
PO
nX
nX
nX
nX
nX
nX
"}
(15,1,1) = {"
PO
Jr
zE
zE
PO
wO
Jr
nX
Wr
ot
Wr
Wr
Wr
nX
nX
pt
Zi
PO
PO
wO
Jr
Jr
Wr
ot
Wr
ot
Wr
Wr
Wr
Jr
Jr
nX
zT
qA
nX
nX
nX
nX
nX
nX
nX
PO
nX
nX
nX
PO
nX
nX
nX
nX
nX
nX
"}
(16,1,1) = {"
Jr
Jr
zE
zE
nX
Jr
Wr
Wr
xm
PZ
Wc
Bq
GV
rc
UC
rc
St
nX
nX
Jr
Jr
Wr
Is
Wc
Wc
Wc
Wc
Wc
Wc
ot
Jr
Jr
nX
qA
nG
nX
nX
nX
nX
Wr
Wr
ot
ot
Wr
Wr
PO
nX
nX
nX
nX
nX
nX
"}
(17,1,1) = {"
Jr
Jr
zE
zE
nX
Jr
ot
YM
Bq
Wc
Wc
Wc
Wr
nX
nX
Ds
Zi
nX
nX
Jr
ot
Wc
Wc
Wc
Is
Wc
Is
Wc
Wc
oh
Wr
Jr
nX
QY
FK
PO
PO
PO
Wr
Wr
Vh
kP
PP
ad
ot
Wr
nX
nX
nX
nX
nX
nX
"}
(18,1,1) = {"
wO
Jr
zE
zE
nX
wO
Wr
Ur
Is
Wc
Wc
Is
Th
PO
PO
PO
Zs
nX
nX
Jr
Wr
Wc
Is
Wc
VH
Wc
IG
Wc
Wc
hQ
Wr
Jr
nX
zT
qA
my
nX
nX
Wr
jd
mL
BD
mL
mL
mL
Wr
nX
nX
nX
nX
nX
nX
"}
(19,1,1) = {"
Jr
Jr
zE
zE
nX
Jr
Wr
Ur
Wc
Is
Wc
Wc
rM
Th
nX
nX
Zi
Vx
PO
Jr
YW
Wc
IG
Wc
Wc
Wc
Is
Tz
Wc
WD
ot
Jr
nX
nX
QY
FK
hO
nX
Wr
bg
mL
mL
mL
mL
tr
Wr
ok
ot
Ye
nX
nX
nX
"}
(20,1,1) = {"
Jr
Jr
zE
zE
PO
Jr
Wr
YN
KX
Em
Bq
ko
KR
Th
nX
nX
SS
UC
rc
MC
GV
Wc
Wc
YT
Wc
Qe
WC
Wc
Ua
Tt
Wr
Jr
PO
PO
UP
fI
rc
rc
Or
eu
BD
mL
mL
mL
Yt
Av
Ua
Vf
Ye
nX
nX
nX
"}
(21,1,1) = {"
Jr
Jr
zE
zE
nX
Jr
ot
Ur
Is
Wc
Wc
WC
Up
Th
nX
nX
Zi
KH
PO
Jr
YW
hg
Wc
jv
Wc
Wc
Wc
Wc
Is
Wc
Wr
Jr
nX
nX
JH
rs
lk
nX
Wr
Rc
mL
mL
mL
mL
nv
ot
Wr
Wr
Ye
nX
nX
nX
"}
(22,1,1) = {"
Jr
Jr
zE
zE
nX
Jr
Wr
Ur
Wc
Wc
Is
Wc
Th
PO
PO
PO
Zi
nX
nX
Jr
ot
Wc
Is
Is
DH
AV
Yu
IG
WD
WP
ot
Jr
nX
Qm
qA
JQ
nX
nX
ot
BD
mL
mL
BD
mL
GG
Wr
nX
nX
nX
nX
nX
nX
"}
(23,1,1) = {"
Jr
Jr
zE
zE
nX
Jr
Wr
EC
Wc
Wc
Wc
Bq
ot
nX
nX
pt
Zi
nX
nX
Jr
Wr
Wc
Wc
Wc
Is
Wc
Wc
Wc
Wc
If
Wr
Jr
nX
OY
Qd
PO
PO
PO
Wr
Wr
ab
KD
Za
vl
ot
Wr
nX
nX
nX
nX
nX
nX
"}
(24,1,1) = {"
Jr
Jr
zE
zE
nX
wO
Wr
Wr
Go
yM
Wc
Wc
Cq
UC
rc
rc
St
nX
nX
Jr
Jr
ot
Is
Wc
Wc
Wc
Wc
Is
Wc
Wr
Jr
Jr
nX
qA
TW
nX
nX
nX
nX
Wr
Wr
ot
Wr
Wr
Wr
PO
nX
nX
nX
nX
nX
nX
"}
(25,1,1) = {"
wO
Jr
zE
zE
PO
PO
Jr
Wr
Wr
ot
Wr
Wr
Wr
nX
nX
Ds
Zi
PO
PO
wO
Jr
Jr
Wr
Wr
Wr
ot
Wr
ot
Wr
Jr
Jr
nX
Qm
qA
zE
nX
ax
zE
nX
nX
nX
PO
nX
nX
nX
PO
nX
nX
nX
nX
nX
nX
"}
(26,1,1) = {"
nX
wO
Jr
zE
zE
nX
Jr
Jr
Jr
wO
Jr
PO
nX
nX
nX
nX
Zs
nG
nX
nX
nX
wO
Jr
Jr
Jr
Jr
PO
wO
Jr
Jr
PO
PO
OY
Qd
nX
nX
nX
wO
nX
nX
nX
PO
nX
nX
nX
PO
nX
nX
nX
nX
nX
nX
"}
(27,1,1) = {"
nX
Jr
Jr
zE
zE
zE
PO
nX
nX
nX
nX
PO
nX
nX
nX
nX
fh
QT
nX
nX
nX
PO
nX
nX
nX
nX
nX
nX
PO
nX
nX
nX
qA
TW
ax
nX
nX
nX
PO
nX
nX
PO
sy
sy
sy
zE
zE
zE
sy
sy
nX
nX
"}
(28,1,1) = {"
nX
nX
wO
Jr
zE
zE
zE
zE
zE
nX
nX
PO
nX
nX
nX
nX
HW
Zi
nG
nX
Wr
Wr
Wr
ot
Wr
Wr
ot
Wr
Wr
Wr
nX
Qm
qA
zE
nX
nX
ax
zE
ax
sy
sy
sy
zE
zE
zE
zE
Jr
Jr
Ef
Ef
wO
Ef
"}
(29,1,1) = {"
nX
nX
nX
Jr
Jr
Jr
zE
Jr
Jr
Jr
PO
PO
PO
PO
PO
PO
PO
fh
eM
nG
ot
bx
ko
CZ
sm
Wc
pg
Sp
dM
al
Qm
JH
zO
PO
wO
PO
nX
ax
ax
ax
ax
zE
zE
Jr
Jr
kx
wO
Ef
nX
nX
nX
nX
"}
(30,1,1) = {"
nX
nX
nX
nX
wO
Jr
zE
wO
nX
nX
nX
PO
nX
nX
nX
nX
PO
Ds
fh
rc
Cq
ii
Is
gg
WC
Wc
Is
Sp
Sp
Ie
rc
Qd
KH
nX
nX
nX
PO
nX
qT
wO
zE
PO
Jr
PO
wO
Ef
nX
nX
nX
nX
nX
nX
"}
(31,1,1) = {"
nX
nX
nX
nX
nX
nX
nX
Jr
nX
nX
nX
PO
nX
nX
nX
nX
PO
nX
nX
Ef
Wr
ii
Wc
Wc
Is
Wc
Sp
al
Is
Wc
wO
nX
PO
nX
nX
nX
nX
nX
wO
nX
qT
nX
nX
nX
nX
nX
nX
nX
nX
nX
nX
nX
"}
(32,1,1) = {"
nX
nX
nX
nX
nX
nX
PO
nX
nX
nX
PO
nX
nX
nX
nX
nX
PO
nX
nX
Ef
Wr
rg
GV
Wr
QN
Or
Wr
QN
YZ
ot
Jr
nX
PO
nX
nX
nX
nX
nX
PO
nX
nX
nX
PO
nX
nX
nX
nX
nX
nX
nX
nX
nX
"}
(33,1,1) = {"
nX
nX
nX
nX
nX
nX
nX
nX
nX
nX
nX
nX
nX
nX
nX
nX
PO
nX
nX
Ef
Wr
ii
cM
Wr
Is
Wc
ot
Wc
Wc
Wr
Jr
nX
PO
nX
nX
nX
nX
zE
zE
zE
zE
PO
nX
nX
nX
nX
nX
nX
nX
nX
nX
nX
"}
(34,1,1) = {"
nX
nX
nX
nX
PO
nX
nX
PO
nX
nX
nX
PO
nX
nX
nX
nX
PO
nX
nX
Ef
ot
hk
Mt
QN
Wc
fD
QN
Is
Nw
Wr
Jr
nX
PO
nX
nX
zE
zE
zE
zE
Jr
nX
nX
nX
ax
nX
nX
nX
nX
nX
nX
nX
nX
"}
(35,1,1) = {"
nX
nX
nX
PO
zE
nX
zE
nX
nX
nX
nX
nX
PO
nX
nX
wO
zE
zE
zE
zE
Wr
au
Wc
ot
bc
Wc
Wr
bc
Wc
Wr
zE
zE
zE
zE
zE
zE
zE
zE
Jr
nX
nX
nX
nX
nX
nX
nX
nX
nX
nX
nX
nX
nX
"}
(36,1,1) = {"
nX
zE
nX
nX
nX
Jr
zE
zE
zE
nX
nX
nX
zE
nX
nX
nX
PO
zE
zE
zE
Wr
kc
Wr
Wr
Wr
Wr
Wr
Wr
ot
Wr
zE
zE
zE
zE
zE
zE
Jr
Jr
PO
nX
nX
nX
nX
nX
nX
nX
nX
nX
nX
nX
nX
nX
"}
(37,1,1) = {"
nX
nX
nX
nX
nX
nX
Jr
nX
zE
zE
zE
nX
nX
nX
nX
nX
Jr
Jr
Jr
zE
zE
Nb
zE
zE
zE
zE
zE
zE
zE
zE
zE
Jr
Jr
Jr
Jr
Jr
Jr
PO
nX
nX
nX
nX
nX
nX
nX
nX
nX
nX
nX
nX
nX
nX
"}
(38,1,1) = {"
nX
nX
nX
nX
nX
nX
wO
Jr
Jr
Jr
PO
nX
nX
nX
zE
nX
nX
PO
Jr
Jr
Jr
sD
Jr
Jr
Jr
Jr
Jr
Jr
Jr
Jr
Jr
Jr
wO
Jr
PO
PO
nX
nX
nX
nX
nX
nX
nX
nX
nX
nX
nX
nX
nX
nX
nX
nX
"}
(39,1,1) = {"
nX
nX
nX
nX
zE
nX
nX
nX
wO
PO
Jr
PO
nX
nX
nX
nX
nX
nX
PO
wO
Jr
NJ
Jr
PO
wO
Jr
Jr
Jr
wO
Jr
Jr
PO
nX
nX
nX
nX
nX
nX
nX
nX
nX
nX
nX
nX
nX
nX
nX
nX
nX
nX
nX
nX
"}
