//MAP CONVERTED BY dmm2tgm.py THIS HEADER COMMENT PREVENTS RECONVERSION, DO NOT REMOVE
"ab" = (
/obj/machinery/light/clockwork{
	dir = 8
	},
/turf/simulated/floor/clockwork,
/area/ruin/space/clockwork_site)
"ac" = (
/turf/simulated/floor/clockwork,
/area/ruin/space/clockwork_site)
"ae" = (
/obj/structure/falsewall/rock_ancient,
/turf/simulated/floor/plating/asteroid/airless,
/area/ruin/space/clockwork_site)
"ag" = (
/obj/structure/table/reinforced/brass,
/obj/item/stack/cable_coil/orange,
/obj/item/stack/cable_coil/orange{
	pixel_x = 2;
	pixel_y = 4
	},
/obj/item/stack/cable_coil/orange{
	pixel_x = 4;
	pixel_y = 7
	},
/obj/item/wirecutters/brass,
/turf/simulated/floor/clockwork,
/area/ruin/space/clockwork_site)
"ai" = (
/obj/structure/table/reinforced/brass,
/obj/item/weldingtool/experimental/brass,
/turf/simulated/floor/clockwork,
/area/ruin/space/clockwork_site)
"ak" = (
/obj/effect/clockwork/overlay/floor,
/obj/machinery/door/airlock/clockwork,
/turf/simulated/floor/clockwork/reebe,
/area/ruin/space/clockwork_site)
"al" = (
/obj/structure/dresser,
/turf/simulated/floor/clockwork,
/area/ruin/space/clockwork_site)
"am" = (
/obj/structure/window/reinforced/clockwork/fulltile,
/obj/structure/grille/ratvar,
/turf/simulated/floor/clockwork/reebe,
/area/ruin/space/clockwork_site)
"an" = (
/obj/machinery/door/airlock/clockwork/glass,
/turf/simulated/floor/carpet/royalblack,
/area/ruin/space/clockwork_site)
"ao" = (
/obj/structure/chair/brass,
/turf/simulated/floor/clockwork,
/area/ruin/space/clockwork_site)
"ap" = (
/obj/structure/table/reinforced/brass,
/obj/item/stack/tile/brass/fifty,
/turf/simulated/floor/clockwork,
/area/ruin/space/clockwork_site)
"aq" = (
/turf/simulated/mineral/ancient,
/area/ruin/unpowered)
"ar" = (
/obj/structure/table/reinforced/brass,
/obj/item/salvage/ruin/tablet,
/turf/simulated/floor/carpet/royalblack,
/area/ruin/space/clockwork_site)
"at" = (
/turf/simulated/wall/clockwork,
/area/ruin/space/clockwork_site)
"av" = (
/obj/structure/table/reinforced/brass,
/turf/simulated/floor/carpet/royalblack,
/area/ruin/space/clockwork_site)
"aw" = (
/obj/structure/shelf/clockwork,
/obj/item/clockwork/component/belligerent_eye/blind_eye,
/obj/item/clockwork/alloy_shards/pinion_lock,
/obj/item/clockwork/alloy_shards/small,
/turf/simulated/floor/clockwork,
/area/ruin/space/clockwork_site)
"ax" = (
/obj/machinery/door/airlock/clockwork,
/turf/simulated/floor/clockwork,
/area/ruin/space/clockwork_site)
"ay" = (
/turf/simulated/floor/plating/asteroid/airless,
/area/ruin/unpowered)
"az" = (
/obj/structure/grille/ratvar,
/obj/structure/window/reinforced/clockwork/fulltile,
/turf/simulated/floor/clockwork/reebe,
/area/ruin/space/clockwork_site)
"aA" = (
/obj/structure/table/reinforced/brass,
/obj/item/crowbar/brass,
/obj/item/wrench/brass,
/turf/simulated/floor/clockwork,
/area/ruin/space/clockwork_site)
"aB" = (
/obj/structure/shelf/clockwork,
/obj/item/reagent_containers/glass/bottle/copper,
/obj/item/reagent_containers/glass/bottle/copper,
/obj/item/reagent_containers/glass/bottle/copper,
/obj/item/reagent_containers/glass/bottle/copper,
/obj/item/reagent_containers/glass/bottle/copper,
/obj/item/reagent_containers/glass/bottle/copper,
/turf/simulated/floor/clockwork,
/area/ruin/space/clockwork_site)
"aC" = (
/obj/machinery/door/airlock/clockwork/glass,
/turf/simulated/floor/clockwork,
/area/ruin/space/clockwork_site)
"aD" = (
/obj/structure/table/reinforced/brass,
/obj/item/storage/firstaid/adv,
/turf/simulated/floor/clockwork,
/area/ruin/space/clockwork_site)
"aF" = (
/obj/structure/gunrack/clockwork,
/obj/item/clockwork/weapon/ratvarian_spear,
/obj/item/clockwork/weapon/ratvarian_spear,
/turf/simulated/floor/clockwork,
/area/ruin/space/clockwork_site)
"aH" = (
/turf/space,
/area/space)
"aI" = (
/obj/machinery/light/clockwork/small,
/turf/simulated/floor/plating/asteroid/airless,
/area/ruin/space/clockwork_site)
"aK" = (
/obj/machinery/optable,
/turf/simulated/floor/clockwork,
/area/ruin/space/clockwork_site)
"aL" = (
/obj/structure/table/reinforced/brass,
/obj/item/tank/internals/oxygen,
/obj/item/clothing/mask/breath,
/turf/simulated/floor/clockwork,
/area/ruin/space/clockwork_site)
"aM" = (
/turf/simulated/floor/carpet/royalblack,
/area/ruin/space/clockwork_site)
"aN" = (
/obj/structure/chair/sofa/pew/clockwork,
/turf/simulated/floor/clockwork,
/area/ruin/space/clockwork_site)
"aO" = (
/obj/structure/table/reinforced/brass,
/turf/simulated/floor/clockwork,
/area/ruin/space/clockwork_site)
"aQ" = (
/obj/machinery/light/clockwork{
	dir = 1
	},
/turf/simulated/floor/carpet/royalblack,
/area/ruin/space/clockwork_site)
"aS" = (
/obj/structure/chair/brass{
	dir = 1
	},
/turf/simulated/floor/clockwork,
/area/ruin/space/clockwork_site)
"aT" = (
/obj/structure/table/reinforced/brass,
/obj/item/clockwork/alloy_shards{
	pixel_y = 3
	},
/turf/simulated/floor/clockwork,
/area/ruin/space/clockwork_site)
"aU" = (
/obj/machinery/light/clockwork{
	dir = 1
	},
/turf/simulated/floor/clockwork,
/area/ruin/space/clockwork_site)
"aW" = (
/obj/structure/fans/tiny,
/obj/machinery/door/airlock/clockwork,
/turf/simulated/floor/clockwork,
/area/ruin/space/clockwork_site)
"aX" = (
/obj/machinery/light/clockwork,
/turf/simulated/floor/clockwork,
/area/ruin/space/clockwork_site)
"aY" = (
/obj/structure/table/reinforced/brass,
/obj/item/storage/surgical_tray{
	pixel_y = 8
	},
/turf/simulated/floor/clockwork,
/area/ruin/space/clockwork_site)
"aZ" = (
/obj/machinery/sleeper/clockwork{
	dir = 4
	},
/turf/simulated/floor/clockwork,
/area/ruin/space/clockwork_site)
"bl" = (
/obj/machinery/light/clockwork,
/obj/structure/table/reinforced/brass,
/obj/effect/spawner/random/snacks,
/turf/simulated/floor/clockwork,
/area/ruin/space/clockwork_site)
"cz" = (
/obj/item/pickaxe/emergency,
/turf/simulated/floor/plating/asteroid/airless,
/area/ruin/unpowered)
"cF" = (
/obj/structure/bed,
/obj/item/bedsheet/clockwork,
/turf/simulated/floor/clockwork,
/area/ruin/space/clockwork_site)
"dg" = (
/obj/machinery/light/clockwork/small{
	dir = 1
	},
/obj/structure/chair/sofa/pew/clockwork,
/turf/simulated/floor/clockwork,
/area/ruin/space/clockwork_site)
"gf" = (
/obj/structure/chair/sofa/pew/clockwork/left{
	dir = 8
	},
/turf/simulated/floor/clockwork,
/area/ruin/space/clockwork_site)
"hC" = (
/obj/structure/chair/sofa/pew/clockwork/left,
/turf/simulated/floor/clockwork,
/area/ruin/space/clockwork_site)
"hJ" = (
/turf/simulated/floor/chasm/space_ruin,
/area/ruin/unpowered)
"hQ" = (
/obj/structure/table/reinforced/brass,
/obj/item/paper/clockwork_cult_message,
/turf/simulated/floor/carpet/royalblack,
/area/ruin/space/clockwork_site)
"kB" = (
/obj/machinery/light/clockwork/small{
	dir = 4
	},
/obj/structure/chair/sofa/pew/clockwork{
	dir = 8
	},
/turf/simulated/floor/clockwork,
/area/ruin/space/clockwork_site)
"lx" = (
/obj/structure/table/reinforced/brass,
/obj/effect/spawner/random/food_or_drink/salad,
/turf/simulated/floor/clockwork,
/area/ruin/space/clockwork_site)
"lC" = (
/obj/structure/table/reinforced/brass,
/obj/effect/spawner/random/food_or_drink/soup,
/turf/simulated/floor/clockwork,
/area/ruin/space/clockwork_site)
"lQ" = (
/obj/structure/chair/brass{
	dir = 8
	},
/turf/simulated/floor/carpet/royalblack,
/area/ruin/space/clockwork_site)
"pz" = (
/obj/structure/bed,
/obj/machinery/light/clockwork{
	dir = 4
	},
/obj/item/bedsheet/clockwork,
/turf/simulated/floor/clockwork,
/area/ruin/space/clockwork_site)
"pZ" = (
/obj/structure/chair/sofa/pew/clockwork/right{
	dir = 1
	},
/turf/simulated/floor/clockwork,
/area/ruin/space/clockwork_site)
"rO" = (
/obj/machinery/light/clockwork/small{
	dir = 1
	},
/turf/simulated/floor/plating/asteroid/basalt,
/area/ruin/space/clockwork_site)
"tM" = (
/obj/machinery/computer/operating/clockwork,
/turf/simulated/floor/clockwork,
/area/ruin/space/clockwork_site)
"uu" = (
/obj/structure/shelf/clockwork,
/obj/item/clockwork/alloy_shards/large,
/obj/item/clockwork/component/geis_capacitor/fallen_armor,
/obj/item/clockwork/alloy_shards/medium,
/obj/machinery/light/clockwork/small{
	dir = 1
	},
/obj/item/clockwork/component/belligerent_eye,
/turf/simulated/floor/clockwork,
/area/ruin/space/clockwork_site)
"uN" = (
/obj/structure/chair/brass{
	dir = 4
	},
/turf/simulated/floor/clockwork,
/area/ruin/space/clockwork_site)
"vs" = (
/obj/structure/chair/brass{
	dir = 8
	},
/turf/simulated/floor/clockwork,
/area/ruin/space/clockwork_site)
"wP" = (
/obj/machinery/light/clockwork{
	dir = 4
	},
/turf/simulated/floor/clockwork,
/area/ruin/space/clockwork_site)
"xz" = (
/obj/structure/chair/sofa/pew/clockwork/right{
	dir = 8
	},
/turf/simulated/floor/clockwork,
/area/ruin/space/clockwork_site)
"ye" = (
/turf/simulated/mineral/random/high_chance,
/area/ruin/unpowered)
"AR" = (
/turf/simulated/floor/plating/asteroid/airless,
/area/ruin/space/clockwork_site)
"BX" = (
/obj/structure/chair/sofa/pew/clockwork/right,
/turf/simulated/floor/clockwork,
/area/ruin/space/clockwork_site)
"Cb" = (
/turf/simulated/floor/plating/asteroid/basalt,
/area/ruin/space/clockwork_site)
"Cq" = (
/obj/structure/shelf/clockwork,
/obj/effect/spawner/random/maintenance,
/turf/simulated/floor/clockwork,
/area/ruin/space/clockwork_site)
"Cv" = (
/mob/living/simple_animal/hostile/clockwork_construct/clockwork_marauder/hostile,
/turf/simulated/floor/clockwork,
/area/ruin/space/clockwork_site)
"CV" = (
/obj/structure/chair/brass{
	dir = 4
	},
/turf/simulated/floor/carpet/royalblack,
/area/ruin/space/clockwork_site)
"Dm" = (
/obj/machinery/light/clockwork/small,
/obj/structure/chair/sofa/pew/clockwork{
	dir = 1
	},
/turf/simulated/floor/clockwork,
/area/ruin/space/clockwork_site)
"Dy" = (
/obj/structure/mirror{
	pixel_y = 28
	},
/obj/structure/dresser,
/turf/simulated/floor/clockwork,
/area/ruin/space/clockwork_site)
"Ff" = (
/obj/structure/table/reinforced/brass,
/obj/item/salvage/ruin/tablet,
/turf/simulated/floor/clockwork,
/area/ruin/space/clockwork_site)
"Gt" = (
/obj/machinery/light/clockwork/small{
	dir = 4
	},
/turf/simulated/floor/clockwork,
/area/ruin/space/clockwork_site)
"Iv" = (
/obj/structure/table/reinforced/brass,
/obj/effect/spawner/random/snacks,
/turf/simulated/floor/clockwork,
/area/ruin/space/clockwork_site)
"Jb" = (
/obj/structure/chair/brass,
/turf/simulated/floor/carpet/royalblack,
/area/ruin/space/clockwork_site)
"Mh" = (
/turf/simulated/mineral/ancient/outer,
/area/ruin/unpowered)
"Mi" = (
/obj/structure/table/reinforced/brass,
/obj/item/storage/belt/utility,
/obj/item/screwdriver/brass,
/turf/simulated/floor/clockwork,
/area/ruin/space/clockwork_site)
"MU" = (
/obj/structure/chair/sofa/pew/clockwork/left{
	dir = 1
	},
/turf/simulated/floor/clockwork,
/area/ruin/space/clockwork_site)
"OE" = (
/obj/structure/chair/sofa/pew/clockwork,
/obj/structure/chair/sofa/pew/clockwork,
/turf/simulated/floor/clockwork,
/area/ruin/space/clockwork_site)
"QC" = (
/obj/structure/table/reinforced/brass,
/obj/effect/spawner/random/maintenance,
/turf/simulated/floor/clockwork,
/area/ruin/space/clockwork_site)
"QV" = (
/obj/structure/table/reinforced/brass,
/obj/item/paper_bin{
	pixel_y = 4
	},
/obj/item/pen/multi/fountain,
/turf/simulated/floor/carpet/royalblack,
/area/ruin/space/clockwork_site)
"VC" = (
/mob/living/simple_animal/hostile/clockwork_construct/clockwork_marauder/hostile{
	dir = 1
	},
/turf/simulated/floor/clockwork,
/area/ruin/space/clockwork_site)
"VW" = (
/turf/simulated/mineral/random/low_chance,
/area/ruin/unpowered)
"YM" = (
/obj/structure/chair/brass{
	dir = 1
	},
/turf/simulated/floor/carpet/royalblack,
/area/ruin/space/clockwork_site)

(1,1,1) = {"
aH
aH
aH
aH
aH
aH
aH
aH
aH
aH
aH
aH
aH
aH
aH
aH
aH
aH
aH
aH
aH
aH
aH
Mh
Mh
Mh
aH
aH
aH
aH
aH
aH
aH
aH
aH
aH
aH
aH
aH
VW
VW
VW
aH
aH
aH
aH
aH
aH
"}
(2,1,1) = {"
aH
aH
aH
aH
aH
aH
aH
aH
aH
aH
aH
aH
aH
aH
aH
aH
aH
aH
aH
aH
aH
Mh
Mh
Mh
VW
Mh
Mh
Mh
aH
aH
aH
aH
aH
aH
aH
aH
aH
aH
aH
aH
VW
aH
aH
aH
aH
aH
aH
aH
"}
(3,1,1) = {"
aH
aH
aH
aH
Mh
Mh
aH
aH
ay
ay
aH
aH
aH
aH
aH
Mh
Mh
Mh
aH
aH
Mh
Mh
VW
VW
VW
VW
VW
Mh
aH
aH
aH
aH
aH
aH
aH
aH
aH
Mh
aH
aH
aH
aH
aH
ye
aH
aH
aH
aH
"}
(4,1,1) = {"
aH
aH
aH
Mh
Mh
Mh
Mh
ay
ay
ay
ay
ay
Mh
Mh
Mh
Mh
VW
Mh
Mh
Mh
Mh
VW
VW
VW
VW
VW
VW
Mh
aH
aH
aH
aH
aH
aH
Mh
Mh
Mh
Mh
Mh
Mh
aH
aH
aH
ye
ye
ye
aH
aH
"}
(5,1,1) = {"
aH
aH
aH
Mh
ye
ye
Mh
Mh
ay
ay
ay
ay
Mh
VW
VW
VW
VW
VW
VW
VW
VW
VW
VW
VW
VW
VW
VW
Mh
Mh
aH
aH
aH
Mh
Mh
Mh
VW
VW
VW
VW
Mh
aH
aH
aH
ye
ye
ye
aH
aH
"}
(6,1,1) = {"
aH
aH
Mh
Mh
ye
ye
Mh
Mh
ay
ay
ay
Mh
Mh
VW
VW
VW
VW
VW
VW
VW
VW
VW
VW
VW
VW
VW
VW
VW
Mh
Mh
Mh
Mh
Mh
VW
VW
VW
VW
VW
VW
Mh
Mh
aH
aH
aH
ye
ye
aH
aH
"}
(7,1,1) = {"
aH
Mh
Mh
ye
ye
Mh
Mh
ay
ay
ay
ay
Mh
VW
VW
VW
VW
VW
VW
VW
VW
VW
VW
VW
VW
VW
VW
VW
VW
VW
VW
VW
VW
VW
VW
VW
VW
VW
VW
VW
VW
Mh
aH
aH
aH
ye
aH
aH
aH
"}
(8,1,1) = {"
aH
Mh
ye
ye
ye
Mh
ay
ay
ay
ay
ay
Mh
VW
VW
VW
VW
VW
VW
VW
VW
VW
VW
VW
VW
VW
VW
VW
VW
VW
VW
VW
VW
VW
VW
VW
VW
VW
VW
VW
VW
Mh
Mh
aH
aH
aH
aH
aH
aH
"}
(9,1,1) = {"
aH
Mh
ye
ye
ye
ay
ay
ay
ay
Mh
Mh
Mh
Mh
Mh
Mh
Mh
at
at
at
at
at
at
at
at
at
VW
VW
VW
VW
VW
VW
VW
VW
VW
VW
VW
VW
VW
VW
VW
VW
Mh
aH
aH
aH
aH
aH
aH
"}
(10,1,1) = {"
aH
Mh
ye
ye
ye
ay
ay
ay
aq
aq
aq
AR
AR
aI
at
at
at
aL
aL
aL
ac
ac
ab
aO
at
VW
VW
VW
VW
VW
VW
VW
VW
VW
VW
VW
VW
VW
VW
VW
VW
Mh
Mh
aH
aH
aH
aH
aH
"}
(11,1,1) = {"
aH
Mh
ye
ye
ye
ay
ay
ay
ay
ay
ae
AR
AR
AR
aW
Gt
ax
ac
ac
ac
ac
ac
ac
aO
at
VW
VW
VW
VW
VW
VW
VW
VW
VW
VW
VW
VW
VW
VW
VW
VW
VW
Mh
Mh
aH
aH
aH
aH
"}
(12,1,1) = {"
aH
Mh
ye
ye
ye
ay
ay
ay
ay
aq
aq
AR
AR
aI
at
at
at
ac
ac
ac
ac
ac
ac
QC
at
VW
VW
VW
VW
VW
VW
VW
VW
VW
VW
VW
VW
VW
VW
VW
VW
VW
VW
Mh
aH
aH
aH
Mh
"}
(13,1,1) = {"
aH
Mh
Mh
ye
ay
ay
ay
Mh
Mh
Mh
Mh
Mh
Mh
Mh
Mh
Mh
at
ac
wP
ac
ac
ac
ac
aO
at
VW
VW
VW
VW
VW
VW
VW
VW
VW
VW
VW
VW
VW
VW
VW
VW
VW
VW
Mh
aH
aH
aH
aH
"}
(14,1,1) = {"
aH
ay
Mh
ay
ay
ay
ay
Mh
VW
VW
VW
VW
at
at
at
at
at
at
at
at
at
az
aC
az
at
at
at
at
at
at
at
at
VW
VW
VW
VW
VW
VW
ye
ye
VW
VW
VW
Mh
aH
aH
aH
aH
"}
(15,1,1) = {"
aH
ay
ay
ay
ay
ay
Mh
Mh
VW
VW
VW
VW
at
aZ
ac
aZ
at
ac
ac
ac
ab
ac
ac
ac
at
ac
ac
ac
ab
ac
ac
at
at
at
VW
VW
VW
ye
ye
ye
ye
VW
VW
Mh
Mh
aH
aH
aH
"}
(16,1,1) = {"
aH
ay
ay
ay
ay
ay
Mh
VW
VW
VW
VW
VW
at
aU
ac
ac
ax
ac
ac
ac
ac
ac
ac
ac
am
ac
hC
ac
hC
ac
ac
ac
ac
at
at
at
VW
ye
ye
ye
ye
ye
VW
VW
Mh
aH
aH
aH
"}
(17,1,1) = {"
ay
ay
ay
ay
ay
ay
Mh
Mh
VW
VW
VW
VW
at
tM
ac
aD
at
ac
ac
ac
ac
ac
ac
ac
am
ac
aN
ac
aN
ac
hC
ac
ac
ab
ac
at
VW
ye
ye
hJ
ye
ye
ye
VW
Mh
Mh
aH
aH
"}
(18,1,1) = {"
ay
Mh
Mh
cz
ay
ay
ay
Mh
VW
VW
VW
VW
at
aK
ac
aY
at
ac
ac
aM
CV
aM
ac
ac
az
ac
OE
ac
aN
ac
aN
ac
VC
ac
ac
at
at
ye
hJ
hJ
hJ
ye
ye
VW
VW
Mh
aH
aH
"}
(19,1,1) = {"
Mh
Mh
ye
ye
ay
ay
ay
Mh
VW
VW
VW
at
at
at
at
at
at
ac
ac
Jb
av
YM
ac
ac
at
ac
BX
ac
BX
ac
BX
ac
ac
ac
ac
QC
at
rO
hJ
hJ
hJ
ye
ye
ye
VW
Mh
Mh
aH
"}
(20,1,1) = {"
Mh
Mh
ye
ye
ay
ay
ay
Mh
Mh
VW
VW
at
aB
ac
ab
Cq
at
Cv
ac
Jb
hQ
YM
ac
ac
an
aM
aM
aM
aM
aM
aM
aM
av
ac
ac
ac
az
Cb
hJ
hJ
hJ
ye
ye
ye
VW
VW
Mh
Mh
"}
(21,1,1) = {"
aH
Mh
ye
ye
ye
ay
ay
ay
Mh
VW
VW
at
aw
ac
ac
ap
at
aU
ac
Jb
QV
YM
ac
aX
at
aQ
aM
aM
aM
aM
aM
aM
ar
ac
ac
ac
az
Cb
hJ
hJ
hJ
hJ
ye
ye
ye
VW
VW
Mh
"}
(22,1,1) = {"
aH
Mh
ye
ye
ye
ay
ay
ay
Mh
Mh
VW
at
uu
ac
ao
aT
am
ac
ac
Jb
ar
YM
ac
ac
an
aM
aM
aM
aM
aM
aM
aM
av
ac
ac
ac
az
Cb
hJ
hJ
hJ
hJ
ye
ye
ye
VW
VW
Mh
"}
(23,1,1) = {"
aH
Mh
Mh
Mh
ye
Mh
ay
ay
ay
Mh
VW
at
aF
ac
ac
aA
am
ac
ac
Jb
av
YM
ac
ac
at
ac
hC
ac
hC
ac
hC
ac
ac
ac
ac
Ff
at
rO
hJ
hJ
hJ
ye
ye
ye
ye
VW
Mh
Mh
"}
(24,1,1) = {"
aH
aH
aH
Mh
ye
Mh
ay
ay
ay
Mh
VW
at
at
ac
Cv
ac
az
ac
ac
aM
lQ
aM
ac
ac
am
ac
aN
ac
aN
ac
aN
ac
VC
ac
ac
at
at
ye
hJ
hJ
ye
ye
ye
ye
VW
VW
Mh
aH
"}
(25,1,1) = {"
aH
aH
aH
Mh
Mh
Mh
Mh
ay
ay
Mh
VW
VW
at
ag
ac
ac
aC
ac
ac
ac
ac
ac
ac
ac
am
ac
aN
ac
aN
ac
BX
ac
ac
wP
ac
at
ye
ye
ye
ye
ye
ye
VW
VW
VW
VW
Mh
aH
"}
(26,1,1) = {"
aH
aH
aH
ay
ay
Mh
ay
ay
ay
Mh
VW
VW
at
ai
ac
ac
az
ac
ac
ac
ac
ac
ac
ac
az
ac
BX
ac
BX
ac
ac
ac
ac
at
at
at
VW
ye
ye
ye
ye
VW
VW
VW
VW
Mh
Mh
aH
"}
(27,1,1) = {"
aH
aH
ay
ay
ay
ay
ay
ay
Mh
Mh
VW
VW
at
Mi
wP
ac
at
ac
ac
ac
wP
ac
ac
ac
at
ac
ac
ac
wP
ac
ac
at
at
at
VW
VW
VW
ye
ye
VW
VW
VW
Mh
Mh
Mh
Mh
aH
aH
"}
(28,1,1) = {"
aH
aH
Mh
ay
ay
ay
ay
ay
Mh
VW
VW
VW
at
at
at
at
at
at
at
ax
at
at
at
at
at
at
at
ak
at
at
at
at
VW
VW
VW
VW
VW
VW
VW
VW
VW
Mh
Mh
aH
aH
aH
aH
aH
"}
(29,1,1) = {"
aH
Mh
Mh
Mh
Mh
Mh
ay
ay
Mh
VW
VW
VW
at
al
ac
ac
ac
ab
ac
ac
ac
QC
at
VW
at
at
ac
ac
ac
at
at
VW
VW
VW
VW
VW
VW
VW
VW
VW
VW
Mh
aH
aH
aH
aH
aH
aH
"}
(30,1,1) = {"
aH
Mh
Mh
Mh
Mh
ay
ay
ay
Mh
VW
VW
VW
at
Dy
ac
ac
uN
uN
ac
ac
ac
Iv
at
VW
at
hC
ac
ac
ac
pZ
at
VW
VW
VW
VW
VW
VW
VW
VW
VW
VW
Mh
aH
aH
aH
aH
aH
aH
"}
(31,1,1) = {"
aH
aH
Mh
Mh
ay
ay
ay
ay
Mh
VW
VW
VW
at
al
ac
ao
lx
lC
aS
ac
ac
Iv
at
VW
at
dg
ac
ac
ac
Dm
at
VW
VW
VW
VW
VW
VW
VW
VW
VW
Mh
Mh
aH
aH
aH
aH
aH
aH
"}
(32,1,1) = {"
aH
aH
aH
aH
aH
ay
ay
Mh
Mh
VW
VW
VW
at
aU
ac
ao
lx
lC
aS
ac
ac
bl
at
VW
at
BX
ac
ac
ac
MU
at
VW
VW
VW
VW
VW
VW
VW
VW
VW
Mh
aH
aH
aH
aH
aH
aH
VW
"}
(33,1,1) = {"
aH
aH
aH
aH
aH
aH
Mh
Mh
VW
VW
VW
VW
at
ac
ac
ac
vs
vs
ac
ac
ac
ac
at
VW
at
at
gf
kB
xz
at
at
VW
VW
VW
VW
VW
VW
VW
Mh
Mh
Mh
aH
aH
VW
VW
VW
aH
aH
"}
(34,1,1) = {"
aH
aH
aH
aH
aH
aH
Mh
VW
VW
VW
VW
VW
at
ac
ac
ac
ac
ac
ac
ac
ac
ac
at
VW
VW
at
at
at
at
at
VW
VW
VW
VW
VW
VW
VW
Mh
Mh
aH
aH
aH
aH
aH
VW
VW
VW
aH
"}
(35,1,1) = {"
aH
aH
aH
aH
aH
aH
Mh
VW
VW
VW
VW
VW
at
cF
ac
cF
ac
pz
ac
cF
ac
cF
at
VW
VW
VW
VW
VW
VW
VW
VW
VW
VW
VW
VW
VW
Mh
Mh
aH
aH
aH
aH
aH
aH
aH
aH
aH
aH
"}
(36,1,1) = {"
aH
aH
aH
aH
aH
aH
Mh
Mh
VW
VW
VW
VW
at
at
at
at
at
at
at
at
at
at
at
VW
VW
VW
VW
VW
VW
VW
VW
VW
VW
VW
Mh
Mh
Mh
aH
aH
aH
aH
aH
aH
aH
VW
VW
aH
aH
"}
(37,1,1) = {"
aH
aH
aH
aH
aH
aH
aH
Mh
VW
VW
VW
VW
VW
VW
VW
VW
VW
VW
VW
VW
VW
VW
VW
VW
VW
VW
VW
VW
VW
VW
VW
VW
VW
Mh
Mh
aH
aH
aH
aH
aH
aH
aH
aH
aH
VW
VW
aH
aH
"}
(38,1,1) = {"
aH
aH
aH
aH
aH
aH
aH
Mh
Mh
VW
VW
VW
VW
VW
VW
VW
VW
VW
VW
VW
VW
VW
VW
VW
VW
VW
VW
VW
VW
VW
VW
VW
VW
Mh
aH
aH
aH
aH
aH
aH
aH
aH
aH
VW
VW
VW
aH
aH
"}
(39,1,1) = {"
aH
aH
aH
aH
aH
aH
aH
aH
Mh
Mh
VW
VW
VW
VW
VW
VW
VW
VW
VW
VW
VW
VW
VW
VW
VW
Mh
Mh
Mh
Mh
Mh
VW
VW
Mh
Mh
aH
aH
aH
Mh
Mh
aH
aH
aH
VW
VW
VW
VW
aH
aH
"}
(40,1,1) = {"
aH
aH
aH
aH
aH
aH
aH
aH
aH
Mh
Mh
VW
VW
VW
VW
VW
Mh
Mh
Mh
Mh
Mh
Mh
Mh
Mh
Mh
Mh
aH
aH
aH
Mh
Mh
Mh
Mh
aH
aH
aH
aH
Mh
aH
aH
aH
VW
VW
VW
VW
aH
aH
aH
"}
(41,1,1) = {"
aH
aH
aH
aH
aH
aH
aH
aH
aH
aH
Mh
Mh
Mh
VW
VW
Mh
Mh
aH
aH
aH
aH
aH
aH
aH
aH
aH
aH
aH
aH
aH
aH
aH
aH
aH
aH
aH
Mh
Mh
aH
aH
aH
VW
VW
VW
aH
aH
aH
aH
"}
(42,1,1) = {"
aH
aH
aH
aH
aH
aH
aH
aH
aH
aH
aH
aH
Mh
Mh
Mh
Mh
aH
aH
aH
aH
aH
aH
aH
aH
aH
aH
aH
aH
aH
aH
aH
aH
aH
Mh
aH
aH
aH
aH
aH
aH
aH
aH
aH
aH
aH
aH
aH
aH
"}
