//MAP CONVERTED BY dmm2tgm.py THIS HEADER COMMENT PREVENTS RECONVERSION, DO NOT REMOVE
"aa" = (
/obj/effect/landmark/burnturf,
/turf/simulated/floor/clockwork/reebe,
/area/ruin/space/clockwork_site)
"ab" = (
/obj/machinery/light{
	dir = 8
	},
/turf/simulated/floor/clockwork,
/area/ruin/space/clockwork_site)
"ac" = (
/turf/simulated/floor/clockwork,
/area/ruin/space/clockwork_site)
"ad" = (
/obj/structure/table/reinforced/brass,
/obj/item/screwdriver/brass,
/turf/simulated/floor/clockwork,
/area/ruin/space/clockwork_site)
"ae" = (
/obj/structure/falsewall/rock_ancient,
/turf/simulated/floor/plating/asteroid/airless,
/area/ruin/unpowered)
"ag" = (
/obj/structure/table/reinforced/brass,
/obj/item/stack/cable_coil/orange,
/obj/item/stack/cable_coil/orange{
	pixel_x = 2;
	pixel_y = 4
	},
/obj/item/stack/cable_coil/orange{
	pixel_x = 4;
	pixel_y = 7
	},
/obj/item/wirecutters/brass,
/turf/simulated/floor/clockwork,
/area/ruin/space/clockwork_site)
"ah" = (
/turf/simulated/mineral/ancient,
/area/ruin/space/clockwork_site)
"ai" = (
/obj/structure/table/reinforced/brass,
/obj/item/weldingtool/experimental/brass,
/turf/simulated/floor/clockwork,
/area/ruin/space/clockwork_site)
"ak" = (
/obj/effect/clockwork/overlay/floor,
/obj/machinery/door/airlock/clockwork,
/turf/simulated/floor/clockwork/reebe,
/area/ruin/space/clockwork_site)
"al" = (
/obj/structure/dresser,
/turf/simulated/floor/clockwork,
/area/ruin/space/clockwork_site)
"am" = (
/obj/structure/window/reinforced/clockwork/fulltile,
/obj/structure/grille/ratvar,
/turf/simulated/floor/clockwork/reebe,
/area/ruin/space/clockwork_site)
"an" = (
/obj/machinery/door/airlock/clockwork/glass,
/turf/simulated/floor/carpet/royalblack,
/area/ruin/space/clockwork_site)
"ao" = (
/obj/structure/chair/brass,
/turf/simulated/floor/clockwork,
/area/ruin/space/clockwork_site)
"ap" = (
/obj/structure/table/reinforced/brass,
/obj/item/stack/tile/brass/fifty,
/turf/simulated/floor/clockwork,
/area/ruin/space/clockwork_site)
"aq" = (
/turf/simulated/mineral/ancient,
/area/ruin/unpowered)
"ar" = (
/obj/structure/table/reinforced/brass,
/obj/item/clockwork/component/belligerent_eye,
/turf/simulated/floor/carpet/royalblack,
/area/ruin/space/clockwork_site)
"at" = (
/turf/simulated/wall/clockwork,
/area/ruin/space/clockwork_site)
"av" = (
/obj/structure/table/reinforced/brass,
/turf/simulated/floor/carpet/royalblack,
/area/ruin/space/clockwork_site)
"aw" = (
/obj/structure/shelf/clockwork,
/obj/item/clockwork/component/belligerent_eye/blind_eye,
/obj/item/clockwork/alloy_shards/pinion_lock,
/obj/item/clockwork/alloy_shards/small,
/turf/simulated/floor/clockwork,
/area/ruin/space/clockwork_site)
"ax" = (
/obj/machinery/door/airlock/clockwork,
/turf/simulated/floor/clockwork,
/area/ruin/space/clockwork_site)
"ay" = (
/turf/simulated/floor/plating/asteroid/airless,
/area/ruin/unpowered)
"az" = (
/obj/structure/grille/ratvar,
/obj/structure/window/reinforced/clockwork/fulltile,
/turf/simulated/floor/clockwork/reebe,
/area/ruin/space/clockwork_site)
"aA" = (
/obj/structure/table/reinforced/brass,
/obj/item/crowbar/brass,
/obj/item/wrench/brass,
/turf/simulated/floor/clockwork,
/area/ruin/space/clockwork_site)
"aB" = (
/obj/structure/shelf/clockwork,
/obj/item/reagent_containers/glass/bottle/copper,
/obj/item/reagent_containers/glass/bottle/copper,
/obj/item/reagent_containers/glass/bottle/copper,
/obj/item/reagent_containers/glass/bottle/copper,
/obj/item/reagent_containers/glass/bottle/copper,
/obj/item/reagent_containers/glass/bottle/copper,
/turf/simulated/floor/clockwork,
/area/ruin/space/clockwork_site)
"aC" = (
/obj/machinery/door/airlock/clockwork/glass,
/turf/simulated/floor/clockwork,
/area/ruin/space/clockwork_site)
"aD" = (
/obj/structure/table/reinforced/brass,
/obj/item/storage/firstaid/regular,
/turf/simulated/floor/clockwork,
/area/ruin/space/clockwork_site)
"aF" = (
/obj/structure/gunrack/clockwork,
/obj/item/clockwork/weapon/ratvarian_spear,
/obj/item/clockwork/weapon/ratvarian_spear,
/turf/simulated/floor/clockwork,
/area/ruin/space/clockwork_site)
"aH" = (
/turf/space,
/area/space)
"aI" = (
/obj/machinery/light/small,
/turf/simulated/floor/plating/asteroid/airless,
/area/ruin/unpowered)
"aK" = (
/obj/machinery/optable,
/turf/simulated/floor/clockwork,
/area/ruin/space/clockwork_site)
"aL" = (
/obj/structure/table/reinforced/brass,
/obj/item/tank/internals/oxygen,
/obj/item/clothing/mask/breath,
/turf/simulated/floor/clockwork,
/area/ruin/space/clockwork_site)
"aM" = (
/turf/simulated/floor/carpet/royalblack,
/area/ruin/space/clockwork_site)
"aN" = (
/obj/structure/chair/sofa/pew/clockwork,
/turf/simulated/floor/clockwork,
/area/ruin/space/clockwork_site)
"aO" = (
/obj/structure/table/reinforced/brass,
/turf/simulated/floor/clockwork,
/area/ruin/space/clockwork_site)
"aP" = (
/obj/item/clockwork/alloy_shards/clockgolem_remains,
/turf/simulated/floor/clockwork,
/area/ruin/space/clockwork_site)
"aQ" = (
/obj/machinery/light{
	dir = 1
	},
/turf/simulated/floor/carpet/royalblack,
/area/ruin/space/clockwork_site)
"aR" = (
/obj/item/bedsheet/brown,
/obj/structure/bed,
/turf/simulated/floor/clockwork,
/area/ruin/space/clockwork_site)
"aS" = (
/obj/structure/chair/brass{
	dir = 1
	},
/turf/simulated/floor/clockwork,
/area/ruin/space/clockwork_site)
"aT" = (
/obj/structure/table/reinforced/brass,
/obj/item/clockwork/alloy_shards{
	pixel_y = 3
	},
/turf/simulated/floor/clockwork,
/area/ruin/space/clockwork_site)
"aU" = (
/obj/machinery/light{
	dir = 1
	},
/turf/simulated/floor/clockwork,
/area/ruin/space/clockwork_site)
"aW" = (
/obj/structure/fans/tiny,
/obj/machinery/door/airlock/clockwork,
/turf/simulated/floor/clockwork,
/area/ruin/space/clockwork_site)
"aX" = (
/obj/machinery/light,
/turf/simulated/floor/clockwork,
/area/ruin/space/clockwork_site)
"aY" = (
/obj/structure/table/reinforced/brass,
/obj/item/storage/surgical_tray{
	pixel_y = 8
	},
/turf/simulated/floor/clockwork,
/area/ruin/space/clockwork_site)
"aZ" = (
/obj/machinery/sleeper/clockwork{
	dir = 4
	},
/turf/simulated/floor/clockwork,
/area/ruin/space/clockwork_site)
"dg" = (
/obj/machinery/light/small{
	dir = 1
	},
/turf/simulated/floor/clockwork,
/area/ruin/space/clockwork_site)
"hC" = (
/obj/structure/chair/sofa/pew/clockwork/left,
/turf/simulated/floor/clockwork,
/area/ruin/space/clockwork_site)
"jR" = (
/obj/structure/shelf/clockwork,
/obj/item/clockwork/alloy_shards/large,
/obj/item/clockwork/component/geis_capacitor/fallen_armor,
/obj/item/clockwork/alloy_shards/medium,
/turf/simulated/floor/clockwork,
/area/ruin/space/clockwork_site)
"tM" = (
/obj/machinery/computer/operating/clockwork,
/turf/simulated/floor/clockwork,
/area/ruin/space/clockwork_site)
"wP" = (
/obj/machinery/light{
	dir = 4
	},
/turf/simulated/floor/clockwork,
/area/ruin/space/clockwork_site)
"BX" = (
/obj/structure/chair/sofa/pew/clockwork/right,
/turf/simulated/floor/clockwork,
/area/ruin/space/clockwork_site)
"Cq" = (
/obj/structure/shelf/clockwork,
/turf/simulated/floor/clockwork,
/area/ruin/space/clockwork_site)
"Dm" = (
/obj/machinery/light/small,
/turf/simulated/floor/clockwork,
/area/ruin/space/clockwork_site)
"Gt" = (
/obj/machinery/light/small{
	dir = 4
	},
/turf/simulated/floor/clockwork,
/area/ruin/space/clockwork_site)
"Mh" = (
/obj/effect/landmark/damageturf,
/obj/item/paper/clockwork_cult_message,
/turf/simulated/floor/clockwork/reebe,
/area/ruin/space/clockwork_site)
"OE" = (
/obj/structure/chair/sofa/pew/clockwork,
/obj/structure/chair/sofa/pew/clockwork,
/turf/simulated/floor/clockwork,
/area/ruin/space/clockwork_site)

(1,1,1) = {"
aH
aH
aH
aH
aH
aH
aH
aH
aH
aH
aH
aH
aH
aH
aH
aH
aH
aH
aH
aH
aH
aH
aH
aH
aH
aH
aH
aH
aH
aH
aH
aH
aH
aH
aH
aH
aH
aH
aH
aH
aH
aH
aH
aH
aH
"}
(2,1,1) = {"
aH
aH
aH
aH
aH
aH
aH
aH
aH
aH
aH
aH
aH
aH
aH
aH
aH
aH
aH
aH
aH
aH
aH
aH
aH
aH
aH
aH
aH
aH
aH
aH
aH
aH
aH
aH
aH
aH
aH
aH
aH
aH
aH
aH
aH
"}
(3,1,1) = {"
aH
aH
aH
aH
aH
aH
aq
aq
aH
aH
aH
aH
aH
aH
aH
aH
aH
aH
aH
aH
aH
aH
aH
aH
aH
aH
aH
aH
aH
aH
aH
aH
aH
aH
aH
aH
aH
aH
aH
aH
aH
aH
aH
aH
aH
"}
(4,1,1) = {"
aH
aH
aH
aH
aH
aq
aq
aq
aq
aH
aH
aH
aH
aH
aH
aH
aH
aH
aH
aH
aH
aH
aH
aH
aH
aH
aH
aH
aH
aH
aH
aH
aH
aH
aH
aH
aH
aH
aH
aH
aH
aH
aH
aH
aH
"}
(5,1,1) = {"
aH
aH
aH
aH
aH
aq
aq
aq
aq
aq
aH
aH
aH
aH
aH
aH
aH
aH
aH
aH
aH
aH
aH
aH
aH
aH
aH
aH
aH
aH
aH
aH
aH
aH
aH
aH
aH
aH
aH
aH
aH
aH
aH
aH
aH
"}
(6,1,1) = {"
aH
aH
aH
aH
aq
aq
aq
aq
aq
aq
aH
aH
aH
aH
aH
aH
aH
aH
aH
aq
aq
aq
aq
aH
aH
aH
aH
aH
aH
aH
aH
aH
aH
aH
aH
aH
aH
aH
aH
aH
aH
aH
aH
aH
aH
"}
(7,1,1) = {"
aH
aH
aH
aq
aq
aq
aq
aq
aq
aH
aH
aH
aH
aH
aq
aq
aq
aq
aq
aq
aq
aq
aq
aq
aq
aH
aH
aH
aH
aH
aH
aH
aH
aH
aH
aH
aH
aH
aH
aH
aH
aH
aH
aH
aH
"}
(8,1,1) = {"
aH
aH
aH
aq
aq
aq
aq
aq
aH
aH
aH
aH
aH
aq
aq
aq
aq
aq
aq
aq
aq
aq
aq
aq
aq
aH
aH
aH
aH
aH
aH
aH
aH
aH
aH
aH
aH
aH
aH
aH
aH
aH
aH
aH
aH
"}
(9,1,1) = {"
aH
aH
aH
aq
aq
aq
aq
aH
aH
aH
aH
aq
aq
aq
aq
aq
aq
aq
at
at
at
at
at
aq
aq
aq
aq
aH
aH
aH
aH
aH
aH
aH
aH
aH
aH
aH
aH
aH
aH
aH
aH
aH
aH
"}
(10,1,1) = {"
aH
aH
aH
aq
aq
aq
aq
aH
aH
aH
aq
aq
aq
ay
ay
aI
at
at
at
aL
aL
aL
at
aq
aq
aq
aq
aq
aq
aq
aq
aH
aH
aH
aH
aH
aH
aH
aH
aH
aH
aH
aH
aH
aH
"}
(11,1,1) = {"
aH
aH
aH
aq
aq
aq
aq
aH
aH
aH
ay
ay
ae
ay
ay
ay
aW
Gt
ax
ac
ac
aX
at
aq
aq
aq
aq
aq
aq
aq
aq
aq
aq
aH
aH
aH
aH
aH
aH
aH
aH
aH
aH
aH
aH
"}
(12,1,1) = {"
aH
aH
aH
aq
aq
aq
aq
aH
aH
ay
ay
aq
aq
ay
ay
aI
at
at
at
ac
ac
ac
at
aq
aq
aq
aq
aq
aq
aq
aq
aq
aq
aq
aq
aq
aH
aH
aH
aH
aH
aH
aH
aH
aH
"}
(13,1,1) = {"
aH
aH
aH
aq
aq
aq
aH
aH
aH
aq
aq
aq
aq
aq
aq
aq
ah
ah
at
ac
ac
ac
at
aq
aq
aq
aq
aq
aq
aq
aq
aq
aq
aq
aq
aq
aq
aq
aq
aH
aH
aH
aH
aH
aH
"}
(14,1,1) = {"
aH
aH
aH
aH
aq
aH
aH
aH
aH
aH
aq
aq
aq
aq
at
at
at
at
at
az
aC
az
at
at
at
at
at
at
at
at
at
at
at
at
aq
aq
aq
aq
aq
aq
aq
aH
aH
aH
aH
"}
(15,1,1) = {"
aH
aH
aH
aH
aH
aH
aH
aH
aH
aH
aq
aq
aq
aq
at
aZ
ac
aZ
at
ac
ac
ac
at
ac
ac
ac
am
ac
ac
ac
ab
ac
ac
at
at
at
aq
aq
aq
aq
aq
aH
aH
aH
aH
"}
(16,1,1) = {"
aH
aH
aH
aH
aH
aH
aH
aH
aH
aH
aq
aq
aq
aq
at
aU
ac
ac
ax
ac
ac
ac
at
ac
ac
aS
am
ac
hC
ac
hC
ac
ac
ac
ac
at
at
at
aq
aq
aq
aH
aH
aH
aH
"}
(17,1,1) = {"
aH
aH
aH
aH
aH
aH
aH
aH
aH
aH
aq
aq
aq
aq
at
tM
ac
aD
at
ac
ac
aX
at
ac
ac
aS
am
ac
aN
ac
aN
ac
hC
ac
ac
ab
ac
at
aq
aq
aq
aq
aH
aH
aH
"}
(18,1,1) = {"
aH
aH
aH
aq
aq
aH
aH
aH
aH
aH
aq
aq
aq
aq
at
aK
ac
aY
at
ac
ac
ac
at
ac
ac
ac
am
ac
OE
ac
aN
ac
aN
ac
ac
ac
ac
at
at
aq
aq
aq
aH
aH
aH
"}
(19,1,1) = {"
aH
aH
aq
aq
aq
aq
aH
aH
aH
aH
aq
aq
aq
at
at
at
at
at
at
ac
ac
ac
at
ac
ac
aP
at
ac
BX
ac
BX
ac
BX
ac
ac
ac
ac
ac
at
aq
aq
aq
aH
aH
aH
"}
(20,1,1) = {"
aH
aH
aq
aq
aq
aq
aH
aH
aH
aH
aq
aq
aq
at
aB
ac
ab
Cq
at
ac
ac
aP
at
ac
ac
ac
an
aM
aM
aM
aM
aM
aM
aM
av
ac
ac
ac
at
aq
aq
aq
aq
aH
aH
"}
(21,1,1) = {"
aH
aH
aH
aq
aq
aq
aq
aH
aH
aH
aq
aq
aq
at
aw
ac
ac
ap
az
ac
ac
ac
ax
ac
ac
aX
at
aQ
aM
aM
aM
aM
aM
aM
ar
ac
ac
ac
at
aq
aq
aq
aq
aH
aH
"}
(22,1,1) = {"
aH
aH
aH
aq
aq
aq
aq
aH
aH
aH
aq
aq
aq
at
jR
ac
ao
aT
am
ac
ac
aP
at
ac
ac
ac
an
aM
aM
aM
aM
aM
aM
aM
av
ac
ac
ac
at
aq
aq
aq
aq
aH
aH
"}
(23,1,1) = {"
aH
aH
aH
aq
aq
aq
aq
aq
aH
aH
aH
aq
aq
at
aF
ac
ac
aA
am
ac
ac
ac
at
ac
ac
aP
at
ac
hC
ac
hC
ac
hC
ac
ac
ac
ac
ac
at
aq
aq
aq
aq
aH
aH
"}
(24,1,1) = {"
aH
aH
aH
aH
aH
aq
aq
aq
aH
aH
aH
aq
aq
at
at
ac
ac
ac
az
ac
ac
ac
at
ac
ac
ac
am
ac
aN
ac
aN
ac
aN
ac
ac
ac
ac
at
at
aq
aq
aq
aH
aH
aH
"}
(25,1,1) = {"
aH
aH
aH
aH
aH
aq
aq
aq
aq
aH
aH
aq
aq
aq
at
ag
ac
ac
aC
ac
ac
aX
at
ac
ac
aS
am
ac
aN
ac
aN
ac
BX
ac
ac
wP
ac
at
aq
aq
aq
aq
aH
aH
aH
"}
(26,1,1) = {"
aH
aH
aH
aH
aH
aH
aq
aq
aH
aH
aH
aq
aq
aq
at
ai
ac
ac
az
ac
ac
ac
at
ac
ac
aS
am
ac
BX
ac
BX
ac
ac
ac
ac
at
at
at
aq
aq
aq
aq
aH
aH
aH
"}
(27,1,1) = {"
aH
aH
aH
aH
aH
aH
aH
aH
aH
aH
aq
aq
aq
aq
at
ad
wP
ac
at
ac
ac
ac
at
ac
ac
ac
am
ac
ac
ac
wP
ac
ac
at
at
at
aq
aq
aq
aq
aq
aH
aH
aH
aH
"}
(28,1,1) = {"
aH
aH
aH
aH
aH
aH
aH
aH
aH
aH
aq
aq
aq
aq
at
at
at
at
at
at
ax
at
at
at
at
at
at
at
at
ak
at
at
at
at
aq
aq
aq
aq
aq
aH
aH
aH
aH
aH
aH
"}
(29,1,1) = {"
aH
aH
aH
aH
aH
aH
aH
aH
aH
aH
aH
aq
aq
aq
at
al
ac
ac
ac
ac
ac
ac
at
aq
aq
aq
at
at
ac
ac
ac
at
at
aq
aq
aq
aq
aq
aH
aH
aH
aH
aH
aH
aH
"}
(30,1,1) = {"
aH
aH
aH
aH
aH
aH
aH
aH
aH
aH
aH
aH
aq
aq
at
ac
ac
ao
aO
aS
ac
ac
at
aq
aq
aq
at
ac
aa
aa
aa
ac
at
aq
aq
aq
aq
aq
aH
aH
aH
aH
aH
aH
aH
"}
(31,1,1) = {"
aH
aH
aH
aH
aH
aH
aH
aH
aH
aH
aH
aq
aq
aq
at
aU
ac
ao
aO
aS
ac
aX
at
aq
aq
aq
at
dg
aa
Mh
aa
Dm
at
aq
aq
aq
aq
aH
aH
aH
aH
aH
aH
aH
aH
"}
(32,1,1) = {"
aH
aH
aH
aH
aH
aH
aH
aH
aH
aH
aH
aH
aq
aq
at
ac
ac
ac
ac
ac
ac
ac
at
aq
aq
aq
at
ac
aa
aa
aa
ac
at
aq
aq
aq
aq
aH
aH
aH
aH
aH
aH
aH
aH
"}
(33,1,1) = {"
aH
aH
aH
aH
aH
aH
aH
aH
aH
aH
aH
aH
aq
aq
at
aR
ac
aR
ac
aR
ac
aR
at
aq
aq
aq
at
at
ac
Gt
ac
at
at
aq
aq
aq
aH
aH
aH
aH
aH
aH
aH
aH
aH
"}
(34,1,1) = {"
aH
aH
aH
aH
aH
aH
aH
aH
aH
aH
aH
aH
aq
aq
at
at
at
at
at
at
at
at
at
aq
aq
aq
at
at
at
at
at
at
at
aq
aq
aH
aH
aH
aH
aH
aH
aH
aH
aH
aH
"}
(35,1,1) = {"
aH
aH
aH
aH
aH
aH
aH
aH
aH
aH
aH
aH
aq
aq
aq
aq
aq
aq
aq
aq
aq
aq
aq
aq
aq
aq
aq
aq
aq
aq
aq
aq
aq
aq
aq
aH
aH
aH
aH
aH
aH
aH
aH
aH
aH
"}
(36,1,1) = {"
aH
aH
aH
aH
aH
aH
aH
aH
aH
aH
aH
aH
aH
aq
aq
aq
aq
aq
aq
aq
aq
aq
aq
aq
aH
aq
aq
aq
aq
aq
aq
aq
aq
aq
aq
aH
aH
aH
aH
aH
aH
aH
aH
aH
aH
"}
(37,1,1) = {"
aH
aH
aH
aH
aH
aH
aH
aH
aH
aH
aH
aH
aH
aH
aH
aH
aH
aq
aq
aq
aH
aH
aq
aq
aH
aH
aH
aq
aq
aq
aq
aq
aq
aq
aH
aH
aH
aH
aH
aH
aH
aH
aH
aH
aH
"}
(38,1,1) = {"
aH
aH
aH
aH
aH
aH
aH
aH
aH
aH
aH
aH
aH
aH
aH
aH
aH
aH
aH
aH
aH
aH
aH
aH
aH
aH
aH
aH
aH
aH
aq
aq
aH
aH
aH
aH
aH
aH
aH
aH
aH
aH
aH
aH
aH
"}
(39,1,1) = {"
aH
aH
aH
aH
aH
aH
aH
aH
aH
aH
aH
aH
aH
aH
aH
aH
aH
aH
aH
aH
aH
aH
aH
aH
aH
aH
aH
aH
aH
aH
aH
aH
aH
aH
aH
aH
aH
aH
aH
aH
aH
aH
aH
aH
aH
"}
(40,1,1) = {"
aH
aH
aH
aH
aH
aH
aH
aH
aH
aH
aH
aH
aH
aH
aH
aH
aH
aH
aH
aH
aH
aH
aH
aH
aH
aH
aH
aH
aH
aH
aH
aH
aH
aH
aH
aH
aH
aH
aH
aH
aH
aH
aH
aH
aH
"}
