//MAP CONVERTED BY dmm2tgm.py THIS HEADER COMMENT PREVENTS RECONVERSION, DO NOT REMOVE
"a" = (
/turf/template_noop,
/area/template_noop)
"b" = (
/turf/simulated/floor/plating/airless,
/area/ruin/space/unpowered)
"c" = (
/turf/simulated/wall,
/area/ruin/space/unpowered)
"d" = (
/obj/structure/lattice,
/turf/template_noop,
/area/space/nearstation)
"h" = (
/obj/effect/decal/remains/human,
/obj/effect/decal/cleanable/blood/drip,
/turf/simulated/floor/plating/airless,
/area/ruin/space/unpowered)
"j" = (
/obj/effect/decal/cleanable/blood/gibs/xeno,
/turf/simulated/floor/plating/airless,
/area/ruin/space/unpowered)
"l" = (
/obj/effect/decal/cleanable/blood/drip,
/turf/simulated/floor/plating/airless,
/area/ruin/space/unpowered)
"w" = (
/obj/item/gun/energy/laser/retro,
/turf/simulated/floor/plating/airless,
/area/ruin/space/unpowered)
"y" = (
/mob/living/simple_animal/hostile/carp/megacarp,
/turf/template_noop,
/area/template_noop)
"B" = (
/obj/item/gun/energy/plasmacutter,
/turf/simulated/floor/plating/airless,
/area/ruin/space/unpowered)
"F" = (
/obj/effect/decal/remains/xeno,
/obj/effect/decal/cleanable/blood/gibs/xeno/body,
/obj/effect/decal/cleanable/blood/gibs/xeno,
/turf/simulated/floor/plating/airless,
/area/ruin/space/unpowered)
"G" = (
/mob/living/simple_animal/hostile/carp,
/turf/template_noop,
/area/template_noop)
"O" = (
/obj/effect/decal/remains/robot,
/turf/simulated/floor/plating/airless,
/area/ruin/space/unpowered)
"U" = (
/obj/structure/lattice,
/mob/living/simple_animal/hostile/megafauna/dragon/space_dragon,
/turf/template_noop,
/area/space/nearstation)
"V" = (
/obj/item/sellable/salvage/ruin,
/turf/simulated/floor/plating/airless,
/area/ruin/space/unpowered)
"Z" = (
/obj/effect/decal/cleanable/blood/gibs/xeno/core,
/obj/effect/decal/cleanable/blood/gibs/xeno,
/turf/simulated/floor/plating/airless,
/area/ruin/space/unpowered)

(1,1,1) = {"
a
a
a
a
a
a
a
a
a
a
a
a
a
a
a
a
a
a
a
a
a
a
a
a
a
a
a
a
a
a
a
a
a
a
a
a
a
a
a
a
"}
(2,1,1) = {"
a
a
a
a
a
a
a
a
a
a
a
a
a
a
a
a
a
a
a
a
a
a
a
a
a
a
a
a
a
a
a
a
a
a
a
a
a
a
a
a
"}
(3,1,1) = {"
a
a
a
a
a
a
a
a
a
a
a
a
a
a
a
a
a
a
a
a
a
a
a
a
a
a
a
a
a
c
c
c
c
c
a
a
a
a
a
a
"}
(4,1,1) = {"
a
a
a
a
a
a
a
a
a
a
a
a
a
a
a
a
a
a
a
a
a
a
a
a
a
a
a
a
b
b
b
b
b
b
c
a
a
a
a
a
"}
(5,1,1) = {"
a
a
a
a
a
a
a
a
a
a
a
a
a
a
a
a
a
a
a
a
a
a
a
a
a
a
a
a
b
b
b
b
b
b
b
c
a
a
a
a
"}
(6,1,1) = {"
a
a
a
a
a
a
a
a
a
a
a
a
a
a
a
a
a
a
a
a
a
a
a
a
a
a
a
a
a
d
b
b
b
b
b
c
a
a
a
a
"}
(7,1,1) = {"
a
a
a
a
a
a
a
a
a
a
a
a
a
a
a
a
a
a
a
a
a
a
a
a
a
a
a
a
a
d
d
d
b
b
b
c
a
a
a
a
"}
(8,1,1) = {"
a
a
a
a
a
a
a
a
a
a
a
a
a
a
a
a
a
a
a
a
a
a
a
a
a
a
a
a
a
d
d
d
b
b
b
c
a
a
a
a
"}
(9,1,1) = {"
a
a
a
a
a
a
a
a
a
a
a
a
a
a
a
a
a
a
a
a
a
a
a
a
a
a
a
a
a
a
d
d
d
b
b
c
a
a
a
a
"}
(10,1,1) = {"
a
a
a
a
a
a
a
a
a
a
a
a
a
a
a
a
a
a
a
a
a
a
a
a
a
a
a
a
a
a
d
d
d
b
b
a
a
a
a
a
"}
(11,1,1) = {"
a
a
a
a
a
a
a
a
a
a
a
a
a
a
a
a
a
a
a
a
a
a
a
a
a
a
a
a
a
d
d
a
d
d
b
a
a
a
a
a
"}
(12,1,1) = {"
a
a
a
a
a
a
a
a
a
a
a
a
a
a
a
a
a
a
a
a
a
a
a
a
a
a
a
a
a
a
a
a
a
a
a
a
a
a
a
a
"}
(13,1,1) = {"
a
a
a
a
a
a
a
a
a
a
a
a
G
a
G
a
a
a
a
a
a
a
a
a
a
a
d
d
a
a
a
a
a
a
a
a
a
a
a
a
"}
(14,1,1) = {"
a
a
a
a
a
a
a
a
a
a
a
a
a
a
a
a
a
a
a
a
a
a
a
d
d
d
d
a
a
a
a
a
a
a
a
a
a
a
a
a
"}
(15,1,1) = {"
a
a
a
a
a
a
a
a
a
a
a
a
a
a
a
a
a
a
a
a
a
d
d
d
d
d
a
a
a
a
a
a
a
a
a
a
a
a
a
a
"}
(16,1,1) = {"
a
a
a
a
a
a
a
a
G
a
a
a
y
a
a
a
a
a
a
b
b
b
b
d
d
d
a
a
a
a
a
a
a
a
a
a
a
a
a
a
"}
(17,1,1) = {"
a
a
a
a
a
a
a
a
a
a
a
a
a
a
a
a
d
d
b
b
c
j
b
b
d
a
a
a
a
a
a
a
a
a
a
a
a
a
a
a
"}
(18,1,1) = {"
a
a
a
a
a
a
a
a
a
a
a
a
a
a
a
d
d
b
b
b
c
F
B
j
d
a
a
a
a
a
a
a
a
a
a
a
a
a
a
a
"}
(19,1,1) = {"
a
a
a
a
a
a
a
G
a
a
a
a
a
a
d
d
b
b
b
b
c
Z
j
b
d
a
a
a
G
a
a
a
a
a
a
a
a
a
a
a
"}
(20,1,1) = {"
a
a
a
a
a
a
a
a
a
a
a
a
d
d
b
d
b
c
c
c
V
c
b
b
d
a
a
a
a
a
a
a
a
a
a
a
a
a
a
a
"}
(21,1,1) = {"
a
a
a
a
a
a
a
a
a
d
d
d
d
d
d
d
b
c
V
b
b
b
b
b
d
a
a
a
a
a
a
a
a
a
a
a
a
a
a
a
"}
(22,1,1) = {"
a
a
a
a
a
a
a
a
a
b
b
b
d
d
d
d
b
b
b
b
b
b
d
d
d
a
a
a
a
a
G
a
a
a
a
a
a
a
a
a
"}
(23,1,1) = {"
a
a
a
a
a
a
a
b
b
b
b
b
b
d
d
d
b
b
O
b
d
d
d
d
d
a
a
a
a
a
a
a
a
a
a
a
a
a
a
a
"}
(24,1,1) = {"
a
a
a
a
a
a
b
b
b
b
c
O
b
d
d
d
d
b
b
b
d
d
b
d
a
a
a
y
a
a
a
a
a
a
a
a
a
a
a
a
"}
(25,1,1) = {"
a
a
a
a
a
a
b
b
b
c
V
b
b
b
d
d
U
d
d
d
d
d
d
d
a
a
a
a
a
a
a
a
a
a
a
a
a
a
a
a
"}
(26,1,1) = {"
a
a
a
a
a
a
b
b
c
c
c
c
b
b
d
d
b
d
d
d
d
d
d
d
d
a
a
a
a
a
a
a
a
a
a
a
a
a
a
a
"}
(27,1,1) = {"
a
a
a
a
a
a
b
b
b
c
V
b
b
l
d
d
d
d
d
b
b
b
b
b
d
d
a
a
a
a
G
a
a
a
a
a
a
a
a
a
"}
(28,1,1) = {"
a
a
a
a
a
a
a
b
b
b
c
c
b
d
d
d
d
b
b
b
b
b
b
b
b
d
a
a
a
a
a
a
a
a
a
a
a
a
a
a
"}
(29,1,1) = {"
a
a
a
a
a
a
a
b
b
b
w
h
l
d
d
d
d
b
O
b
b
b
b
b
b
a
a
a
G
a
a
a
a
a
a
a
a
a
a
a
"}
(30,1,1) = {"
a
a
a
a
a
a
a
a
a
b
b
b
b
d
d
d
b
b
b
b
V
c
b
b
b
b
a
a
a
a
a
a
a
a
a
a
a
a
a
a
"}
(31,1,1) = {"
a
a
a
a
a
a
a
a
a
d
d
d
d
d
d
d
b
b
b
V
c
c
c
c
b
b
a
a
a
a
a
a
a
a
a
a
a
a
a
a
"}
(32,1,1) = {"
a
a
a
a
a
a
a
a
a
a
a
d
d
b
d
d
b
b
c
c
b
c
b
b
b
a
a
a
a
a
a
a
a
a
a
a
a
a
a
a
"}
(33,1,1) = {"
a
a
a
a
a
a
a
a
a
a
a
a
d
d
d
d
b
b
b
b
b
c
b
b
a
a
a
a
a
a
a
a
a
a
a
a
a
a
a
a
"}
(34,1,1) = {"
a
a
a
a
a
a
a
a
a
a
a
a
a
d
d
d
d
d
b
b
b
b
a
a
a
a
a
a
a
a
a
a
a
a
a
a
a
a
a
a
"}
(35,1,1) = {"
a
a
a
a
a
a
a
a
a
a
G
a
a
a
a
a
a
a
a
a
a
a
a
a
a
a
a
a
a
a
a
a
a
a
a
a
a
a
a
a
"}
(36,1,1) = {"
a
a
a
a
a
a
a
a
a
a
a
a
a
y
a
a
a
a
a
a
a
a
a
a
a
a
a
a
a
a
a
a
a
a
a
a
a
a
a
a
"}
(37,1,1) = {"
a
a
a
a
a
a
a
a
a
a
a
a
a
a
a
a
G
a
a
a
a
a
a
a
a
a
a
a
a
a
a
a
a
a
a
a
a
a
a
a
"}
(38,1,1) = {"
a
a
a
a
a
a
a
a
a
a
G
a
a
a
a
a
a
a
a
a
a
a
a
a
a
a
a
a
a
a
a
a
a
a
a
a
a
a
a
a
"}
(39,1,1) = {"
a
a
a
a
a
a
a
a
a
a
a
a
a
G
a
a
a
a
a
a
a
a
a
a
a
a
a
a
a
a
a
a
a
a
a
a
a
a
a
a
"}
(40,1,1) = {"
a
a
a
a
a
a
a
a
a
a
a
a
a
a
a
a
a
a
a
a
a
a
a
a
a
a
a
a
a
a
a
a
a
a
a
a
a
a
a
a
"}
