//MAP CONVERTED BY dmm2tgm.py THIS HEADER COMMENT PREVENTS RECONVERSION, DO NOT REMOVE
"a" = (
/turf/template_noop,
/area/template_noop)
"b" = (
/obj/structure/lattice,
/turf/template_noop,
/area/space/nearstation)
"c" = (
/turf/simulated/wall,
/area/ruin/space/unpowered)
"d" = (
/obj/structure/alien/weeds,
/obj/structure/alien/resin/wall,
/turf/simulated/floor/plating/airless,
/area/ruin/space/unpowered)
"e" = (
/obj/structure/girder,
/obj/structure/alien/weeds,
/turf/simulated/floor/plating/airless,
/area/ruin/space/unpowered)
"f" = (
/obj/structure/alien/weeds,
/turf/simulated/floor/plating/airless,
/area/ruin/space/unpowered)
"g" = (
/obj/structure/alien/weeds,
/obj/structure/table_frame,
/turf/simulated/floor/plating/airless,
/area/ruin/space/unpowered)
"h" = (
/obj/structure/alien/weeds/node,
/turf/simulated/floor/plating/airless,
/area/ruin/space/unpowered)
"i" = (
/obj/structure/alien/weeds,
/obj/structure/bed/nest,
/turf/simulated/floor/plating/airless,
/area/ruin/space/unpowered)
"j" = (
/obj/structure/alien/weeds,
/obj/structure/bed/nest,
/obj/effect/decal/remains/human,
/turf/simulated/floor/plating/airless,
/area/ruin/space/unpowered)
"k" = (
/obj/structure/alien/resin/wall,
/turf/simulated/floor/plating/airless,
/area/ruin/space/unpowered)
"m" = (
/obj/structure/alien/weeds,
/obj/structure/table,
/turf/simulated/floor/plating/airless,
/area/ruin/space/unpowered)
"n" = (
/obj/structure/alien/weeds,
/obj/effect/decal/remains/robot,
/turf/simulated/floor/plating/airless,
/area/ruin/space/unpowered)
"o" = (
/obj/structure/alien/weeds/node,
/obj/structure/table,
/turf/simulated/floor/plating/airless,
/area/ruin/space/unpowered)
"p" = (
/obj/structure/girder,
/turf/simulated/floor/plating/airless,
/area/ruin/space/unpowered)
"q" = (
/turf/simulated/floor/plating/airless,
/area/ruin/space/unpowered)
"r" = (
/obj/structure/alien/weeds,
/obj/structure/bed/nest,
/obj/effect/decal/remains/xeno,
/mob/living/basic/alien,
/turf/simulated/floor/plating/airless,
/area/ruin/space/unpowered)
"v" = (
/obj/structure/girder,
/turf/simulated/floor/plating/airless,
/area/space/nearstation)
"x" = (
/turf/simulated/floor/plating/airless,
/area/space/nearstation)
"F" = (
/obj/structure/alien/weeds/node,
/mob/living/basic/alien/maid,
/turf/simulated/floor/plating/airless,
/area/ruin/space/unpowered)
"G" = (
/obj/structure/alien/weeds,
/obj/structure/bed/nest,
/mob/living/basic/alien,
/turf/simulated/floor/plating/airless,
/area/ruin/space/unpowered)
"I" = (
/obj/structure/alien/weeds,
/obj/structure/table,
/obj/effect/spawner/random/pool/spaceloot/syndicate/mixed,
/turf/simulated/floor/plating/airless,
/area/ruin/space/unpowered)
"S" = (
/obj/structure/alien/weeds,
/obj/structure/bed/nest,
/obj/effect/decal/remains/human,
/mob/living/basic/alien,
/turf/simulated/floor/plating/airless,
/area/ruin/space/unpowered)

(1,1,1) = {"
a
a
a
a
a
a
a
a
a
a
a
a
a
a
a
a
a
a
a
a
a
a
a
a
a
a
a
a
a
a
a
"}
(2,1,1) = {"
a
a
a
a
a
a
a
a
a
a
a
a
a
a
a
a
a
a
a
a
a
a
a
a
a
b
b
b
a
a
a
"}
(3,1,1) = {"
a
a
a
a
a
a
a
a
a
a
a
a
a
a
a
a
a
a
a
a
a
a
a
a
b
p
p
p
c
a
a
"}
(4,1,1) = {"
a
a
a
a
a
a
a
a
a
a
a
a
a
a
a
a
a
a
a
a
a
a
a
b
b
c
q
q
c
a
a
"}
(5,1,1) = {"
a
a
a
a
a
a
a
a
a
a
a
a
a
a
a
a
a
a
a
a
a
a
b
b
q
q
q
q
c
b
a
"}
(6,1,1) = {"
a
a
a
a
a
a
a
a
a
a
a
a
a
a
a
a
a
a
a
a
a
a
a
b
q
q
q
q
c
b
a
"}
(7,1,1) = {"
a
a
a
a
a
a
a
a
a
a
a
a
a
a
a
a
a
a
a
a
a
a
a
c
q
q
q
q
p
b
a
"}
(8,1,1) = {"
a
a
a
a
a
a
a
a
a
a
a
a
a
a
a
a
a
a
a
a
a
a
c
q
q
q
c
q
b
b
a
"}
(9,1,1) = {"
a
a
a
a
a
a
a
a
a
a
a
a
a
a
a
a
a
a
a
a
a
b
b
q
q
q
b
b
b
a
a
"}
(10,1,1) = {"
a
a
a
a
a
a
a
a
a
a
a
a
a
a
a
a
a
a
a
a
a
b
b
b
b
b
b
a
a
a
a
"}
(11,1,1) = {"
a
a
a
a
a
a
b
b
a
a
a
a
a
a
a
a
a
a
a
a
b
b
a
b
b
b
a
a
a
a
a
"}
(12,1,1) = {"
a
a
a
a
a
b
b
b
b
b
a
a
a
b
b
b
b
b
b
a
a
a
a
a
a
a
a
a
a
a
a
"}
(13,1,1) = {"
a
a
a
a
b
b
b
b
k
c
a
a
b
b
b
b
b
b
a
a
a
a
a
a
a
a
a
a
a
a
a
"}
(14,1,1) = {"
a
a
a
a
b
b
b
k
f
f
e
a
c
d
p
b
b
a
a
a
a
a
a
a
a
a
a
a
a
a
a
"}
(15,1,1) = {"
a
a
a
b
b
b
k
f
f
f
c
c
c
f
c
b
a
a
a
a
a
a
a
a
a
a
a
a
a
a
a
"}
(16,1,1) = {"
a
a
a
b
b
b
k
f
G
f
c
I
I
f
c
b
a
a
a
a
a
a
a
a
a
a
a
a
a
a
a
"}
(17,1,1) = {"
a
a
a
b
b
e
f
h
f
f
e
f
h
f
c
c
c
c
a
a
a
a
a
a
a
a
a
a
a
a
a
"}
(18,1,1) = {"
a
a
a
a
c
f
f
f
f
f
c
j
f
f
c
h
f
e
b
a
a
a
a
a
a
a
a
a
a
a
a
"}
(19,1,1) = {"
a
a
a
a
c
c
c
c
c
f
c
f
S
f
c
f
f
k
b
b
a
a
a
a
a
a
a
a
a
a
a
"}
(20,1,1) = {"
a
a
a
b
c
g
f
f
f
f
f
f
f
f
f
f
f
f
k
x
b
a
a
a
a
a
a
a
a
a
a
"}
(21,1,1) = {"
a
a
b
b
c
h
f
f
f
f
f
f
f
f
f
f
f
r
d
b
b
a
a
a
a
a
a
a
a
a
a
"}
(22,1,1) = {"
a
b
b
b
c
c
c
c
c
f
c
f
f
f
c
f
f
f
d
b
b
a
a
a
a
a
a
a
a
a
a
"}
(23,1,1) = {"
a
b
b
b
d
f
f
f
f
f
c
f
f
i
c
i
g
d
b
b
a
a
a
a
a
a
a
a
a
a
a
"}
(24,1,1) = {"
a
b
b
b
c
i
f
F
f
f
c
f
h
f
c
c
c
h
b
b
a
a
a
a
a
a
a
a
a
a
a
"}
(25,1,1) = {"
a
a
a
b
c
j
f
f
f
f
e
i
f
f
k
x
b
b
b
b
a
a
a
a
a
a
a
a
a
a
a
"}
(26,1,1) = {"
a
a
a
b
c
c
c
f
f
f
c
f
i
k
x
v
b
b
b
a
a
a
a
a
a
a
a
a
a
a
a
"}
(27,1,1) = {"
a
a
a
a
a
b
c
c
f
n
c
c
c
x
b
b
b
a
a
a
a
a
a
a
a
a
a
a
a
a
a
"}
(28,1,1) = {"
a
a
a
a
a
b
b
c
m
o
c
a
a
b
b
a
a
a
a
a
a
a
a
a
a
a
a
a
a
a
a
"}
(29,1,1) = {"
a
a
a
a
a
b
b
k
k
p
p
a
a
a
a
a
a
a
a
a
a
a
a
a
a
a
a
a
a
a
a
"}
(30,1,1) = {"
a
a
a
a
a
b
b
b
b
b
b
a
a
a
a
a
a
a
a
a
a
a
a
a
a
a
a
a
a
a
a
"}
(31,1,1) = {"
a
a
a
a
a
b
b
b
b
b
a
a
a
a
a
a
a
a
a
a
a
a
a
a
a
a
a
a
a
a
a
"}
(32,1,1) = {"
a
a
a
a
a
a
b
b
b
a
a
a
a
a
a
a
a
a
a
a
a
a
a
a
a
a
a
a
a
a
a
"}
(33,1,1) = {"
a
a
a
a
a
a
a
a
a
a
a
a
a
a
a
a
a
a
a
a
a
a
a
a
a
a
a
a
a
a
a
"}
