//MAP CONVERTED BY dmm2tgm.py THIS HEADER COMMENT PREVENTS RECONVERSION, DO NOT REMOVE
"a" = (
/turf/template_noop,
/area/template_noop)
"b" = (
/turf/simulated/mineral,
/area/ruin/space/methlab)
"c" = (
/obj/machinery/floodlight{
	in_use = 1
	},
/turf/simulated/floor/plating,
/area/ruin/space/methlab)
"d" = (
/obj/structure/closet/crate,
/obj/effect/spawner/random/pool/spaceloot/syndicate/mixed,
/turf/simulated/floor/plating,
/area/ruin/space/methlab)
"e" = (
/obj/structure/closet,
/obj/item/clothing/head/bio_hood,
/obj/item/clothing/suit/bio_suit,
/obj/item/clothing/gloves/color/black,
/turf/simulated/floor/plating,
/area/ruin/space/methlab)
"f" = (
/obj/effect/decal/cleanable/blood/drip,
/turf/simulated/floor/plating,
/area/ruin/space/methlab)
"g" = (
/obj/effect/decal/cleanable/blood,
/obj/machinery/atmospherics/pipe/simple/visible{
	dir = 6
	},
/turf/simulated/floor/plating,
/area/ruin/space/methlab)
"h" = (
/obj/machinery/door/airlock/external{
	name = "Crackden Airlock"
	},
/obj/machinery/atmospherics/pipe/simple/visible{
	dir = 8
	},
/obj/machinery/access_button/offset/south,
/obj/effect/map_effect/dynamic_airlock/door/interior,
/turf/simulated/floor/plating,
/area/ruin/space/methlab)
"i" = (
/obj/item/grenade/chem_grenade/drugs,
/turf/simulated/floor/plating,
/area/ruin/space/methlab)
"j" = (
/turf/simulated/floor/plating,
/area/ruin/space/methlab)
"k" = (
/obj/machinery/door/airlock/external{
	name = "Plain Airlock"
	},
/obj/machinery/access_button/offset/southeast,
/obj/effect/map_effect/dynamic_airlock/door/exterior,
/turf/simulated/floor/plating,
/area/ruin/space/methlab)
"l" = (
/obj/structure/table,
/obj/item/food/chips,
/turf/simulated/floor/plating,
/area/ruin/space/methlab)
"m" = (
/obj/item/ammo_casing{
	pixel_y = 3
	},
/turf/simulated/floor/plating,
/area/ruin/space/methlab)
"n" = (
/obj/effect/decal/cleanable/blood/oil,
/obj/item/ammo_casing{
	pixel_x = -4;
	pixel_y = -6
	},
/turf/simulated/floor/plating,
/area/ruin/space/methlab)
"o" = (
/obj/structure/table,
/obj/item/reagent_containers/glass/beaker/drugs/meth,
/obj/item/reagent_containers/glass/beaker/drugs/meth,
/obj/item/reagent_containers/glass/beaker/drugs/meth,
/turf/simulated/floor/plating,
/area/ruin/space/methlab)
"p" = (
/obj/structure/cable{
	icon_state = "0-2"
	},
/obj/machinery/power/apc/directional/east{
	layer = 5
	},
/turf/simulated/floor/plating,
/area/ruin/space/methlab)
"q" = (
/obj/machinery/floodlight,
/turf/simulated/floor/plating,
/area/ruin/space/methlab)
"r" = (
/obj/machinery/chem_master,
/turf/simulated/floor/plating,
/area/ruin/space/methlab)
"u" = (
/obj/machinery/chem_dispenser,
/turf/simulated/floor/plating,
/area/ruin/space/methlab)
"v" = (
/obj/structure/chair,
/mob/living/basic/pirate,
/turf/simulated/floor/plating,
/area/ruin/space/methlab)
"w" = (
/obj/machinery/chem_heater,
/turf/simulated/floor/plating,
/area/ruin/space/methlab)
"x" = (
/obj/machinery/atmospherics/portable/canister/air,
/turf/simulated/floor/plating,
/area/ruin/space/methlab)
"y" = (
/obj/structure/table,
/obj/machinery/kitchen_machine/microwave,
/turf/simulated/floor/plating,
/area/ruin/space/methlab)
"A" = (
/obj/item/grenade/chem_grenade/drugs,
/obj/machinery/atmospherics/pipe/simple/visible,
/turf/simulated/floor/plating,
/area/ruin/space/methlab)
"B" = (
/obj/machinery/atmospherics/pipe/simple/visible{
	dir = 5
	},
/turf/simulated/floor/plating,
/area/ruin/space/methlab)
"C" = (
/obj/effect/decal/cleanable/blood/oil,
/turf/simulated/floor/plating,
/area/ruin/space/methlab)
"K" = (
/turf/simulated/mineral/random/high_chance/space,
/area/ruin/space/methlab)
"L" = (
/obj/machinery/airlock_controller/air_cycler/directional/north,
/obj/effect/map_effect/dynamic_airlock,
/turf/simulated/floor/plating,
/area/ruin/space/methlab)
"M" = (
/obj/machinery/atmospherics/unary/portables_connector{
	dir = 8
	},
/obj/machinery/atmospherics/portable/canister/air,
/turf/simulated/floor/plating,
/area/ruin/space/methlab)
"N" = (
/obj/machinery/power/port_gen/pacman,
/obj/structure/cable,
/turf/simulated/floor/plating,
/area/ruin/space/methlab)
"Z" = (
/obj/item/grenade/chem_grenade/drugs,
/obj/machinery/atmospherics/unary/vent_pump/high_volume{
	dir = 8
	},
/obj/effect/map_effect/dynamic_airlock,
/turf/simulated/floor/plating,
/area/ruin/space/methlab)

(1,1,1) = {"
a
a
a
a
a
a
a
a
a
a
a
a
a
a
a
a
"}
(2,1,1) = {"
a
a
a
a
a
a
a
b
b
b
b
a
a
a
a
a
"}
(3,1,1) = {"
a
a
a
a
a
b
b
b
b
b
b
a
a
a
a
a
"}
(4,1,1) = {"
a
a
a
a
b
b
K
K
K
b
b
b
a
a
a
a
"}
(5,1,1) = {"
a
a
a
a
b
b
l
o
r
u
w
b
a
a
a
a
"}
(6,1,1) = {"
a
a
a
a
b
c
i
j
j
v
j
b
b
b
b
a
"}
(7,1,1) = {"
a
a
a
b
b
d
j
j
C
j
j
y
b
b
b
a
"}
(8,1,1) = {"
a
a
a
b
b
e
j
p
N
K
K
b
b
b
a
a
"}
(9,1,1) = {"
a
a
b
b
K
f
m
b
K
K
b
b
a
a
a
a
"}
(10,1,1) = {"
a
b
b
K
K
f
n
j
i
j
x
b
a
a
a
a
"}
(11,1,1) = {"
a
b
b
b
K
g
A
B
j
j
q
b
a
a
a
a
"}
(12,1,1) = {"
a
a
a
b
b
h
b
M
b
b
b
b
a
a
a
a
"}
(13,1,1) = {"
a
a
a
b
b
Z
b
b
b
b
a
a
a
a
a
a
"}
(14,1,1) = {"
a
a
b
b
b
L
b
b
b
b
a
a
a
a
a
a
"}
(15,1,1) = {"
a
a
b
b
b
k
b
b
b
a
a
a
a
a
a
a
"}
(16,1,1) = {"
a
a
a
b
b
a
a
b
a
a
a
a
a
a
a
a
"}
(17,1,1) = {"
a
a
a
a
b
a
a
a
a
a
a
a
a
a
a
a
"}
(18,1,1) = {"
a
a
a
a
a
a
a
a
a
a
a
a
a
a
a
a
"}
