"a" = (/turf/space,/area/space)
"b" = (/turf/simulated/wall/shuttle{dir = 8; icon_state = "diagonalWall3"},/area/ruin/powered)
"c" = (/turf/simulated/wall/shuttle{icon_state = "wall3"},/area/ruin/powered)
"d" = (/turf/simulated/wall/shuttle{dir = 1; icon_state = "diagonalWall3"},/area/ruin/powered)
"e" = (/obj/structure/shuttle/engine/propulsion{tag = "icon-propulsion (EAST)"; icon_state = "propulsion"; dir = 4},/turf/space,/area/ruin/powered)
"f" = (/obj/structure/window/reinforced{dir = 4},/obj/structure/shuttle/engine/heater{tag = "icon-heater (WEST)"; icon_state = "heater"; dir = 8},/turf/simulated/floor/plating,/area/ruin/powered)
"g" = (/obj/structure/table/wood,/obj/item/clothing/under/shorts/black,/turf/simulated/floor/plasteel/shuttle/purple,/area/ruin/powered)
"h" = (/turf/simulated/floor/plasteel/shuttle/purple,/area/ruin/powered)
"i" = (/obj/structure/table,/obj/item/device/flashlight/lamp,/obj/machinery/light{dir = 1},/turf/simulated/floor/plasteel/shuttle/purple,/area/ruin/powered)
"j" = (/obj/structure/closet,/turf/simulated/floor/plasteel/shuttle/purple,/area/ruin/powered)
"k" = (/obj/machinery/vending/assist,/turf/simulated/floor/plasteel/shuttle/purple,/area/ruin/powered)
"l" = (/obj/structure/table/wood,/obj/item/clothing/shoes/sandal,/turf/simulated/floor/plasteel/shuttle/purple,/area/ruin/powered)
"m" = (/obj/machinery/light{dir = 8},/turf/simulated/floor/plasteel/shuttle/purple,/area/ruin/powered)
"n" = (/obj/structure/table/wood,/turf/simulated/floor/plasteel/shuttle/purple,/area/ruin/powered)
"o" = (/obj/structure/table/wood,/obj/machinery/computer/libraryconsole/bookmanagement,/turf/simulated/floor/plasteel/shuttle/purple,/area/ruin/powered)
"p" = (/obj/structure/window/reinforced/fulltile,/obj/structure/grille,/turf/simulated/floor/plating,/area/ruin/powered)
"q" = (/obj/structure/grille,/obj/structure/window/reinforced/fulltile,/turf/simulated/floor/plating,/area/ruin/powered)
"r" = (/obj/structure/table/wood,/obj/item/weapon/paper_bin,/obj/item/weapon/pen,/turf/simulated/floor/plasteel/shuttle/purple,/area/ruin/powered)
"s" = (/obj/machinery/door/poddoor{id = "goonwizship1"},/obj/machinery/button/door{id = "goonwizship1"; name = "Strange Ship Door Button"; pixel_y = 32},/turf/simulated/floor/plasteel/shuttle/purple,/area/ruin/powered)
"t" = (/obj/machinery/door/airlock/external,/turf/simulated/floor/plasteel/shuttle/purple,/area/ruin/powered)
"u" = (/obj/machinery/door/airlock/glass,/turf/simulated/floor/plasteel/shuttle/purple,/area/ruin/powered)
"v" = (/obj/structure/chair{dir = 4},/turf/simulated/floor/plasteel/shuttle/purple,/area/ruin/powered)
"w" = (/obj/structure/table/wood,/obj/item/weapon/paper,/obj/item/weapon/pen,/turf/simulated/floor/plasteel/shuttle/purple,/area/ruin/powered)
"x" = (/obj/machinery/light,/turf/simulated/floor/plasteel/shuttle/purple,/area/ruin/powered)
"y" = (/mob/living/simple_animal/bot/medbot,/turf/simulated/floor/plasteel/shuttle/purple,/area/ruin/powered)
"z" = (/turf/simulated/wall/shuttle{dir = 2; icon_state = "diagonalWall3"},/area/ruin/powered)
"A" = (/obj/structure/chair,/turf/simulated/floor/plasteel/shuttle/purple,/area/ruin/powered)
"B" = (/turf/simulated/wall/shuttle{dir = 4; icon_state = "diagonalWall3"},/area/ruin/powered)
"C" = (/obj/machinery/light,/obj/structure/bed,/turf/simulated/floor/plasteel/shuttle/purple,/area/ruin/powered)

(1,1,1) = {"
aabcccccdaaaa
aefghijkcaaaa
aeflhhhhccccd
bccccmhhcmhjc
cnophhhhqhhrc
shhthhhhuhvwc
chxpyhhhqhhnc
zccccmhhcmhjc
aefAhhhhccccB
aefnnChjcaaaa
aazcccccBaaaa
"}
