//MAP CONVERTED BY dmm2tgm.py THIS HEADER COMMENT PREVENTS RECONVERSION, DO NOT REMOVE
"aW" = (
/obj/structure/disposalpipe/trunk{
	dir = 4
	},
/obj/machinery/disposal,
/turf/simulated/floor/plasteel/dark,
/area/ruin/space/syndicate_listening_station)
"bn" = (
/obj/machinery/atmospherics/portable/canister/air,
/obj/machinery/atmospherics/unary/portables_connector,
/obj/effect/decal/cleanable/dirt,
/obj/effect/spawner/random_spawners/cobweb_left_rare,
/obj/structure/sign/vacuum/external{
	pixel_x = -30
	},
/turf/simulated/floor/plating,
/area/ruin/space/syndicate_listening_station)
"bU" = (
/obj/machinery/light/small,
/obj/effect/decal/cleanable/dirt,
/obj/structure/table,
/obj/item/storage/toolbox/syndicate,
/turf/simulated/floor/plating,
/area/ruin/space/syndicate_listening_station)
"ca" = (
/obj/structure/chair{
	dir = 8
	},
/turf/simulated/floor/plasteel/dark,
/area/ruin/space/syndicate_listening_station)
"cB" = (
/turf/simulated/mineral/random/high_chance,
/area/ruin/space/syndicate_listening_station/asteroid)
"du" = (
/obj/effect/decal/cleanable/dirt,
/turf/simulated/floor/plating,
/area/ruin/space/syndicate_listening_station)
"dS" = (
/obj/machinery/light{
	dir = 1
	},
/turf/simulated/floor/plasteel/dark,
/area/ruin/space/syndicate_listening_station)
"gD" = (
/obj/structure/closet/syndicate,
/obj/item/tank/internals/oxygen,
/obj/item/tank/jetpack/oxygen,
/obj/item/clothing/suit/space/syndicate/black/red,
/obj/item/clothing/mask/gas/syndicate,
/obj/item/clothing/head/helmet/space/syndicate/black/red,
/turf/simulated/floor/plasteel/dark,
/area/ruin/space/syndicate_listening_station)
"hr" = (
/obj/structure/cable/yellow{
	d1 = 4;
	d2 = 8;
	icon_state = "4-8"
	},
/turf/simulated/floor/plating/airless{
	icon_state = "asteroidplating"
	},
/area/ruin/space/syndicate_listening_station/asteroid)
"hQ" = (
/obj/structure/sink{
	dir = 4;
	pixel_x = 12
	},
/obj/structure/mirror{
	pixel_x = 28
	},
/turf/simulated/floor/mineral/silver,
/area/ruin/space/syndicate_listening_station)
"il" = (
/obj/machinery/light,
/turf/simulated/floor/plasteel/dark,
/area/ruin/space/syndicate_listening_station)
"iB" = (
/obj/item/paper_bin,
/obj/item/pen/multi/syndicate,
/obj/structure/table/glass/reinforced/plastitanium,
/turf/simulated/floor/plasteel/dark,
/area/ruin/space/syndicate_listening_station)
"iL" = (
/obj/structure/disposaloutlet{
	dir = 4
	},
/obj/structure/disposalpipe/trunk{
	dir = 8
	},
/turf/simulated/floor/plating/airless,
/area/ruin/space/syndicate_listening_station/asteroid)
"kx" = (
/obj/machinery/newscaster{
	pixel_y = 28;
	name = "north bump"
	},
/turf/simulated/floor/plasteel/dark,
/area/ruin/space/syndicate_listening_station)
"kE" = (
/obj/effect/decal/cleanable/dirt,
/obj/structure/cable/yellow{
	d1 = 4;
	d2 = 8;
	icon_state = "4-8"
	},
/turf/simulated/floor/plating,
/area/ruin/space/syndicate_listening_station)
"kJ" = (
/turf/simulated/wall/mineral/plastitanium/nodiagonal,
/area/ruin/space/syndicate_listening_station)
"le" = (
/turf/simulated/floor/plasteel/dark,
/area/ruin/space/syndicate_listening_station)
"mn" = (
/obj/structure/window/reinforced{
	dir = 8
	},
/obj/machinery/light/small{
	dir = 1
	},
/turf/simulated/floor/mineral/silver,
/area/ruin/space/syndicate_listening_station)
"mC" = (
/obj/structure/cable/yellow,
/obj/machinery/power/solar,
/turf/simulated/floor/plasteel/airless{
	icon_state = "solarpanel"
	},
/area/ruin/space/syndicate_listening_station/asteroid)
"oE" = (
/obj/machinery/atmospherics/portable/scrubber,
/obj/effect/decal/cleanable/dirt,
/turf/simulated/floor/plating,
/area/ruin/space/syndicate_listening_station)
"pV" = (
/obj/structure/cable/yellow{
	d2 = 2;
	icon_state = "0-2"
	},
/obj/machinery/power/solar,
/turf/simulated/floor/plasteel/airless{
	icon_state = "solarpanel"
	},
/area/ruin/space/syndicate_listening_station/asteroid)
"qC" = (
/obj/item/flag/syndi,
/turf/simulated/floor/plasteel/dark,
/area/ruin/space/syndicate_listening_station)
"qW" = (
/obj/structure/cable/yellow{
	d1 = 2;
	d2 = 4;
	icon_state = "2-4"
	},
/turf/simulated/floor/plating/airless,
/area/ruin/space/syndicate_listening_station/asteroid)
"rK" = (
/obj/structure/disposalpipe/segment{
	dir = 4
	},
/turf/simulated/mineral/ancient,
/area/ruin/space/syndicate_listening_station/asteroid)
"rS" = (
/obj/structure/falsewall/rock_ancient,
/obj/structure/cable/yellow{
	d1 = 1;
	d2 = 2;
	icon_state = "1-2"
	},
/turf/simulated/floor/plating/airless,
/area/ruin/space/syndicate_listening_station/asteroid)
"se" = (
/obj/effect/spawner/airlock/w_to_e,
/turf/simulated/wall/mineral/plastitanium/nodiagonal,
/area/ruin/space/syndicate_listening_station)
"sf" = (
/obj/structure/cable/yellow{
	d1 = 1;
	d2 = 4;
	icon_state = "1-4"
	},
/obj/structure/cable/yellow{
	d1 = 2;
	d2 = 4;
	icon_state = "2-4"
	},
/obj/structure/cable/yellow{
	d1 = 4;
	d2 = 8;
	icon_state = "4-8"
	},
/turf/simulated/floor/plating/airless{
	icon_state = "asteroidplating"
	},
/area/ruin/space/syndicate_listening_station/asteroid)
"sq" = (
/obj/structure/falsewall/rock_ancient,
/obj/structure/cable/yellow{
	d1 = 4;
	d2 = 8;
	icon_state = "4-8"
	},
/turf/simulated/floor/plating/airless,
/area/ruin/space/syndicate_listening_station/asteroid)
"tk" = (
/obj/structure/cable/yellow{
	d1 = 1;
	d2 = 2;
	icon_state = "1-2"
	},
/turf/simulated/floor/plating/airless{
	icon_state = "asteroidplating"
	},
/area/ruin/space/syndicate_listening_station/asteroid)
"tF" = (
/obj/machinery/power/smes/upgraded{
	charge = 5e+006;
	input_level = 20000;
	output_level = 100000
	},
/obj/structure/cable{
	d2 = 2;
	icon_state = "0-2"
	},
/obj/effect/decal/cleanable/dirt,
/turf/simulated/floor/plating,
/area/ruin/space/syndicate_listening_station)
"tG" = (
/obj/item/paper/monitorkey,
/obj/structure/table/glass/reinforced/plastitanium,
/turf/simulated/floor/plasteel/dark,
/area/ruin/space/syndicate_listening_station)
"tV" = (
/obj/machinery/atmospherics/pipe/simple/visible{
	dir = 5
	},
/obj/effect/decal/cleanable/dirt,
/turf/simulated/floor/plasteel/dark,
/area/ruin/space/syndicate_listening_station)
"un" = (
/obj/effect/decal/cleanable/dirt,
/turf/simulated/floor/plasteel/dark,
/area/ruin/space/syndicate_listening_station)
"uM" = (
/obj/machinery/power/apc/syndicate/directional/north,
/obj/structure/cable{
	d2 = 8;
	icon_state = "0-8"
	},
/turf/simulated/floor/plasteel/dark,
/area/ruin/space/syndicate_listening_station)
"vc" = (
/obj/machinery/economy/vending/snack/free,
/turf/simulated/floor/plasteel/dark,
/area/ruin/space/syndicate_listening_station)
"vd" = (
/obj/structure/mopbucket{
	dir = 8
	},
/obj/item/mop,
/turf/simulated/floor/plasteel/dark,
/area/ruin/space/syndicate_listening_station)
"vP" = (
/obj/machinery/power/solar_control/autostart{
	dir = 1
	},
/obj/effect/decal/cleanable/dirt,
/obj/structure/cable/yellow,
/turf/simulated/floor/plating,
/area/ruin/space/syndicate_listening_station)
"wj" = (
/obj/machinery/door/airlock/hatch/syndicate{
	name = "Telecommunications"
	},
/turf/simulated/floor/plasteel/dark,
/area/ruin/space/syndicate_listening_station)
"wr" = (
/obj/machinery/door/airlock/hatch/syndicate{
	name = "Cabin"
	},
/turf/simulated/floor/plasteel/dark,
/area/ruin/space/syndicate_listening_station)
"wF" = (
/obj/machinery/atmospherics/pipe/simple/visible,
/obj/effect/decal/cleanable/dirt,
/obj/structure/sign/vacuum/external{
	pixel_x = 30
	},
/turf/simulated/floor/plasteel/dark,
/area/ruin/space/syndicate_listening_station)
"xh" = (
/obj/structure/cable/yellow{
	d1 = 4;
	d2 = 8;
	icon_state = "4-8"
	},
/turf/simulated/floor/plating/airless,
/area/ruin/space/syndicate_listening_station/asteroid)
"xK" = (
/obj/structure/bed,
/obj/item/bedsheet/syndie,
/turf/simulated/floor/wood,
/area/ruin/space/syndicate_listening_station)
"yn" = (
/turf/simulated/mineral/ancient,
/area/ruin/space/syndicate_listening_station/asteroid)
"yv" = (
/obj/structure/cable{
	d1 = 1;
	d2 = 4;
	icon_state = "1-4"
	},
/turf/simulated/floor/plasteel/dark,
/area/ruin/space/syndicate_listening_station)
"Aa" = (
/obj/machinery/ai_status_display{
	pixel_y = 32
	},
/turf/simulated/floor/plasteel/dark,
/area/ruin/space/syndicate_listening_station)
"Ab" = (
/obj/machinery/status_display/supply_display{
	pixel_y = 32
	},
/obj/structure/shelf,
/obj/item/storage/box/tapes,
/obj/item/taperecorder,
/obj/item/clothing/glasses/regular,
/turf/simulated/floor/plasteel/dark,
/area/ruin/space/syndicate_listening_station)
"AT" = (
/turf/simulated/floor/plating/asteroid/airless,
/area/ruin/space/syndicate_listening_station/asteroid)
"Bt" = (
/obj/structure/cable{
	d1 = 1;
	d2 = 2;
	icon_state = "1-2"
	},
/obj/effect/decal/cleanable/dirt,
/turf/simulated/floor/plating,
/area/ruin/space/syndicate_listening_station)
"Bu" = (
/obj/machinery/tcomms/relay/ruskie{
	network_id = "SYNDIE-LPOST-RELAY"
	},
/turf/simulated/floor/plasteel/dark,
/area/ruin/space/syndicate_listening_station)
"BD" = (
/obj/structure/cable/yellow{
	d1 = 1;
	d2 = 8;
	icon_state = "1-8"
	},
/obj/structure/cable/yellow{
	d1 = 1;
	d2 = 2;
	icon_state = "1-2"
	},
/turf/simulated/floor/plating/airless{
	icon_state = "asteroidplating"
	},
/area/ruin/space/syndicate_listening_station/asteroid)
"BG" = (
/obj/effect/landmark/damageturf,
/turf/simulated/floor/wood,
/area/ruin/space/syndicate_listening_station)
"Cw" = (
/obj/structure/filingcabinet,
/obj/item/paper{
	info = "A good start to the operation: intercepted Nanotrasen military communications. A convoy is scheduled to transfer nuclear warheads to a new military base. This is as good a chance as any to get our hands on some heavy weaponry, I suggest we take it.";
	name = "april report"
	},
/obj/item/paper{
	info = "Nothing of real interest to report this month. I have intercepted faint transmissions from what appears to be some sort of pirate radio station. They do not appear to be relevant to my assignment.";
	name = "may report"
	},
/obj/item/paper{
	info = "Nanotrasen communications have been noticably less frequent recently.  The pirate radio station I found last month has been transmitting pro-Nanotrasen propaganda. I will continue to monitor it.";
	name = "june report"
	},
/obj/item/paper{
	info = "Nothing of interest to report.";
	name = "july report"
	},
/obj/item/paper{
	info = "Nothing of interest to report.";
	name = "august report"
	},
/obj/item/paper{
	info = "Nothing of interest to report.";
	name = "september report"
	},
/obj/item/paper{
	info = "Nothing of interest to report.";
	name = "october report"
	},
/obj/item/paper{
	info = "1 x Stechtkin pistol - $600<br>1 x silencer - $200<br>shipping charge - $4360<br>total - $5160";
	name = "receipt"
	},
/obj/machinery/status_display{
	layer = 4;
	pixel_y = 32
	},
/obj/item/paper{
	info = "Nothing of interest to report.";
	name = "november report"
	},
/turf/simulated/floor/plasteel/dark,
/area/ruin/space/syndicate_listening_station)
"CC" = (
/obj/effect/decal/cleanable/dirt,
/obj/structure/cable/yellow{
	d1 = 1;
	d2 = 2;
	icon_state = "1-2"
	},
/turf/simulated/floor/plating,
/area/ruin/space/syndicate_listening_station)
"CG" = (
/obj/structure/shelf,
/obj/item/storage/box/donkpockets,
/obj/item/storage/box/donkpockets,
/obj/item/vending_refill/cigarette,
/obj/item/vending_refill/snack,
/obj/item/storage/firstaid,
/obj/item/storage/firstaid,
/turf/simulated/floor/plasteel/dark,
/area/ruin/space/syndicate_listening_station)
"CI" = (
/obj/machinery/light/small{
	dir = 1
	},
/obj/effect/decal/cleanable/dirt,
/obj/structure/cable/yellow{
	d1 = 4;
	d2 = 8;
	icon_state = "4-8"
	},
/turf/simulated/floor/plating,
/area/ruin/space/syndicate_listening_station)
"DT" = (
/obj/machinery/light{
	dir = 8
	},
/turf/simulated/floor/plasteel/dark,
/area/ruin/space/syndicate_listening_station)
"Ej" = (
/obj/effect/decal/cleanable/dirt,
/obj/structure/cable/yellow{
	d1 = 4;
	d2 = 8;
	icon_state = "4-8"
	},
/obj/effect/mapping_helpers/airlock/access/all/syndicate,
/turf/simulated/floor/plating,
/area/ruin/space/syndicate_listening_station)
"Em" = (
/obj/machinery/power/terminal,
/obj/effect/spawner/random_spawners/cobweb_right_rare,
/obj/effect/decal/cleanable/dirt,
/obj/structure/cable/yellow{
	d2 = 8;
	icon_state = "0-8"
	},
/turf/simulated/floor/plating,
/area/ruin/space/syndicate_listening_station)
"Fx" = (
/obj/machinery/light/small{
	dir = 1
	},
/obj/structure/dresser,
/turf/simulated/floor/wood,
/area/ruin/space/syndicate_listening_station)
"Ge" = (
/obj/machinery/atmospherics/portable/canister/air,
/obj/machinery/atmospherics/unary/portables_connector,
/turf/simulated/floor/plasteel/dark,
/area/ruin/space/syndicate_listening_station)
"Go" = (
/mob/living/simple_animal/hostile/syndicate{
	desc = "A weary looking Syndicate operative.";
	environment_smash = 0
	},
/obj/structure/chair/office/dark,
/turf/simulated/floor/plasteel/dark,
/area/ruin/space/syndicate_listening_station)
"Gy" = (
/obj/structure/falsewall/rock_ancient,
/turf/simulated/floor/plating/asteroid/airless,
/area/ruin/space/syndicate_listening_station/asteroid)
"GQ" = (
/obj/effect/decal/cleanable/dirt,
/obj/structure/cable/yellow{
	d1 = 4;
	d2 = 8;
	icon_state = "4-8"
	},
/obj/structure/extinguisher_cabinet{
	name = "north bump";
	pixel_y = 30
	},
/turf/simulated/floor/plating,
/area/ruin/space/syndicate_listening_station)
"HZ" = (
/obj/structure/cable/yellow{
	d1 = 1;
	d2 = 8;
	icon_state = "1-8"
	},
/turf/simulated/floor/plating/airless,
/area/ruin/space/syndicate_listening_station/asteroid)
"Ie" = (
/obj/structure/spawner/mining/basilisk,
/turf/simulated/floor/plating/asteroid/airless,
/area/ruin/space/syndicate_listening_station/asteroid)
"Im" = (
/obj/structure/chair{
	dir = 4
	},
/turf/simulated/floor/plasteel/dark,
/area/ruin/space/syndicate_listening_station)
"Ir" = (
/obj/structure/table/glass/reinforced/plastitanium,
/obj/item/ashtray/glass,
/turf/simulated/floor/plasteel/dark,
/area/ruin/space/syndicate_listening_station)
"KM" = (
/obj/machinery/shower{
	pixel_y = 20
	},
/obj/item/soap/syndie,
/obj/item/bikehorn/rubberducky,
/obj/structure/curtain/open/shower/security,
/turf/simulated/floor/mineral/silver,
/area/ruin/space/syndicate_listening_station)
"Lj" = (
/turf/simulated/floor/wood,
/area/ruin/space/syndicate_listening_station)
"Mv" = (
/obj/structure/extinguisher_cabinet{
	name = "north bump";
	pixel_y = 30
	},
/turf/simulated/floor/plasteel/dark,
/area/ruin/space/syndicate_listening_station)
"MF" = (
/obj/structure/cable/yellow,
/obj/machinery/power/tracker,
/turf/simulated/floor/plasteel/airless{
	icon_state = "solarpanel"
	},
/area/ruin/space/syndicate_listening_station/asteroid)
"MO" = (
/obj/machinery/light{
	dir = 4
	},
/turf/simulated/floor/plasteel/dark,
/area/ruin/space/syndicate_listening_station)
"Nd" = (
/turf/simulated/floor/mineral/silver,
/area/ruin/space/syndicate_listening_station)
"Or" = (
/obj/machinery/economy/vending/cigarette/free,
/turf/simulated/floor/plasteel/dark,
/area/ruin/space/syndicate_listening_station)
"OO" = (
/obj/structure/cable/yellow{
	d1 = 2;
	d2 = 4;
	icon_state = "2-4"
	},
/turf/simulated/floor/plating/airless{
	icon_state = "asteroidplating"
	},
/area/ruin/space/syndicate_listening_station/asteroid)
"PH" = (
/obj/machinery/kitchen_machine/microwave/upgraded{
	pixel_y = 5
	},
/obj/structure/table/glass/reinforced/plastitanium,
/turf/simulated/floor/plasteel/dark,
/area/ruin/space/syndicate_listening_station)
"Qp" = (
/obj/structure/closet/secure_closet/personal/cabinet,
/turf/simulated/floor/wood,
/area/ruin/space/syndicate_listening_station)
"RN" = (
/obj/machinery/door/airlock/silver{
	name = "Bathroom"
	},
/turf/simulated/floor/mineral/silver,
/area/ruin/space/syndicate_listening_station)
"Sq" = (
/obj/structure/table/glass/reinforced/plastitanium,
/obj/item/food/soup/chicken_noodle_soup,
/turf/simulated/floor/plasteel/dark,
/area/ruin/space/syndicate_listening_station)
"TF" = (
/obj/structure/cable/yellow{
	d1 = 1;
	d2 = 2;
	icon_state = "1-2"
	},
/turf/simulated/floor/plating/airless,
/area/ruin/space/syndicate_listening_station/asteroid)
"TZ" = (
/obj/item/radio/intercom{
	freerange = 1;
	pixel_y = -24;
	name = "intercom"
	},
/obj/item/paper{
	info = "<b>Mission Details</b>: You have been assigned to a newly constructed listening post constructed within an asteroid in Nanotrasen space to monitor their plasma mining operations. Accurate intel is crucial to the success of our operatives onboard, do not fail us.";
	name = "mission briefing"
	},
/obj/structure/table/glass/reinforced/plastitanium,
/turf/simulated/floor/plasteel/dark,
/area/ruin/space/syndicate_listening_station)
"Uy" = (
/obj/item/gps/ruin{
	gpstag = "Encrypted Signal"
	},
/turf/simulated/wall/mineral/plastitanium/nodiagonal,
/area/ruin/space/syndicate_listening_station)
"UM" = (
/obj/machinery/door/airlock/hatch/syndicate{
	name = "Engineering"
	},
/obj/structure/cable{
	d1 = 1;
	d2 = 2;
	icon_state = "1-2"
	},
/obj/effect/decal/cleanable/dirt,
/turf/simulated/floor/plasteel/dark,
/area/ruin/space/syndicate_listening_station)
"UT" = (
/obj/effect/decal/cleanable/dirt,
/obj/effect/mapping_helpers/airlock/access/all/syndicate,
/turf/simulated/floor/plating,
/area/ruin/space/syndicate_listening_station)
"Vn" = (
/obj/machinery/computer/message_monitor{
	dir = 1
	},
/turf/simulated/floor/plasteel/dark,
/area/ruin/space/syndicate_listening_station)
"Wc" = (
/obj/effect/spawner/airlock/e_to_w,
/turf/simulated/wall/mineral/plastitanium/nodiagonal,
/area/ruin/space/syndicate_listening_station)
"Wf" = (
/obj/structure/disposalpipe/segment{
	dir = 4
	},
/turf/simulated/wall/mineral/plastitanium/nodiagonal,
/area/ruin/space/syndicate_listening_station)
"WN" = (
/obj/structure/cable/yellow{
	d1 = 1;
	d2 = 4;
	icon_state = "1-4"
	},
/obj/structure/cable/yellow{
	d1 = 2;
	d2 = 4;
	icon_state = "2-4"
	},
/turf/simulated/floor/plating/airless{
	icon_state = "asteroidplating"
	},
/area/ruin/space/syndicate_listening_station/asteroid)
"Xm" = (
/obj/structure/toilet{
	dir = 8
	},
/turf/simulated/floor/mineral/silver,
/area/ruin/space/syndicate_listening_station)
"Xz" = (
/obj/effect/decal/cleanable/dirt,
/obj/structure/cable/yellow{
	d1 = 2;
	d2 = 8;
	icon_state = "2-8"
	},
/obj/structure/cable/yellow{
	d1 = 2;
	d2 = 4;
	icon_state = "2-4"
	},
/obj/machinery/atmospherics/pipe/simple/visible{
	dir = 9
	},
/turf/simulated/floor/plating,
/area/ruin/space/syndicate_listening_station)
"Zw" = (
/turf/template_noop,
/area/template_noop)

(1,1,1) = {"
Zw
Zw
Zw
Zw
Zw
Zw
Zw
Zw
Zw
Zw
Zw
Zw
Zw
Zw
Zw
Zw
pV
WN
mC
AT
pV
WN
mC
Zw
Zw
Zw
Zw
Zw
Zw
Zw
Zw
Zw
Zw
Zw
Zw
Zw
Zw
Zw
Zw
Zw
"}
(2,1,1) = {"
Zw
yn
Zw
Zw
Zw
Zw
Zw
Zw
Zw
Zw
Zw
Zw
Zw
Zw
yn
AT
pV
sf
mC
AT
pV
sf
mC
AT
Zw
Zw
Zw
Zw
Zw
Zw
Zw
Zw
Zw
yn
Zw
Zw
Zw
Zw
Zw
Zw
"}
(3,1,1) = {"
Zw
yn
yn
yn
yn
Zw
Zw
Zw
Zw
Zw
Zw
Zw
Zw
yn
yn
AT
pV
sf
mC
AT
pV
sf
mC
AT
Zw
Zw
Zw
Zw
Zw
Zw
yn
Zw
yn
yn
Zw
yn
Zw
Zw
Zw
Zw
"}
(4,1,1) = {"
Zw
Zw
yn
yn
yn
yn
Zw
Zw
Zw
Zw
Zw
Zw
Zw
yn
yn
yn
pV
sf
mC
AT
pV
sf
mC
AT
AT
Zw
Zw
Zw
Zw
Zw
yn
yn
yn
yn
Zw
yn
yn
yn
Zw
yn
"}
(5,1,1) = {"
Zw
Zw
yn
yn
cB
cB
yn
Zw
Zw
Zw
Zw
Zw
yn
yn
yn
yn
AT
hr
AT
AT
AT
hr
AT
AT
AT
AT
Zw
Zw
Zw
Zw
Zw
yn
cB
Zw
Zw
cB
yn
yn
yn
Zw
"}
(6,1,1) = {"
Zw
Zw
yn
yn
cB
cB
cB
Zw
Zw
Zw
Zw
Zw
yn
yn
yn
OO
tk
BD
tk
tk
tk
BD
tk
tk
tk
MF
AT
yn
Zw
Zw
Zw
yn
yn
Zw
cB
cB
yn
Zw
yn
Zw
"}
(7,1,1) = {"
Zw
Zw
Zw
yn
yn
yn
yn
yn
Zw
Zw
Zw
yn
yn
yn
yn
sq
yn
yn
yn
yn
yn
yn
AT
AT
yn
AT
AT
yn
yn
Zw
Zw
Zw
yn
yn
yn
yn
Zw
Zw
Zw
Zw
"}
(8,1,1) = {"
Zw
Zw
Zw
Zw
yn
Zw
Zw
yn
Zw
Zw
yn
yn
yn
yn
qW
HZ
yn
yn
yn
cB
yn
AT
AT
yn
yn
yn
yn
yn
yn
Zw
Zw
Zw
Zw
yn
yn
Zw
Zw
Zw
Zw
Zw
"}
(9,1,1) = {"
Zw
Zw
Zw
Zw
Zw
Zw
Zw
Zw
Zw
yn
yn
qW
rS
TF
HZ
yn
yn
cB
yn
yn
yn
AT
AT
yn
cB
cB
yn
yn
yn
yn
Zw
Zw
Zw
Zw
Zw
Zw
Zw
Zw
Zw
Zw
"}
(10,1,1) = {"
Zw
Zw
Zw
Zw
Zw
Zw
Zw
Zw
yn
yn
yn
xh
yn
yn
yn
yn
cB
yn
cB
yn
yn
yn
yn
yn
yn
yn
yn
yn
yn
yn
Zw
yn
Zw
Zw
Zw
Zw
Zw
Zw
Zw
Zw
"}
(11,1,1) = {"
Zw
Zw
Zw
Zw
Zw
Zw
Zw
yn
yn
yn
kJ
kE
Wc
yn
cB
cB
yn
yn
yn
yn
yn
yn
yn
yn
yn
yn
yn
yn
cB
yn
yn
yn
Zw
Zw
Zw
Zw
Zw
Zw
Zw
Zw
"}
(12,1,1) = {"
Zw
Zw
Zw
Zw
Zw
Zw
Zw
yn
yn
yn
kJ
Ej
kJ
yn
yn
yn
yn
yn
yn
yn
yn
yn
yn
yn
cB
yn
cB
yn
yn
yn
cB
cB
Zw
Zw
Zw
Zw
Zw
Zw
Zw
Zw
"}
(13,1,1) = {"
Zw
Zw
Zw
Zw
Zw
Zw
Zw
yn
yn
kJ
kJ
kE
kJ
kJ
kJ
kJ
kJ
kJ
kJ
kJ
kJ
yn
yn
yn
yn
yn
yn
yn
cB
cB
cB
cB
Zw
Zw
Zw
Zw
Zw
Zw
Zw
Zw
"}
(14,1,1) = {"
Zw
Zw
Zw
Zw
Zw
Zw
Zw
yn
yn
kJ
bn
Xz
CC
vP
kJ
Qp
BG
kJ
CG
vd
kJ
yn
yn
yn
yn
yn
yn
yn
yn
yn
cB
yn
yn
Zw
Zw
Zw
Zw
Zw
Zw
Zw
"}
(15,1,1) = {"
Zw
Zw
Zw
Zw
Zw
Zw
Zw
yn
yn
kJ
kJ
kE
du
bU
kJ
Fx
Lj
wr
le
le
kJ
kJ
kJ
kJ
kJ
yn
yn
cB
yn
yn
yn
yn
yn
Zw
Zw
Zw
Zw
Zw
Zw
Zw
"}
(16,1,1) = {"
Zw
Zw
Zw
Zw
Zw
Zw
Zw
yn
yn
yn
kJ
GQ
du
oE
kJ
xK
Lj
kJ
Mv
il
kJ
Cw
DT
iB
kJ
yn
yn
yn
yn
yn
yn
yn
AT
Zw
Zw
Zw
Zw
Zw
Zw
Zw
"}
(17,1,1) = {"
Zw
Zw
Zw
Zw
Zw
Zw
Zw
Zw
yn
yn
kJ
CI
du
du
kJ
kJ
kJ
Uy
le
le
kJ
Aa
le
TZ
kJ
yn
yn
yn
yn
yn
yn
AT
AT
Zw
Zw
Zw
Zw
Zw
Zw
Zw
"}
(18,1,1) = {"
Zw
Zw
Zw
Zw
Zw
Zw
Zw
Zw
yn
yn
kJ
Em
tF
Bt
UM
yv
DT
le
le
le
wj
le
Go
Vn
kJ
yn
yn
yn
yn
yn
AT
Ie
AT
Zw
Zw
Zw
Zw
Zw
Zw
Zw
"}
(19,1,1) = {"
Zw
Zw
Zw
Zw
Zw
Zw
Zw
Zw
yn
yn
kJ
kJ
kJ
kJ
kJ
uM
le
Im
Im
le
kJ
kx
le
tG
kJ
yn
yn
yn
yn
yn
AT
AT
Zw
Zw
Zw
Zw
Zw
Zw
Zw
Zw
"}
(20,1,1) = {"
Zw
Zw
Zw
Zw
Zw
Zw
Zw
Zw
yn
yn
kJ
KM
Nd
kJ
PH
le
le
Sq
Ir
le
kJ
Ab
MO
Bu
kJ
yn
yn
yn
yn
AT
AT
AT
Zw
Zw
Zw
Zw
Zw
Zw
Zw
Zw
"}
(21,1,1) = {"
Zw
Zw
Zw
Zw
Zw
Zw
Zw
Zw
yn
yn
kJ
mn
Nd
RN
le
le
le
ca
ca
le
kJ
kJ
kJ
kJ
kJ
yn
yn
yn
yn
AT
AT
Zw
Zw
Zw
Zw
Zw
Zw
Zw
Zw
Zw
"}
(22,1,1) = {"
Zw
Zw
Zw
Zw
Zw
Zw
Zw
Zw
yn
yn
kJ
Xm
hQ
kJ
dS
le
le
le
le
il
kJ
yn
yn
yn
yn
yn
yn
yn
AT
Ie
AT
Zw
Zw
Zw
Zw
Zw
Zw
Zw
Zw
Zw
"}
(23,1,1) = {"
Zw
Zw
Zw
Zw
Zw
Zw
Zw
Zw
yn
yn
kJ
kJ
kJ
kJ
qC
un
le
vc
Or
aW
kJ
yn
yn
yn
yn
yn
yn
yn
AT
AT
Zw
Zw
Zw
Zw
Zw
Zw
Zw
Zw
Zw
Zw
"}
(24,1,1) = {"
Zw
Zw
yn
yn
yn
Zw
Zw
Zw
yn
yn
yn
yn
kJ
Ge
wF
tV
gD
kJ
kJ
Wf
kJ
yn
yn
yn
yn
yn
yn
AT
AT
AT
Zw
Zw
Zw
Zw
Zw
Zw
Zw
Zw
Zw
Zw
"}
(25,1,1) = {"
Zw
Zw
Zw
yn
yn
Zw
Zw
Zw
Zw
yn
yn
yn
kJ
kJ
kJ
du
se
kJ
yn
rK
cB
cB
cB
yn
yn
yn
yn
AT
AT
Zw
Zw
Zw
Zw
Zw
Zw
Zw
Zw
Zw
Zw
Zw
"}
(26,1,1) = {"
Zw
yn
Zw
yn
yn
yn
Zw
Zw
Zw
Zw
yn
yn
yn
yn
kJ
UT
kJ
yn
yn
rK
yn
cB
cB
cB
yn
yn
yn
AT
AT
Zw
Zw
Zw
Zw
Zw
Zw
Zw
Zw
Zw
Zw
Zw
"}
(27,1,1) = {"
Zw
Zw
Zw
Zw
yn
yn
Zw
Zw
Zw
Zw
Zw
yn
yn
yn
kJ
du
kJ
yn
yn
iL
yn
yn
cB
cB
yn
yn
AT
AT
Zw
Zw
Zw
Zw
Zw
Zw
Zw
Zw
Zw
Zw
Zw
Zw
"}
(28,1,1) = {"
Zw
Zw
Zw
Zw
Zw
Zw
Zw
Zw
Zw
Zw
Zw
Zw
yn
yn
AT
AT
AT
yn
yn
Zw
yn
yn
cB
Zw
yn
AT
AT
AT
Zw
Zw
Zw
Zw
Zw
Zw
Zw
Zw
Zw
Zw
Zw
Zw
"}
(29,1,1) = {"
Zw
Zw
Zw
Zw
Zw
Zw
Zw
Zw
Zw
Zw
Zw
Zw
yn
yn
AT
AT
yn
yn
yn
Zw
yn
yn
Zw
Zw
yn
AT
Zw
Zw
Zw
Zw
Zw
Zw
Zw
Zw
Zw
Zw
Zw
Zw
Zw
Zw
"}
(30,1,1) = {"
Zw
Zw
Zw
Zw
Zw
Zw
Zw
Zw
Zw
Zw
Zw
Zw
Zw
yn
yn
Gy
yn
Zw
Zw
Zw
Zw
Zw
Zw
Zw
Zw
Zw
Zw
Zw
Zw
Zw
Zw
Zw
Zw
Zw
Zw
Zw
Zw
Zw
Zw
Zw
"}
(31,1,1) = {"
Zw
Zw
Zw
yn
yn
Zw
Zw
Zw
Zw
Zw
Zw
Zw
Zw
Zw
yn
Zw
Zw
Zw
Zw
Zw
Zw
Zw
Zw
Zw
Zw
Zw
Zw
Zw
Zw
Zw
Zw
Zw
Zw
Zw
Zw
Zw
Zw
Zw
Zw
Zw
"}
(32,1,1) = {"
Zw
Zw
yn
yn
yn
Zw
Zw
Zw
Zw
yn
Zw
Zw
Zw
Zw
Zw
Zw
Zw
Zw
Zw
Zw
Zw
Zw
Zw
Zw
Zw
Zw
Zw
Zw
Zw
Zw
Zw
Zw
Zw
Zw
Zw
Zw
Zw
Zw
Zw
Zw
"}
(33,1,1) = {"
Zw
Zw
yn
yn
cB
cB
Zw
Zw
yn
yn
Zw
Zw
Zw
Zw
Zw
Zw
Zw
Zw
Zw
Zw
Zw
Zw
Zw
Zw
Zw
Zw
Zw
Zw
Zw
Zw
Zw
Zw
Zw
Zw
Zw
Zw
Zw
Zw
Zw
Zw
"}
(34,1,1) = {"
Zw
Zw
Zw
yn
yn
yn
Zw
Zw
yn
yn
yn
Zw
Zw
Zw
Zw
Zw
Zw
Zw
Zw
Zw
Zw
Zw
Zw
Zw
Zw
Zw
Zw
Zw
Zw
Zw
Zw
Zw
Zw
Zw
Zw
Zw
Zw
Zw
Zw
Zw
"}
(35,1,1) = {"
Zw
Zw
yn
Zw
Zw
Zw
Zw
Zw
Zw
yn
yn
yn
Zw
Zw
Zw
Zw
Zw
Zw
Zw
Zw
Zw
Zw
Zw
Zw
Zw
Zw
Zw
Zw
Zw
Zw
Zw
Zw
Zw
Zw
Zw
Zw
Zw
Zw
Zw
Zw
"}
(36,1,1) = {"
Zw
Zw
yn
Zw
Zw
Zw
Zw
Zw
Zw
Zw
yn
yn
Zw
Zw
Zw
Zw
Zw
Zw
Zw
Zw
Zw
Zw
Zw
Zw
Zw
Zw
Zw
Zw
Zw
Zw
Zw
Zw
Zw
Zw
Zw
Zw
Zw
Zw
Zw
Zw
"}
(37,1,1) = {"
Zw
Zw
Zw
Zw
Zw
Zw
yn
Zw
Zw
Zw
Zw
yn
Zw
Zw
Zw
Zw
Zw
Zw
Zw
Zw
Zw
Zw
Zw
Zw
Zw
Zw
Zw
Zw
Zw
Zw
Zw
Zw
Zw
Zw
Zw
Zw
Zw
Zw
Zw
Zw
"}
(38,1,1) = {"
Zw
Zw
Zw
Zw
Zw
Zw
Zw
Zw
Zw
Zw
Zw
Zw
Zw
Zw
Zw
Zw
Zw
Zw
Zw
Zw
Zw
Zw
Zw
Zw
Zw
Zw
Zw
Zw
Zw
Zw
Zw
Zw
Zw
Zw
Zw
Zw
Zw
Zw
Zw
Zw
"}
(39,1,1) = {"
Zw
Zw
Zw
Zw
Zw
Zw
Zw
Zw
Zw
Zw
Zw
Zw
Zw
Zw
Zw
Zw
Zw
Zw
Zw
Zw
Zw
Zw
Zw
Zw
Zw
Zw
Zw
Zw
Zw
Zw
Zw
Zw
Zw
Zw
Zw
Zw
Zw
Zw
Zw
Zw
"}
(40,1,1) = {"
Zw
Zw
Zw
Zw
Zw
Zw
Zw
Zw
Zw
Zw
Zw
Zw
Zw
Zw
Zw
Zw
Zw
Zw
Zw
Zw
Zw
Zw
Zw
Zw
Zw
Zw
Zw
Zw
Zw
Zw
Zw
Zw
Zw
Zw
Zw
Zw
Zw
Zw
Zw
Zw
"}
