//MAP CONVERTED BY dmm2tgm.py THIS HEADER COMMENT PREVENTS RECONVERSION, DO NOT REMOVE
"at" = (
/obj/effect/decal/cleanable/dirt,
/turf/simulated/floor/wood{
	icon_state = "wood-broken5"
	},
/area/ruin/space/syndicate_listening_station)
"aW" = (
/obj/structure/disposalpipe/segment{
	dir = 4
	},
/turf/simulated/wall/r_wall,
/area/ruin/space/syndicate_listening_station)
"bU" = (
/obj/machinery/light/small,
/obj/item/storage/toolbox/syndicate,
/obj/structure/closet/syndicate,
/obj/effect/decal/cleanable/dirt,
/turf/simulated/floor/plating,
/area/ruin/space/syndicate_listening_station)
"du" = (
/obj/effect/decal/cleanable/dirt,
/turf/simulated/floor/plating,
/area/ruin/space/syndicate_listening_station)
"eg" = (
/obj/machinery/door/airlock/hatch/syndicate{
	name = "Cabin"
	},
/obj/effect/decal/cleanable/dirt,
/turf/simulated/floor/wood,
/area/ruin/space/syndicate_listening_station)
"hp" = (
/obj/structure/disposalpipe/trunk{
	dir = 4
	},
/obj/machinery/disposal,
/obj/effect/decal/cleanable/dirt,
/turf/simulated/floor/plasteel/dark,
/area/ruin/space/syndicate_listening_station)
"hr" = (
/obj/structure/cable{
	d1 = 4;
	d2 = 8;
	icon_state = "4-8";
	tag = ""
	},
/turf/simulated/floor/plating/airless,
/area/ruin/space/syndicate_listening_station/asteroid)
"iB" = (
/obj/item/taperecorder,
/obj/structure/table,
/obj/effect/decal/cleanable/dirt,
/turf/simulated/floor/plasteel/dark,
/area/ruin/space/syndicate_listening_station)
"iL" = (
/obj/structure/disposaloutlet{
	dir = 4
	},
/obj/structure/disposalpipe/trunk{
	dir = 8
	},
/turf/simulated/floor/plating/airless,
/area/ruin/space/syndicate_listening_station/asteroid)
"kE" = (
/obj/machinery/door/airlock/external{
	id_tag = "sst_away";
	req_access_txt = "150"
	},
/obj/structure/cable{
	d1 = 4;
	d2 = 8;
	icon_state = "4-8";
	tag = ""
	},
/obj/structure/fans/tiny,
/obj/effect/decal/cleanable/dirt,
/turf/simulated/floor/plating,
/area/ruin/space/syndicate_listening_station)
"kJ" = (
/turf/simulated/wall/r_wall,
/area/ruin/space/syndicate_listening_station)
"mC" = (
/obj/machinery/power/solar,
/obj/structure/cable,
/turf/simulated/floor/plasteel/airless{
	icon_state = "solarpanel"
	},
/area/ruin/space/syndicate_listening_station/asteroid)
"nC" = (
/obj/structure/cable{
	d1 = 1;
	d2 = 2;
	icon_state = "1-2";
	tag = ""
	},
/obj/machinery/light{
	dir = 8
	},
/obj/structure/table,
/obj/item/storage/box/donkpockets{
	pixel_x = 3;
	pixel_y = 3
	},
/obj/item/storage/box/donkpockets{
	pixel_x = -2;
	pixel_y = 6
	},
/obj/effect/decal/cleanable/dirt,
/turf/simulated/floor/plasteel/dark,
/area/ruin/space/syndicate_listening_station)
"oE" = (
/obj/machinery/atmospherics/portable/scrubber,
/obj/effect/decal/cleanable/dirt,
/turf/simulated/floor/plating,
/area/ruin/space/syndicate_listening_station)
"pV" = (
/obj/machinery/power/solar,
/obj/structure/cable{
	d2 = 2;
	icon_state = "0-2"
	},
/turf/simulated/floor/plasteel/airless{
	icon_state = "solarpanel"
	},
/area/ruin/space/syndicate_listening_station/asteroid)
"rK" = (
/obj/structure/disposalpipe/segment{
	dir = 4
	},
/turf/simulated/mineral/ancient,
/area/ruin/space/syndicate_listening_station/asteroid)
"rS" = (
/obj/structure/cable{
	d1 = 1;
	d2 = 2;
	icon_state = "1-2";
	tag = ""
	},
/obj/structure/falsewall/rock_ancient,
/turf/simulated/floor/plating/airless,
/area/ruin/space/syndicate_listening_station/asteroid)
"sf" = (
/obj/structure/cable{
	d1 = 4;
	d2 = 8;
	icon_state = "4-8";
	tag = ""
	},
/obj/structure/cable{
	d1 = 2;
	d2 = 4;
	icon_state = "2-4"
	},
/obj/structure/cable{
	d1 = 1;
	d2 = 4;
	icon_state = "1-4";
	tag = "90Curve"
	},
/turf/simulated/floor/plating/airless,
/area/ruin/space/syndicate_listening_station/asteroid)
"sq" = (
/obj/structure/cable{
	d1 = 4;
	d2 = 8;
	icon_state = "4-8";
	tag = ""
	},
/obj/structure/falsewall/rock_ancient,
/turf/simulated/floor/plating/airless,
/area/ruin/space/syndicate_listening_station/asteroid)
"tk" = (
/obj/structure/cable{
	d1 = 1;
	d2 = 2;
	icon_state = "1-2";
	tag = ""
	},
/turf/simulated/floor/plating/airless,
/area/ruin/space/syndicate_listening_station/asteroid)
"tF" = (
/obj/machinery/power/smes/upgraded{
	charge = 5e+006;
	input_level = 20000;
	output_level = 100000
	},
/obj/structure/cable{
	d2 = 2;
	icon_state = "0-2";
	pixel_y = 1
	},
/obj/effect/decal/cleanable/dirt,
/turf/simulated/floor/plating,
/area/ruin/space/syndicate_listening_station)
"tG" = (
/obj/structure/table,
/obj/item/paper{
	info = "<b>Mission Details</b>: You have been assigned to a newly constructed listening post constructed within an asteroid in Nanotrasen space to monitor their plasma mining operations. Accurate intel is crucial to the success of our operatives onboard, do not fail us.";
	name = "mission briefing"
	},
/obj/effect/decal/cleanable/dirt,
/obj/item/paper/monitorkey,
/turf/simulated/floor/plasteel/dark,
/area/ruin/space/syndicate_listening_station)
"un" = (
/obj/effect/decal/cleanable/dirt,
/turf/simulated/floor/plasteel/dark,
/area/ruin/space/syndicate_listening_station)
"uv" = (
/obj/structure/cable{
	d1 = 1;
	d2 = 4;
	icon_state = "1-4"
	},
/obj/structure/table,
/obj/machinery/kitchen_machine/microwave/upgraded,
/obj/effect/decal/cleanable/dirt,
/turf/simulated/floor/plasteel/dark,
/area/ruin/space/syndicate_listening_station)
"vd" = (
/obj/effect/decal/cleanable/dirt,
/turf/simulated/floor/wood,
/area/ruin/space/syndicate_listening_station)
"vP" = (
/obj/structure/cable,
/obj/machinery/power/solar_control/autostart{
	dir = 1
	},
/obj/effect/decal/cleanable/dirt,
/turf/simulated/floor/plating,
/area/ruin/space/syndicate_listening_station)
"wj" = (
/obj/machinery/door/airlock/hatch/syndicate{
	name = "Telecommunications"
	},
/obj/effect/decal/cleanable/dirt,
/turf/simulated/floor/plasteel/dark,
/area/ruin/space/syndicate_listening_station)
"yn" = (
/turf/simulated/mineral/ancient,
/area/ruin/space/syndicate_listening_station/asteroid)
"yv" = (
/obj/structure/cable{
	d1 = 1;
	d2 = 2;
	icon_state = "1-2";
	tag = ""
	},
/obj/effect/decal/cleanable/dirt,
/turf/simulated/floor/plasteel/dark,
/area/ruin/space/syndicate_listening_station)
"zb" = (
/obj/machinery/door/airlock/external{
	id_tag = "sst_away";
	req_access_txt = "150"
	},
/obj/structure/fans/tiny,
/obj/effect/decal/cleanable/dirt,
/turf/simulated/floor/plating,
/area/ruin/space/syndicate_listening_station)
"zs" = (
/obj/machinery/shower{
	pixel_y = 20
	},
/obj/item/soap/syndie,
/turf/simulated/floor/mineral/silver,
/area/ruin/space/syndicate_listening_station)
"Ab" = (
/obj/structure/closet/syndicate,
/obj/item/clothing/glasses/regular,
/obj/item/storage/firstaid,
/obj/item/storage/firstaid,
/obj/effect/decal/cleanable/dirt,
/turf/simulated/floor/plasteel/dark,
/area/ruin/space/syndicate_listening_station)
"AT" = (
/turf/simulated/floor/plating/asteroid/airless,
/area/ruin/space/syndicate_listening_station/asteroid)
"Bt" = (
/obj/structure/cable{
	d1 = 1;
	d2 = 2;
	icon_state = "1-2"
	},
/obj/effect/decal/cleanable/dirt,
/turf/simulated/floor/plating,
/area/ruin/space/syndicate_listening_station)
"Bu" = (
/obj/machinery/tcomms/relay/ruskie{
	network_id = "SYNDIE-LPOST-RELAY"
	},
/obj/effect/decal/cleanable/dirt,
/turf/simulated/floor/plasteel/dark,
/area/ruin/space/syndicate_listening_station)
"BD" = (
/obj/structure/cable{
	d1 = 1;
	d2 = 2;
	icon_state = "1-2";
	tag = ""
	},
/obj/structure/cable{
	d1 = 1;
	d2 = 8;
	icon_state = "1-8"
	},
/turf/simulated/floor/plating/airless,
/area/ruin/space/syndicate_listening_station/asteroid)
"Cw" = (
/obj/structure/filingcabinet,
/obj/item/paper{
	info = "A good start to the operation: intercepted Nanotrasen military communications. A convoy is scheduled to transfer nuclear warheads to a new military base. This is as good a chance as any to get our hands on some heavy weaponry, I suggest we take it.";
	name = "april report"
	},
/obj/item/paper{
	info = "Nothing of real interest to report this month. I have intercepted faint transmissions from what appears to be some sort of pirate radio station. They do not appear to be relevant to my assignment.";
	name = "may report"
	},
/obj/item/paper{
	info = "Nanotrasen communications have been noticably less frequent recently.  The pirate radio station I found last month has been transmitting pro-Nanotrasen propaganda. I will continue to monitor it.";
	name = "june report"
	},
/obj/item/paper{
	info = "Nothing of interest to report.";
	name = "july report"
	},
/obj/item/paper{
	info = "Nothing of interest to report.";
	name = "august report"
	},
/obj/item/paper{
	info = "Nothing of interest to report.";
	name = "september report"
	},
/obj/item/paper{
	info = "Nothing of interest to report.";
	name = "october report"
	},
/obj/item/paper{
	info = "1 x Stechtkin pistol - $600<br>1 x silencer - $200<br>shipping charge - $4360<br>total - $5160";
	name = "receipt"
	},
/obj/item/tape,
/obj/item/tape,
/obj/item/tape,
/obj/item/tape,
/obj/item/tape,
/obj/item/tape,
/obj/effect/decal/cleanable/dirt,
/turf/simulated/floor/plasteel/dark,
/area/ruin/space/syndicate_listening_station)
"CF" = (
/obj/machinery/light{
	dir = 4
	},
/obj/effect/decal/cleanable/dirt,
/obj/machinery/economy/vending/cigarette/free,
/turf/simulated/floor/plasteel/dark,
/area/ruin/space/syndicate_listening_station)
"CG" = (
/obj/structure/closet/secure_closet/personal/cabinet,
/obj/effect/decal/cleanable/dirt,
/turf/simulated/floor/wood,
/area/ruin/space/syndicate_listening_station)
"CI" = (
/obj/structure/cable{
	d1 = 4;
	d2 = 8;
	icon_state = "4-8";
	tag = ""
	},
/obj/machinery/light/small{
	dir = 1
	},
/obj/effect/decal/cleanable/dirt,
/turf/simulated/floor/plating,
/area/ruin/space/syndicate_listening_station)
"DT" = (
/obj/machinery/light{
	dir = 8
	},
/obj/effect/decal/cleanable/dirt,
/turf/simulated/floor/plasteel/dark,
/area/ruin/space/syndicate_listening_station)
"Ej" = (
/obj/structure/cable{
	d1 = 4;
	d2 = 8;
	icon_state = "4-8";
	tag = ""
	},
/obj/effect/decal/cleanable/dirt,
/turf/simulated/floor/plating,
/area/ruin/space/syndicate_listening_station)
"Em" = (
/obj/structure/cable{
	d2 = 8;
	icon_state = "0-8"
	},
/obj/machinery/power/terminal,
/obj/effect/spawner/random_spawners/cobweb_right_rare,
/obj/effect/decal/cleanable/dirt,
/turf/simulated/floor/plating,
/area/ruin/space/syndicate_listening_station)
"FW" = (
/obj/structure/table,
/obj/effect/decal/cleanable/dirt,
/turf/simulated/floor/plasteel/dark,
/area/ruin/space/syndicate_listening_station)
"Go" = (
/mob/living/simple_animal/hostile/syndicate{
	desc = "A weary looking Syndicate operative.";
	environment_smash = 0
	},
/obj/effect/decal/cleanable/dirt,
/turf/simulated/floor/plasteel/dark,
/area/ruin/space/syndicate_listening_station)
"Gy" = (
/obj/structure/falsewall/rock_ancient,
/turf/simulated/floor/plating/asteroid/airless,
/area/ruin/space/syndicate_listening_station/asteroid)
"GQ" = (
/obj/structure/cable{
	d1 = 4;
	d2 = 8;
	icon_state = "4-8";
	tag = ""
	},
/obj/machinery/atmospherics/portable/canister/air,
/obj/effect/decal/cleanable/dirt,
/turf/simulated/floor/plating,
/area/ruin/space/syndicate_listening_station)
"Hg" = (
/obj/structure/closet/syndicate,
/obj/item/clothing/suit/space/syndicate/black/red,
/obj/item/clothing/head/helmet/space/syndicate/black/red,
/obj/item/clothing/mask/gas/syndicate,
/obj/item/tank/internals/oxygen,
/obj/item/tank/jetpack/oxygen,
/obj/effect/decal/cleanable/dirt,
/turf/simulated/floor/plasteel/dark,
/area/ruin/space/syndicate_listening_station)
"HZ" = (
/obj/structure/cable{
	d1 = 1;
	d2 = 8;
	icon_state = "1-8"
	},
/turf/simulated/floor/plating/airless,
/area/ruin/space/syndicate_listening_station/asteroid)
"Km" = (
/obj/machinery/light/small{
	dir = 1
	},
/obj/structure/dresser,
/obj/effect/decal/cleanable/dirt,
/turf/simulated/floor/wood,
/area/ruin/space/syndicate_listening_station)
"Mv" = (
/obj/item/bedsheet/syndie,
/obj/structure/bed/pod,
/obj/effect/decal/cleanable/dirt,
/turf/simulated/floor/wood,
/area/ruin/space/syndicate_listening_station)
"MF" = (
/obj/structure/cable,
/obj/machinery/power/tracker,
/turf/simulated/floor/plasteel/airless{
	icon_state = "solarpanel"
	},
/area/ruin/space/syndicate_listening_station/asteroid)
"MO" = (
/obj/machinery/light{
	dir = 4
	},
/obj/effect/decal/cleanable/dirt,
/turf/simulated/floor/plasteel/dark,
/area/ruin/space/syndicate_listening_station)
"Nd" = (
/turf/simulated/floor/mineral/silver,
/area/ruin/space/syndicate_listening_station)
"Ow" = (
/obj/machinery/door/airlock/external{
	id_tag = "sst_away";
	req_access_txt = "150"
	},
/obj/effect/decal/cleanable/dirt,
/turf/simulated/floor/plating,
/area/ruin/space/syndicate_listening_station)
"OO" = (
/obj/structure/cable{
	d1 = 2;
	d2 = 4;
	icon_state = "2-4"
	},
/turf/simulated/floor/plating/airless,
/area/ruin/space/syndicate_listening_station/asteroid)
"Pc" = (
/obj/structure/cable{
	d1 = 1;
	d2 = 2;
	icon_state = "1-2";
	tag = ""
	},
/obj/effect/decal/cleanable/dirt,
/turf/simulated/floor/plating,
/area/ruin/space/syndicate_listening_station)
"PH" = (
/obj/item/gps/ruin{
	gpstag = "Encrypted Signal"
	},
/turf/simulated/wall/r_wall,
/area/ruin/space/syndicate_listening_station)
"PP" = (
/obj/machinery/light/small,
/turf/simulated/floor/mineral/silver,
/area/ruin/space/syndicate_listening_station)
"RN" = (
/obj/machinery/door/airlock/silver{
	name = "Bathroom"
	},
/turf/simulated/floor/mineral/silver,
/area/ruin/space/syndicate_listening_station)
"Sq" = (
/obj/structure/cable{
	d1 = 4;
	d2 = 8;
	icon_state = "4-8";
	tag = ""
	},
/obj/effect/decal/cleanable/dirt,
/turf/simulated/floor/plasteel/dark,
/area/ruin/space/syndicate_listening_station)
"TS" = (
/obj/machinery/door/airlock/external{
	id_tag = "sst_away";
	req_access_txt = "150"
	},
/obj/structure/cable{
	d1 = 4;
	d2 = 8;
	icon_state = "4-8";
	tag = ""
	},
/obj/effect/decal/cleanable/dirt,
/turf/simulated/floor/plating,
/area/ruin/space/syndicate_listening_station)
"TZ" = (
/obj/structure/table,
/obj/item/paper{
	info = "Nothing of interest to report.";
	name = "november report"
	},
/obj/item/pen,
/obj/item/tape,
/obj/item/radio/intercom{
	freerange = 1;
	pixel_y = -24;
	name = "intercom"
	},
/obj/item/paper_bin,
/obj/item/pen,
/obj/effect/decal/cleanable/dirt,
/turf/simulated/floor/plasteel/dark,
/area/ruin/space/syndicate_listening_station)
"UM" = (
/obj/machinery/door/airlock/hatch/syndicate{
	name = "Engineering"
	},
/obj/structure/cable{
	d1 = 1;
	d2 = 2;
	icon_state = "1-2";
	tag = ""
	},
/obj/effect/decal/cleanable/dirt,
/turf/simulated/floor/plasteel/dark,
/area/ruin/space/syndicate_listening_station)
"Vn" = (
/obj/machinery/computer/message_monitor{
	dir = 1
	},
/obj/effect/decal/cleanable/dirt,
/turf/simulated/floor/plasteel/dark,
/area/ruin/space/syndicate_listening_station)
"WN" = (
/obj/structure/cable{
	d1 = 2;
	d2 = 4;
	icon_state = "2-4"
	},
/obj/structure/cable{
	d1 = 1;
	d2 = 4;
	icon_state = "1-4";
	tag = "90Curve"
	},
/turf/simulated/floor/plating/airless,
/area/ruin/space/syndicate_listening_station/asteroid)
"Xm" = (
/obj/structure/toilet{
	dir = 8
	},
/turf/simulated/floor/mineral/silver,
/area/ruin/space/syndicate_listening_station)
"Xz" = (
/obj/structure/cable{
	d1 = 2;
	d2 = 4;
	icon_state = "2-4"
	},
/obj/structure/cable{
	d1 = 2;
	d2 = 8;
	icon_state = "2-8";
	tag = ""
	},
/obj/effect/decal/cleanable/dirt,
/turf/simulated/floor/plating,
/area/ruin/space/syndicate_listening_station)
"Ya" = (
/obj/machinery/power/apc/syndicate/directional/east,
/obj/structure/cable{
	d2 = 8;
	icon_state = "0-8"
	},
/obj/effect/decal/cleanable/dirt,
/obj/machinery/economy/vending/snack/free,
/turf/simulated/floor/plasteel/dark,
/area/ruin/space/syndicate_listening_station)
"Zw" = (
/turf/template_noop,
/area/template_noop)

(1,1,1) = {"
Zw
Zw
Zw
Zw
Zw
Zw
Zw
Zw
Zw
Zw
Zw
Zw
Zw
Zw
Zw
Zw
pV
WN
mC
AT
pV
WN
mC
Zw
Zw
Zw
Zw
Zw
Zw
Zw
Zw
Zw
Zw
Zw
Zw
Zw
Zw
Zw
Zw
Zw
"}
(2,1,1) = {"
Zw
Zw
Zw
Zw
Zw
Zw
Zw
Zw
Zw
Zw
Zw
Zw
Zw
Zw
yn
AT
pV
sf
mC
AT
pV
sf
mC
AT
Zw
Zw
Zw
Zw
Zw
Zw
Zw
Zw
Zw
yn
Zw
Zw
Zw
Zw
Zw
Zw
"}
(3,1,1) = {"
Zw
yn
Zw
Zw
Zw
Zw
Zw
Zw
Zw
Zw
Zw
Zw
Zw
yn
yn
AT
pV
sf
mC
AT
pV
sf
mC
AT
Zw
Zw
Zw
Zw
Zw
Zw
yn
Zw
yn
yn
Zw
yn
Zw
Zw
Zw
Zw
"}
(4,1,1) = {"
Zw
yn
yn
yn
yn
Zw
Zw
Zw
Zw
Zw
Zw
Zw
Zw
yn
yn
yn
pV
sf
mC
AT
pV
sf
mC
AT
AT
Zw
Zw
Zw
Zw
Zw
yn
yn
yn
yn
Zw
yn
yn
yn
Zw
yn
"}
(5,1,1) = {"
Zw
Zw
yn
yn
yn
yn
Zw
Zw
Zw
Zw
Zw
Zw
yn
yn
yn
yn
AT
hr
AT
AT
AT
hr
AT
AT
AT
AT
Zw
Zw
Zw
Zw
Zw
yn
yn
Zw
Zw
yn
yn
yn
yn
Zw
"}
(6,1,1) = {"
Zw
Zw
yn
yn
yn
yn
yn
Zw
Zw
Zw
Zw
Zw
yn
yn
yn
OO
tk
BD
tk
tk
tk
BD
tk
tk
tk
MF
AT
yn
Zw
Zw
Zw
yn
yn
Zw
yn
yn
yn
Zw
yn
Zw
"}
(7,1,1) = {"
Zw
Zw
yn
yn
yn
yn
yn
Zw
Zw
Zw
Zw
yn
yn
yn
yn
sq
yn
yn
yn
yn
yn
yn
AT
AT
yn
AT
AT
yn
yn
Zw
Zw
Zw
yn
yn
yn
yn
Zw
Zw
Zw
Zw
"}
(8,1,1) = {"
Zw
Zw
Zw
yn
yn
yn
yn
yn
Zw
Zw
yn
yn
yn
yn
OO
HZ
yn
yn
yn
yn
yn
AT
AT
yn
yn
yn
yn
yn
yn
Zw
Zw
Zw
Zw
yn
yn
Zw
Zw
Zw
Zw
Zw
"}
(9,1,1) = {"
Zw
Zw
Zw
Zw
yn
Zw
Zw
yn
Zw
yn
yn
OO
rS
tk
HZ
yn
yn
yn
yn
yn
yn
AT
AT
yn
yn
yn
yn
yn
yn
yn
Zw
Zw
Zw
Zw
Zw
Zw
Zw
Zw
Zw
Zw
"}
(10,1,1) = {"
Zw
Zw
Zw
Zw
Zw
Zw
Zw
Zw
Zw
yn
yn
hr
yn
yn
yn
yn
yn
yn
yn
yn
yn
yn
yn
yn
yn
yn
yn
yn
yn
yn
Zw
yn
Zw
Zw
Zw
Zw
Zw
Zw
Zw
Zw
"}
(11,1,1) = {"
Zw
Zw
Zw
Zw
Zw
Zw
Zw
Zw
yn
yn
kJ
kE
kJ
yn
yn
yn
yn
yn
yn
yn
yn
yn
yn
yn
yn
yn
yn
yn
yn
yn
yn
yn
Zw
Zw
Zw
Zw
Zw
Zw
Zw
Zw
"}
(12,1,1) = {"
Zw
Zw
Zw
Zw
Zw
Zw
Zw
Zw
yn
yn
kJ
Ej
kJ
yn
yn
yn
yn
yn
yn
yn
yn
yn
yn
yn
yn
yn
yn
yn
yn
yn
yn
yn
Zw
Zw
Zw
Zw
Zw
Zw
Zw
Zw
"}
(13,1,1) = {"
Zw
Zw
Zw
Zw
Zw
Zw
Zw
yn
yn
yn
kJ
TS
kJ
kJ
kJ
yn
yn
kJ
kJ
kJ
kJ
yn
yn
yn
yn
yn
yn
yn
yn
yn
yn
yn
Zw
Zw
Zw
Zw
Zw
Zw
Zw
Zw
"}
(14,1,1) = {"
Zw
Zw
Zw
Zw
Zw
Zw
Zw
yn
yn
yn
kJ
Xz
Bt
vP
kJ
yn
yn
kJ
CG
vd
kJ
yn
yn
yn
yn
yn
yn
yn
yn
yn
yn
yn
yn
Zw
Zw
Zw
Zw
Zw
Zw
Zw
"}
(15,1,1) = {"
Zw
Zw
Zw
Zw
Zw
Zw
Zw
yn
yn
yn
kJ
GQ
du
bU
kJ
yn
yn
kJ
Km
at
kJ
kJ
kJ
kJ
kJ
yn
yn
yn
yn
yn
yn
yn
yn
Zw
Zw
Zw
Zw
Zw
Zw
Zw
"}
(16,1,1) = {"
Zw
Zw
Zw
Zw
Zw
Zw
Zw
yn
yn
yn
kJ
GQ
du
oE
kJ
yn
yn
kJ
Mv
vd
kJ
Cw
DT
iB
kJ
yn
yn
yn
yn
yn
yn
yn
AT
Zw
Zw
Zw
Zw
Zw
Zw
Zw
"}
(17,1,1) = {"
Zw
Zw
Zw
Zw
Zw
Zw
Zw
Zw
yn
yn
kJ
CI
du
du
kJ
kJ
kJ
kJ
kJ
eg
kJ
un
un
TZ
kJ
yn
yn
yn
yn
yn
yn
AT
AT
Zw
Zw
Zw
Zw
Zw
Zw
Zw
"}
(18,1,1) = {"
Zw
Zw
Zw
Zw
Zw
Zw
Zw
Zw
yn
yn
kJ
Em
tF
Pc
UM
yv
nC
uv
FW
un
wj
un
Go
Vn
kJ
yn
yn
yn
yn
yn
AT
AT
AT
Zw
Zw
Zw
Zw
Zw
Zw
Zw
"}
(19,1,1) = {"
Zw
Zw
Zw
Zw
Zw
Zw
Zw
Zw
yn
yn
kJ
kJ
kJ
kJ
kJ
un
un
Sq
un
un
kJ
un
un
tG
kJ
yn
yn
yn
yn
yn
AT
AT
Zw
Zw
Zw
Zw
Zw
Zw
Zw
Zw
"}
(20,1,1) = {"
Zw
Zw
Zw
Zw
Zw
Zw
Zw
Zw
Zw
yn
yn
kJ
zs
PP
PH
un
un
Sq
un
un
kJ
Ab
MO
Bu
kJ
yn
yn
yn
yn
AT
AT
AT
Zw
Zw
Zw
Zw
Zw
Zw
Zw
Zw
"}
(21,1,1) = {"
Zw
Zw
Zw
Zw
Zw
Zw
Zw
Zw
Zw
yn
yn
kJ
Xm
Nd
RN
un
un
Sq
un
un
kJ
kJ
kJ
kJ
kJ
yn
yn
yn
yn
AT
AT
Zw
Zw
Zw
Zw
Zw
Zw
Zw
Zw
Zw
"}
(22,1,1) = {"
Zw
Zw
Zw
Zw
Zw
Zw
Zw
Zw
Zw
yn
yn
kJ
kJ
kJ
kJ
un
Hg
Ya
CF
hp
kJ
yn
yn
yn
yn
yn
yn
yn
AT
AT
AT
Zw
Zw
Zw
Zw
Zw
Zw
Zw
Zw
Zw
"}
(23,1,1) = {"
Zw
Zw
Zw
Zw
Zw
Zw
Zw
Zw
Zw
Zw
yn
yn
yn
yn
kJ
Ow
kJ
kJ
kJ
aW
kJ
yn
yn
yn
yn
yn
yn
yn
AT
AT
Zw
Zw
Zw
Zw
Zw
Zw
Zw
Zw
Zw
Zw
"}
(24,1,1) = {"
Zw
Zw
Zw
Zw
yn
yn
yn
Zw
Zw
Zw
yn
yn
yn
yn
kJ
du
kJ
yn
yn
rK
yn
yn
yn
yn
yn
yn
yn
AT
AT
AT
Zw
Zw
Zw
Zw
Zw
Zw
Zw
Zw
Zw
Zw
"}
(25,1,1) = {"
Zw
Zw
Zw
Zw
Zw
yn
yn
Zw
Zw
Zw
Zw
yn
yn
yn
kJ
zb
kJ
yn
yn
rK
yn
yn
yn
yn
yn
yn
yn
AT
AT
Zw
Zw
Zw
Zw
Zw
Zw
Zw
Zw
Zw
Zw
Zw
"}
(26,1,1) = {"
Zw
Zw
Zw
yn
Zw
yn
yn
yn
Zw
Zw
Zw
yn
yn
yn
AT
AT
AT
yn
yn
rK
yn
yn
yn
yn
yn
yn
yn
AT
AT
Zw
Zw
Zw
Zw
Zw
Zw
Zw
Zw
Zw
Zw
Zw
"}
(27,1,1) = {"
Zw
Zw
Zw
Zw
Zw
Zw
yn
yn
Zw
Zw
Zw
Zw
yn
yn
AT
AT
yn
yn
yn
iL
yn
yn
yn
yn
yn
yn
AT
AT
Zw
Zw
Zw
Zw
Zw
Zw
Zw
Zw
Zw
Zw
Zw
Zw
"}
(28,1,1) = {"
Zw
Zw
Zw
Zw
Zw
Zw
Zw
Zw
Zw
Zw
Zw
Zw
Zw
yn
yn
Gy
yn
yn
yn
Zw
yn
yn
yn
Zw
yn
AT
AT
AT
Zw
Zw
Zw
Zw
Zw
Zw
Zw
Zw
Zw
Zw
Zw
Zw
"}
(29,1,1) = {"
Zw
Zw
Zw
Zw
Zw
Zw
Zw
Zw
Zw
Zw
Zw
Zw
Zw
Zw
yn
Zw
Zw
Zw
yn
Zw
yn
yn
Zw
Zw
yn
AT
Zw
Zw
Zw
Zw
Zw
Zw
Zw
Zw
Zw
Zw
Zw
Zw
Zw
Zw
"}
(30,1,1) = {"
Zw
Zw
Zw
Zw
Zw
Zw
Zw
Zw
Zw
Zw
Zw
Zw
Zw
Zw
Zw
Zw
Zw
Zw
Zw
Zw
Zw
Zw
Zw
Zw
Zw
Zw
Zw
Zw
Zw
Zw
Zw
Zw
Zw
Zw
Zw
Zw
Zw
Zw
Zw
Zw
"}
(31,1,1) = {"
Zw
Zw
Zw
yn
yn
Zw
Zw
Zw
Zw
Zw
Zw
Zw
Zw
Zw
Zw
Zw
Zw
Zw
Zw
Zw
Zw
Zw
Zw
Zw
Zw
Zw
Zw
Zw
Zw
Zw
Zw
Zw
Zw
Zw
Zw
Zw
Zw
Zw
Zw
Zw
"}
(32,1,1) = {"
Zw
Zw
yn
yn
yn
Zw
Zw
Zw
Zw
yn
Zw
Zw
Zw
Zw
Zw
Zw
Zw
Zw
Zw
Zw
Zw
Zw
Zw
Zw
Zw
Zw
Zw
Zw
Zw
Zw
Zw
Zw
Zw
Zw
Zw
Zw
Zw
Zw
Zw
Zw
"}
(33,1,1) = {"
Zw
Zw
yn
yn
yn
yn
Zw
Zw
yn
yn
Zw
Zw
Zw
Zw
Zw
Zw
Zw
Zw
Zw
Zw
Zw
Zw
Zw
Zw
Zw
Zw
Zw
Zw
Zw
Zw
Zw
Zw
Zw
Zw
Zw
Zw
Zw
Zw
Zw
Zw
"}
(34,1,1) = {"
Zw
Zw
Zw
yn
yn
yn
Zw
Zw
yn
yn
yn
Zw
Zw
Zw
Zw
Zw
Zw
Zw
Zw
Zw
Zw
Zw
Zw
Zw
Zw
Zw
Zw
Zw
Zw
Zw
Zw
Zw
Zw
Zw
Zw
Zw
Zw
Zw
Zw
Zw
"}
(35,1,1) = {"
Zw
Zw
yn
Zw
Zw
Zw
Zw
Zw
Zw
yn
yn
yn
Zw
Zw
Zw
Zw
Zw
Zw
Zw
Zw
Zw
Zw
Zw
Zw
Zw
Zw
Zw
Zw
Zw
Zw
Zw
Zw
Zw
Zw
Zw
Zw
Zw
Zw
Zw
Zw
"}
(36,1,1) = {"
Zw
Zw
yn
Zw
Zw
Zw
Zw
Zw
Zw
Zw
yn
yn
Zw
Zw
Zw
Zw
Zw
Zw
Zw
Zw
Zw
Zw
Zw
Zw
Zw
Zw
Zw
Zw
Zw
Zw
Zw
Zw
Zw
Zw
Zw
Zw
Zw
Zw
Zw
Zw
"}
(37,1,1) = {"
Zw
Zw
Zw
Zw
Zw
Zw
yn
Zw
Zw
Zw
Zw
yn
Zw
Zw
Zw
Zw
Zw
Zw
Zw
Zw
Zw
Zw
Zw
Zw
Zw
Zw
Zw
Zw
Zw
Zw
Zw
Zw
Zw
Zw
Zw
Zw
Zw
Zw
Zw
Zw
"}
(38,1,1) = {"
Zw
Zw
Zw
Zw
Zw
Zw
Zw
Zw
Zw
Zw
Zw
Zw
Zw
Zw
Zw
Zw
Zw
Zw
Zw
Zw
Zw
Zw
Zw
Zw
Zw
Zw
Zw
Zw
Zw
Zw
Zw
Zw
Zw
Zw
Zw
Zw
Zw
Zw
Zw
Zw
"}
(39,1,1) = {"
Zw
Zw
Zw
Zw
Zw
Zw
Zw
Zw
Zw
Zw
Zw
Zw
Zw
Zw
Zw
Zw
Zw
Zw
Zw
Zw
Zw
Zw
Zw
Zw
Zw
Zw
Zw
Zw
Zw
Zw
Zw
Zw
Zw
Zw
Zw
Zw
Zw
Zw
Zw
Zw
"}
(40,1,1) = {"
Zw
Zw
Zw
Zw
Zw
Zw
Zw
Zw
Zw
Zw
Zw
Zw
Zw
Zw
Zw
Zw
Zw
Zw
Zw
Zw
Zw
Zw
Zw
Zw
Zw
Zw
Zw
Zw
Zw
Zw
Zw
Zw
Zw
Zw
Zw
Zw
Zw
Zw
Zw
Zw
"}
