//MAP CONVERTED BY dmm2tgm.py THIS HEADER COMMENT PREVENTS RECONVERSION, DO NOT REMOVE
"a" = (
/obj/effect/spawner/window/reinforced,
/turf/simulated/floor/plating,
/area/ruin/powered)
"e" = (
/obj/item/paper{
	text = To exit push the wall and always try to go west.
	},
/turf/simulated/floor/plating/asteroid,
/area/ruin/unpowered/no_grav)
"f" = (
/obj/structure/table/glass,
/obj/item/coin/gold,
/turf/simulated/floor/plating/asteroid,
/area/ruin/unpowered/no_grav)
"h" = (
/turf/simulated/floor/plating/asteroid,
/area/ruin/unpowered/no_grav)
"i" = (
/turf/simulated/floor/plasteel,
/area/ruin/powered{
	no_air = 1
	})
"k" = (
/turf/simulated/wall/indestructible,
/area/ruin/unpowered)
"m" = (
/obj/item/assembly/signaler/anomaly{
	name = "SCP-184";
	pixel_y = 8
	},
/obj/structure/table/holotable,
/turf/simulated/floor/plating/asteroid,
/area/ruin/unpowered/no_grav)
"n" = (
/turf/simulated/wall,
/area/ruin/unpowered/no_grav)
"q" = (
/obj/item/paper{
	text = "I am writing this just in case someone happens to find it. Yeah I know it sounds weird but I've been facing unending walls for the last 3 days and I need some rest. I was sent here by Nanotrasen to check what is inside this mess, but that does not matter anymore. I don't have much oxygen left and I can't identify the way I came here. I'm kind of screwed."
	},
/turf/simulated/floor/plating/asteroid,
/area/ruin/unpowered/no_grav)
"r" = (
/turf/simulated/wall/indestructible,
/area/ruin/unpowered/no_grav)
"s" = (
/obj/structure/table/abductor,
/obj/item/coin/diamond,
/turf/simulated/floor/plating/asteroid,
/area/ruin/unpowered/no_grav)
"v" = (
/turf/simulated/wall/indestructible,
/area/ruin/powered)
"x" = (
/obj/machinery/door/airlock/external,
/turf/simulated/floor/plasteel{
	blocks_air = 1
	},
/area/ruin/powered)
"z" = (
/obj/structure/table/reinforced/brass,
/obj/item/coin/mythril,
/turf/simulated/floor/plating/asteroid,
/area/ruin/unpowered/no_grav)
"E" = (
/obj/structure/table/holotable/wood,
/obj/item/coin/mime,
/turf/simulated/floor/plating/asteroid,
/area/ruin/unpowered/no_grav)
"F" = (
/obj/structure/table,
/obj/item/flashlight/lantern,
/obj/item/flashlight/lantern,
/obj/item/flashlight/lantern,
/obj/item/flashlight/lantern,
/obj/item/flashlight/lantern,
/obj/machinery/light{
	dir = 8
	},
/turf/simulated/floor/plasteel,
/area/ruin/powered)
"I" = (
/turf/space,
/area/space)
"J" = (
/obj/machinery/door/airlock/hatch{
	desc = "Twists and turns until you loose your head";
	name = "Maze"
	},
/turf/simulated/floor/plasteel{
	blocks_air = 1
	},
/area/ruin/powered)
"L" = (
/obj/structure/table/wood/fancy,
/obj/item/coin/clown,
/turf/simulated/floor/plating/asteroid,
/area/ruin/unpowered/no_grav)
"M" = (
/mob/living/simple_animal/hostile/carp,
/turf/simulated/floor/plating/asteroid,
/area/ruin/unpowered/no_grav)
"N" = (
/obj/structure/falsewall,
/obj/effect/turf_decal/arrows{
	dir = 8;
	pixel_x = 14;
	pixel_y = 13
	},
/turf/simulated/floor/plating,
/area/ruin/unpowered/no_grav)
"O" = (
/obj/structure/dispenser{
	pixel_x = -1
	},
/obj/machinery/light{
	dir = 4
	},
/turf/simulated/floor/plasteel,
/area/ruin/powered)
"S" = (
/obj/machinery/door/poddoor{
	id_tag = "mazeExit";
	name = "Blast Door";
	opacity = 0
	},
/turf/simulated/floor/plating,
/area/ruin/powered{
	has_gravity = 0
	})
"U" = (
/obj/machinery/door_control{
	id = "mazeExit";
	name = "Exit gate control";
	pixel_x = -24;
	pixel_y = 6
	},
/turf/simulated/floor/plating/asteroid,
/area/ruin/powered{
	has_gravity = 0
	})
"V" = (
/obj/structure/table/abductor,
/obj/item/coin/plasma,
/turf/simulated/floor/plating/asteroid,
/area/ruin/unpowered/no_grav)
"X" = (
/turf/simulated/floor/plasteel,
/area/ruin/powered)

(1,1,1) = {"
I
I
I
I
I
I
I
I
I
I
I
I
I
I
I
v
v
a
a
v
k
r
r
r
r
r
r
r
r
r
r
r
r
r
r
r
r
r
r
r
r
r
r
r
r
r
r
r
r
r
r
r
r
r
r
r
r
r
r
r
r
r
r
r
r
r
r
r
r
r
r
r
r
r
r
r
r
r
r
r
r
r
r
r
r
r
r
r
r
r
r
r
r
r
r
r
r
r
r
r
r
r
r
r
r
r
r
r
r
r
r
r
r
r
r
r
r
r
r
r
"}
(2,1,1) = {"
I
I
I
I
I
I
I
I
I
I
I
I
I
I
I
v
X
X
X
F
k
h
h
h
h
h
h
h
h
h
n
h
h
h
h
h
h
h
h
h
n
h
h
h
h
h
h
h
h
h
h
h
h
h
h
h
h
h
h
h
h
n
h
h
h
h
h
h
h
h
h
h
h
n
h
h
h
h
h
h
h
h
h
h
h
h
h
h
h
n
h
h
h
r
h
h
h
h
h
h
h
h
h
r
h
h
h
h
h
h
h
h
h
h
h
h
h
h
h
r
"}
(3,1,1) = {"
I
I
I
I
I
I
I
I
I
I
I
I
a
a
v
v
X
X
X
X
k
h
n
n
n
n
n
h
n
h
n
h
n
n
n
n
n
n
n
h
n
h
n
n
n
n
n
n
n
n
n
n
n
h
n
h
n
n
h
n
h
n
h
n
n
n
n
n
n
n
n
n
h
n
h
n
n
n
n
n
n
n
n
n
n
n
n
n
h
n
h
n
h
r
h
r
r
r
r
r
h
r
h
r
h
r
r
r
r
r
r
h
r
r
r
h
r
h
r
r
"}
(4,1,1) = {"
I
I
I
I
I
I
I
I
I
I
I
I
x
i
x
X
X
X
X
X
J
h
n
h
h
h
n
h
n
h
n
h
h
h
h
h
h
h
n
h
n
h
h
h
h
h
h
h
h
h
h
h
n
h
n
h
n
h
n
h
h
n
h
n
h
h
h
h
h
h
h
n
h
n
h
n
h
n
h
h
h
n
h
h
h
n
h
n
h
n
h
n
h
r
h
r
h
r
h
r
h
r
h
r
h
r
h
h
h
h
h
h
r
h
r
h
r
h
h
r
"}
(5,1,1) = {"
I
I
I
I
I
I
I
I
I
I
I
I
a
a
v
v
X
X
X
X
k
h
n
h
n
h
n
h
n
h
n
h
n
n
n
n
n
h
n
h
n
h
n
n
n
n
n
n
n
n
n
h
n
h
n
h
h
h
h
h
h
n
h
n
h
n
n
n
n
n
h
n
h
n
h
n
h
n
h
n
h
n
h
n
h
n
h
n
h
n
h
n
h
r
h
r
h
r
h
r
h
r
h
r
h
r
h
r
r
r
r
r
r
h
r
h
r
r
h
r
"}
(6,1,1) = {"
I
I
I
I
I
I
I
I
I
I
I
I
I
I
I
v
X
X
X
O
k
h
n
h
n
h
n
h
n
h
n
h
n
h
h
h
h
h
n
h
n
h
h
h
h
h
h
h
h
h
n
h
n
h
n
n
h
n
n
n
h
n
h
n
h
n
h
h
h
n
h
n
h
n
h
n
h
n
h
n
h
n
h
n
h
n
h
n
h
n
h
n
h
r
h
r
h
r
h
r
h
r
h
r
h
r
h
h
h
h
h
h
h
h
r
h
h
h
h
r
"}
(7,1,1) = {"
I
I
I
I
I
I
I
I
I
I
I
I
I
I
I
v
v
a
a
v
k
h
n
h
n
h
h
h
n
h
h
h
n
n
h
n
n
n
n
h
n
h
n
n
n
n
n
n
n
h
n
h
n
h
h
n
h
h
h
n
h
n
h
h
h
h
h
n
h
n
h
n
h
n
h
h
h
h
h
n
h
h
h
n
h
n
h
n
h
n
h
n
h
r
h
r
h
h
h
r
h
r
h
r
h
r
r
r
r
r
r
r
r
r
r
r
r
r
r
r
"}
(8,1,1) = {"
I
I
I
I
I
I
I
I
I
I
I
I
I
I
I
I
I
I
I
I
r
h
n
n
n
n
n
n
n
h
n
h
h
n
h
n
h
h
h
h
n
h
h
h
h
h
h
h
n
h
n
h
n
n
h
n
n
n
h
n
h
n
h
n
n
n
n
n
n
n
h
n
h
n
h
n
n
n
n
n
n
n
n
n
h
n
h
n
h
n
h
n
n
r
h
r
r
h
r
r
h
r
h
r
h
h
h
h
h
h
h
h
h
h
h
h
h
h
h
r
"}
(9,1,1) = {"
I
I
I
I
I
I
I
I
I
I
I
I
I
I
I
I
I
I
I
I
r
h
h
h
h
h
h
h
h
h
n
n
n
n
h
n
n
n
n
n
n
h
n
n
n
n
n
h
n
h
n
h
n
h
h
n
h
n
h
n
h
n
h
n
h
h
h
h
h
h
h
n
h
n
h
n
h
h
h
h
h
h
h
h
h
h
h
n
h
h
h
h
n
h
h
h
r
h
r
h
h
r
h
r
r
r
r
r
r
r
r
r
r
r
r
r
r
r
h
r
"}
(10,1,1) = {"
I
I
I
I
I
I
I
I
I
I
I
I
I
I
I
I
I
I
I
I
r
h
n
h
n
h
n
h
n
h
n
h
h
h
h
h
h
h
n
h
n
h
n
h
h
h
n
h
n
h
n
h
n
h
n
n
h
n
h
n
h
h
h
n
h
n
n
n
n
n
h
n
h
n
h
n
h
n
n
n
n
n
n
n
n
n
n
n
n
n
n
h
n
h
r
h
r
h
r
h
r
r
h
r
h
h
h
r
h
h
h
h
h
h
h
h
h
h
h
r
"}
(11,1,1) = {"
I
I
I
I
I
I
I
I
I
I
I
I
I
I
I
I
I
I
I
I
r
h
n
h
n
h
n
h
n
h
n
h
n
n
n
h
n
h
n
h
n
h
h
h
n
h
n
h
n
h
n
h
n
h
n
h
h
n
h
n
h
n
h
n
h
h
n
h
h
h
h
n
h
n
h
n
h
h
h
h
h
h
h
h
h
h
h
h
n
h
n
h
n
h
r
h
h
h
h
h
r
h
h
r
h
r
h
r
h
r
r
r
r
r
r
r
r
r
r
r
"}
(12,1,1) = {"
I
I
I
I
I
I
I
I
I
I
I
I
I
I
I
I
I
I
I
I
r
h
n
h
n
h
n
h
n
h
n
h
n
h
h
h
n
h
n
h
n
h
n
n
n
n
n
h
n
h
n
h
n
h
n
h
h
n
h
n
h
n
h
n
n
h
n
h
n
n
n
n
h
n
h
h
h
n
n
n
n
n
n
n
n
n
n
n
n
h
n
h
n
h
r
r
r
r
r
h
r
h
r
r
h
r
h
r
h
r
h
h
h
h
h
h
r
h
h
r
"}
(13,1,1) = {"
I
I
I
I
I
I
I
I
I
I
I
I
I
I
I
I
I
I
I
I
r
h
n
h
n
h
n
h
n
h
n
h
n
h
n
n
n
h
n
h
n
h
h
h
h
h
h
h
n
h
n
h
n
h
n
h
n
n
h
n
h
n
h
n
h
h
n
h
n
h
h
h
h
n
n
n
h
h
h
h
h
h
h
h
h
h
h
h
n
h
h
q
h
h
h
h
h
h
h
h
h
h
h
r
h
r
h
r
h
r
r
r
r
r
r
h
r
r
h
r
"}
(14,1,1) = {"
I
I
I
I
I
I
I
I
I
I
I
I
I
I
I
I
I
I
I
I
r
h
n
h
n
h
n
h
n
h
n
h
n
h
n
h
h
h
n
h
n
h
n
n
n
n
n
n
n
h
n
h
n
h
n
h
h
h
h
n
h
n
h
n
h
n
h
h
n
h
n
h
h
h
h
n
h
n
n
n
n
n
n
n
n
n
n
n
n
h
n
h
n
h
r
r
r
r
r
r
r
r
r
r
h
r
h
r
h
h
h
h
h
h
r
h
h
h
h
r
"}
(15,1,1) = {"
I
I
I
I
I
I
I
I
I
I
I
I
I
I
I
I
I
I
I
I
r
h
n
h
n
h
n
h
n
h
n
h
n
h
n
h
n
n
n
h
n
h
h
h
n
h
n
h
h
h
n
h
n
h
n
h
n
n
h
n
h
n
h
n
h
n
h
n
n
h
n
n
n
n
h
n
h
h
h
h
h
h
h
h
h
h
h
h
n
h
n
h
n
h
r
h
h
h
h
h
h
h
h
r
h
r
h
r
h
r
r
r
r
r
r
r
r
r
h
r
"}
(16,1,1) = {"
I
I
I
I
I
I
I
I
I
I
I
I
I
I
I
I
I
I
I
I
r
n
n
h
n
h
n
h
n
h
n
n
n
h
n
h
n
h
h
h
n
h
n
h
n
h
n
n
n
n
n
h
n
h
n
h
h
n
h
n
h
n
h
n
h
n
h
n
h
h
n
h
h
h
h
n
h
n
n
n
n
n
n
n
n
n
n
n
n
n
n
h
n
h
r
h
r
h
r
h
r
r
h
r
h
r
h
h
h
h
h
h
h
h
h
h
h
h
h
r
"}
(17,1,1) = {"
I
I
I
I
I
I
I
I
I
I
I
I
I
I
I
I
I
I
I
I
r
h
h
h
n
h
n
h
n
h
h
h
h
h
n
h
n
h
n
h
h
h
n
h
h
h
n
h
h
h
h
h
n
h
n
n
h
n
h
n
h
n
h
n
n
n
h
n
h
n
n
n
n
n
n
n
h
n
h
h
h
h
h
h
h
h
h
h
h
h
h
h
n
h
r
h
r
h
r
h
h
r
h
r
h
r
r
r
r
r
r
r
r
r
r
r
r
r
r
r
"}
(18,1,1) = {"
I
I
I
I
I
I
I
I
I
I
I
I
I
I
I
I
I
I
I
I
r
h
n
n
n
h
n
h
n
n
n
n
n
n
n
h
n
h
n
n
n
n
n
n
n
h
n
h
n
n
n
n
n
h
n
h
h
n
h
n
h
n
h
h
h
h
h
h
h
h
h
h
h
n
h
h
h
n
h
r
r
r
r
r
r
r
r
r
r
r
r
h
n
h
r
h
r
h
r
r
r
r
h
r
h
h
h
r
h
h
h
h
h
h
h
h
h
h
h
r
"}
(19,1,1) = {"
I
I
I
I
I
I
I
I
I
I
I
I
I
I
I
I
I
I
I
I
r
h
h
h
n
h
n
h
h
h
h
h
h
n
h
h
h
h
h
h
h
h
h
h
h
h
n
h
n
n
n
n
n
h
n
h
n
n
h
n
h
n
n
n
n
n
n
n
n
n
n
n
n
n
n
n
h
n
h
r
h
h
h
h
h
h
h
h
h
h
r
h
n
h
r
h
r
h
r
h
h
h
h
r
h
r
h
r
h
r
r
r
r
r
r
r
r
r
h
r
"}
(20,1,1) = {"
I
I
I
I
I
I
I
I
I
I
I
I
I
I
I
I
I
I
I
I
r
h
n
n
n
h
n
n
n
n
n
n
h
n
h
n
h
n
n
n
n
n
n
n
n
h
n
h
n
h
h
h
h
h
n
h
h
h
h
h
h
h
h
h
h
h
h
h
h
h
h
h
h
h
h
h
h
n
h
r
h
r
h
r
h
r
h
r
h
r
r
h
n
h
r
h
r
r
r
r
r
r
h
r
h
r
h
r
h
r
h
h
h
h
h
h
h
r
h
r
"}
(21,1,1) = {"
I
I
I
I
I
I
I
I
I
I
I
I
I
I
I
I
I
I
I
I
r
h
h
h
h
h
h
h
h
h
h
n
h
n
h
n
h
h
h
h
h
h
n
h
n
h
n
h
n
h
n
n
n
n
n
n
n
n
n
n
h
n
n
n
n
n
n
n
n
n
n
n
n
n
h
n
n
n
h
r
h
r
h
r
h
r
h
r
h
h
r
h
n
h
h
h
h
h
h
h
h
h
h
r
h
r
h
h
h
r
h
r
r
r
r
r
h
r
h
r
"}
(22,1,1) = {"
I
I
I
I
I
I
I
I
I
I
I
I
I
I
I
I
I
I
I
I
r
h
n
n
n
n
n
n
h
n
h
n
h
n
h
n
n
n
n
h
n
h
h
h
n
h
n
h
n
h
n
h
h
h
h
h
h
h
h
h
h
n
h
h
h
h
h
h
h
h
h
h
h
n
h
n
h
h
h
r
h
r
r
r
r
r
h
r
r
r
r
h
n
h
r
r
r
r
r
r
r
r
r
r
h
r
r
r
r
r
r
r
h
h
h
h
h
r
h
r
"}
(23,1,1) = {"
I
I
I
I
I
I
I
I
I
I
I
I
I
I
I
I
I
I
I
I
r
h
n
h
h
h
h
h
h
n
h
n
h
n
h
n
h
h
h
h
n
h
n
n
n
h
n
h
n
h
n
h
n
n
n
n
n
n
n
n
h
h
h
n
n
n
n
n
n
n
n
n
h
n
h
n
h
r
r
r
h
r
h
h
h
h
h
h
h
h
r
h
n
h
h
h
h
h
h
h
h
h
h
h
h
r
h
h
h
r
h
r
h
r
h
r
r
r
r
r
"}
(24,1,1) = {"
I
I
I
I
I
I
I
I
I
I
I
I
I
I
I
I
I
I
I
I
r
h
n
h
n
n
n
n
n
n
h
n
h
n
h
n
h
n
n
n
n
h
h
h
n
h
n
h
n
h
n
h
n
h
h
h
h
h
h
h
n
n
n
n
h
h
h
h
h
h
h
n
h
n
h
n
h
h
h
r
h
r
h
r
r
r
r
r
r
h
r
h
r
h
r
r
r
r
r
r
r
r
r
r
h
r
h
r
h
r
h
h
h
r
h
h
h
h
h
r
"}
(25,1,1) = {"
I
I
I
I
I
I
I
I
I
I
I
I
I
I
I
I
I
I
I
I
r
h
h
h
n
h
h
h
h
h
h
n
h
n
h
n
h
h
h
h
n
n
n
h
n
h
n
h
n
h
n
h
n
h
n
h
n
h
n
h
h
h
h
h
h
n
n
n
n
n
h
n
h
n
h
n
r
r
r
r
h
r
h
r
h
h
h
h
h
h
r
h
r
h
h
h
h
h
h
h
h
h
h
r
h
r
h
r
h
r
h
r
h
r
r
r
r
r
r
r
"}
(26,1,1) = {"
I
I
I
I
I
I
I
I
I
I
I
I
I
I
I
I
I
I
I
I
r
h
n
n
n
h
n
n
n
n
n
n
h
n
h
n
h
n
h
h
h
h
h
h
n
h
n
h
n
h
n
h
n
h
n
h
n
h
n
n
n
n
n
n
h
n
h
h
h
n
h
n
h
n
h
n
h
h
h
r
h
r
h
r
h
r
r
r
r
r
r
h
r
h
r
h
r
r
r
r
r
r
h
r
h
r
h
r
h
r
h
r
h
r
h
h
h
h
h
r
"}
(27,1,1) = {"
I
I
I
I
I
I
I
I
I
I
I
I
I
I
I
I
I
I
I
I
r
h
h
h
h
h
n
h
h
h
h
h
h
n
h
n
h
n
h
n
n
n
n
h
n
h
n
h
n
h
n
h
n
h
n
h
n
h
h
h
h
h
h
n
h
n
h
n
h
n
h
n
h
n
h
n
h
r
r
r
h
r
h
r
h
r
h
h
h
h
h
h
r
h
r
h
r
h
h
h
h
h
h
r
h
r
h
r
h
r
h
r
h
r
r
r
r
r
h
r
"}
(28,1,1) = {"
I
I
I
I
I
I
I
I
I
I
I
I
I
I
I
I
I
I
I
I
r
n
n
h
n
n
n
h
n
n
n
n
h
n
h
n
h
n
h
h
h
h
h
h
n
h
n
h
n
h
n
h
n
h
n
h
n
n
n
n
n
n
h
n
h
n
h
n
h
n
h
n
n
n
h
n
h
h
h
r
h
r
h
r
h
r
h
r
r
r
r
r
r
h
r
h
r
h
r
r
r
r
h
r
h
h
h
r
h
h
h
r
h
h
h
h
h
h
h
r
"}
(29,1,1) = {"
I
I
I
I
I
I
I
I
I
I
I
I
I
I
I
I
I
I
I
I
r
h
h
h
h
h
h
h
n
h
h
n
h
n
h
n
n
n
n
n
n
n
n
n
n
h
n
h
n
h
n
h
n
h
n
h
h
h
h
h
h
n
h
n
h
n
h
n
h
h
h
h
h
h
h
n
r
r
h
h
h
h
h
r
h
r
h
r
h
h
h
h
r
h
r
h
r
h
r
h
h
r
h
r
r
r
r
r
r
r
r
r
r
r
r
r
r
r
n
r
"}
(30,1,1) = {"
I
I
I
I
I
I
I
I
I
I
I
I
I
I
I
I
I
I
I
I
r
h
n
n
n
n
n
n
n
h
n
n
h
n
h
h
h
h
h
h
h
h
h
h
h
h
n
h
n
h
n
h
n
h
n
n
n
n
n
n
h
n
h
n
h
n
h
n
n
n
n
n
n
n
n
n
h
r
r
r
r
r
h
r
h
r
h
r
r
r
r
h
r
h
r
h
r
h
r
h
r
r
h
r
h
r
h
h
h
h
h
h
h
h
h
h
h
h
h
r
"}
(31,1,1) = {"
I
I
I
I
I
I
I
I
I
I
I
I
I
I
I
I
I
I
I
I
r
h
n
h
n
h
h
h
h
h
n
h
h
n
n
n
n
n
n
n
n
n
n
n
n
n
n
h
h
h
n
h
n
h
h
h
h
h
h
h
h
n
h
n
h
h
h
h
h
h
h
n
h
n
h
h
h
r
h
h
h
h
h
h
h
r
h
r
h
h
h
h
h
h
r
h
h
h
h
h
h
h
h
r
h
r
h
r
r
r
h
r
r
r
r
r
h
r
h
r
"}
(32,1,1) = {"
I
I
I
I
I
I
I
I
I
I
I
I
I
I
I
I
I
I
I
I
r
h
n
h
n
h
n
n
n
n
n
h
n
n
h
n
h
n
h
h
h
h
h
h
h
h
n
n
n
n
n
h
n
h
n
n
n
n
n
n
n
n
n
n
n
n
n
n
n
n
n
n
h
n
h
r
r
r
r
r
r
r
r
r
h
r
h
r
r
r
r
r
r
r
r
r
r
r
r
r
r
r
r
r
h
r
h
r
h
r
h
r
h
r
h
r
h
r
h
r
"}
(33,1,1) = {"
I
I
I
I
I
I
I
I
I
I
I
I
I
I
I
I
I
I
I
I
r
h
n
h
n
h
n
h
h
h
h
h
n
h
h
n
h
n
h
n
n
n
n
n
n
h
h
h
h
h
h
h
h
h
h
h
h
h
h
h
h
h
h
h
h
h
h
h
h
h
h
h
h
n
h
r
h
h
h
h
h
h
h
h
h
r
h
h
h
h
h
h
h
h
h
h
h
h
h
h
h
h
h
r
h
r
h
r
h
r
h
r
h
r
h
r
h
r
h
r
"}
(34,1,1) = {"
I
I
I
I
I
I
I
I
I
I
I
I
I
I
I
I
I
I
I
I
r
h
n
h
n
h
n
h
n
n
h
n
n
h
n
n
h
n
h
n
h
h
h
h
n
h
n
n
n
n
h
n
n
n
n
n
n
n
n
n
n
n
n
n
n
n
n
n
n
n
n
n
n
n
h
r
h
r
r
r
r
r
r
r
r
r
h
n
n
n
n
n
n
n
n
n
n
h
n
n
n
n
n
r
h
r
h
r
h
r
h
r
h
r
h
r
h
r
h
r
"}
(35,1,1) = {"
I
I
I
I
I
I
I
I
I
I
I
I
I
I
I
I
I
I
I
I
r
h
h
h
n
h
n
h
n
h
h
h
h
h
h
h
h
n
h
n
h
n
n
h
n
h
n
h
h
h
h
h
h
h
h
r
h
h
n
h
h
h
n
h
h
h
h
h
h
n
h
h
h
r
h
h
h
r
h
h
h
h
h
h
h
h
h
n
h
h
h
h
h
h
h
h
h
h
h
h
h
h
h
r
h
r
h
r
h
r
h
r
h
r
h
r
h
r
h
r
"}
(36,1,1) = {"
I
I
I
I
I
I
I
I
I
I
I
I
I
I
I
I
I
I
I
I
r
h
n
n
n
h
n
h
n
h
n
n
n
n
n
n
n
n
h
n
h
n
h
h
n
h
n
n
n
n
n
n
h
n
h
r
n
h
n
h
n
h
n
h
n
n
n
n
h
n
h
n
h
r
r
r
r
r
h
n
n
n
n
n
n
r
h
n
n
n
n
n
h
n
n
n
n
n
n
n
n
n
h
r
h
r
h
r
h
r
h
r
h
r
h
h
h
r
h
r
"}
(37,1,1) = {"
I
I
I
I
I
I
I
I
I
I
I
I
I
I
I
I
I
I
I
I
r
h
h
h
h
h
n
h
n
h
h
h
h
h
h
n
h
n
h
n
h
n
h
n
n
h
n
h
h
h
h
h
h
n
h
r
h
h
h
h
n
h
h
h
h
h
h
h
h
h
h
n
h
h
h
h
h
h
h
h
h
h
h
h
h
r
h
n
h
h
h
h
h
h
h
h
h
h
h
h
h
h
h
r
h
r
h
r
h
r
h
r
h
r
r
r
r
r
h
r
"}
(38,1,1) = {"
I
I
I
I
I
I
I
I
I
I
I
I
I
I
I
I
I
I
I
I
r
h
n
n
n
n
n
h
n
n
n
n
n
n
n
n
h
n
h
n
h
n
h
h
n
h
n
h
n
n
n
n
n
n
h
r
r
r
r
h
r
r
r
r
r
r
r
r
r
r
r
r
r
r
r
r
r
r
r
r
r
r
r
r
r
r
h
n
n
n
n
n
n
n
n
n
h
n
n
n
n
n
n
r
h
r
h
r
h
r
h
r
h
r
h
h
h
h
h
r
"}
(39,1,1) = {"
I
I
I
I
I
I
I
I
I
I
I
I
I
I
I
I
I
I
I
I
r
h
n
h
h
h
n
h
h
h
h
h
h
n
h
h
h
n
h
n
h
n
h
n
n
h
n
h
h
h
h
h
h
n
h
r
h
h
h
h
h
h
h
h
n
h
n
h
h
h
h
h
h
h
h
h
n
h
n
h
n
h
h
h
h
r
h
n
h
h
h
h
h
h
h
h
h
h
h
h
h
h
h
r
h
r
h
r
h
r
h
r
h
r
h
r
r
r
h
r
"}
(40,1,1) = {"
I
I
I
I
I
I
I
I
I
I
I
I
I
I
I
I
I
I
I
I
r
h
n
h
n
h
n
n
n
n
n
n
n
n
h
n
h
n
h
n
h
h
h
h
h
h
n
h
h
n
n
n
n
n
h
r
h
n
n
n
h
n
n
h
h
h
n
h
n
n
n
h
n
h
n
h
h
h
n
h
n
h
n
n
h
r
h
n
h
n
n
n
n
n
n
n
n
n
n
h
n
n
n
r
h
r
h
r
h
r
h
r
h
r
h
r
h
h
h
r
"}
(41,1,1) = {"
I
I
I
I
I
I
I
I
I
I
I
I
I
I
I
I
I
I
I
I
r
h
n
h
n
h
h
h
h
h
h
h
h
h
h
n
h
h
h
n
h
n
h
h
n
h
n
n
h
h
h
h
h
n
h
r
h
n
h
h
h
n
h
h
n
h
n
h
n
h
n
h
n
h
n
n
n
h
n
h
n
h
n
h
h
r
h
n
h
h
h
h
h
h
h
h
h
h
h
h
h
h
h
r
h
r
h
r
h
r
h
r
h
r
h
r
h
r
r
r
"}
(42,1,1) = {"
I
I
I
I
I
I
I
I
I
I
I
I
I
I
I
I
I
I
I
I
r
h
n
h
n
n
n
n
n
n
n
n
h
n
h
n
n
n
n
n
n
n
n
h
n
h
h
n
h
n
h
n
h
n
h
r
h
n
h
n
h
n
h
n
n
h
h
h
n
h
h
h
n
h
h
h
h
h
n
h
h
h
n
h
n
r
h
n
n
n
n
n
n
n
n
h
n
n
n
n
n
h
h
r
h
r
h
r
h
h
h
r
h
h
h
r
h
h
h
r
"}
(43,1,1) = {"
I
I
I
I
I
I
I
I
I
I
I
I
I
I
I
I
I
I
I
I
r
h
n
h
h
h
h
h
h
h
h
h
h
n
h
h
h
h
h
h
h
h
n
h
n
n
h
n
h
n
h
n
h
n
h
r
h
n
h
n
h
n
h
h
n
n
h
n
r
r
r
r
r
r
r
n
h
n
n
h
n
h
n
h
h
r
h
h
h
h
h
h
h
h
h
h
h
h
h
h
h
h
h
r
h
r
r
r
h
r
r
r
r
r
r
r
r
r
h
r
"}
(44,1,1) = {"
I
I
I
I
I
I
I
I
I
I
I
I
I
I
I
I
I
I
I
I
r
h
n
h
n
n
n
n
n
n
n
n
n
n
n
n
n
n
n
n
n
h
n
n
n
h
h
n
h
n
h
n
h
n
h
r
h
n
h
n
h
n
n
n
n
h
h
r
r
h
h
h
h
h
r
r
h
h
h
h
n
n
n
n
h
r
h
n
n
n
n
n
n
n
n
n
n
n
n
n
n
n
n
r
h
h
h
h
h
h
h
h
h
h
h
h
h
h
h
r
"}
(45,1,1) = {"
I
I
I
I
I
I
I
I
I
I
I
I
I
I
I
I
I
I
I
I
r
h
n
h
h
h
h
h
h
h
h
h
h
h
h
h
h
h
h
h
n
h
h
h
h
h
h
n
h
n
h
n
h
n
h
r
h
n
h
n
h
h
h
h
n
h
r
r
h
h
h
h
h
h
h
r
r
n
n
n
n
h
h
h
h
r
h
n
h
h
h
h
h
h
h
h
h
h
h
h
h
h
h
r
h
r
r
r
r
r
r
r
r
r
r
r
r
r
r
r
"}
(46,1,1) = {"
I
I
I
I
I
I
I
I
I
I
I
I
I
I
I
I
I
I
I
I
r
h
r
n
n
n
n
n
n
n
n
h
n
n
n
n
n
n
n
n
n
n
n
n
n
n
h
n
n
n
h
n
n
n
h
r
h
n
h
n
n
n
n
n
n
h
r
h
h
h
h
h
h
h
h
h
r
h
h
n
h
h
n
n
n
r
n
n
n
n
n
n
h
n
n
n
n
n
n
n
n
n
n
r
h
n
h
h
h
n
h
h
n
h
h
h
h
h
h
r
"}
(47,1,1) = {"
I
I
I
I
I
I
I
I
I
I
I
I
I
I
I
I
I
I
I
I
r
h
n
h
h
h
h
h
h
h
h
h
h
h
h
h
h
h
h
h
h
h
h
h
h
h
n
n
h
h
h
h
h
n
h
r
h
n
h
h
h
h
h
h
h
r
r
h
M
h
f
h
E
h
M
h
r
r
h
n
n
h
h
h
h
r
h
n
h
n
h
n
h
h
h
h
h
h
h
h
h
h
h
r
h
n
h
n
h
h
h
h
n
h
n
n
n
n
h
r
"}
(48,1,1) = {"
I
I
I
I
I
I
I
I
I
I
I
I
I
I
I
I
I
I
I
I
r
h
r
r
r
r
r
r
r
r
r
r
r
r
r
r
r
r
r
r
r
r
r
r
r
r
r
r
r
r
r
r
r
r
r
r
r
r
r
r
r
r
r
r
r
r
h
h
h
h
h
h
h
h
h
h
h
r
h
n
n
n
h
n
h
r
h
n
h
n
h
n
n
n
h
n
n
n
n
n
h
n
h
r
h
n
h
n
n
n
n
h
n
h
n
h
h
h
h
r
"}
(49,1,1) = {"
I
I
I
I
I
I
I
I
I
I
I
I
I
I
I
I
I
I
I
I
r
h
N
S
U
e
h
h
h
h
h
h
h
h
h
h
h
h
h
h
h
h
h
h
h
h
h
h
h
h
h
h
h
h
h
h
h
h
h
h
h
h
h
h
h
h
h
h
h
s
h
m
h
z
h
h
h
r
h
n
h
n
h
n
h
n
h
n
h
n
h
n
h
n
h
h
h
n
h
h
h
n
h
r
h
n
h
h
h
h
n
h
n
h
n
h
n
n
n
r
"}
(50,1,1) = {"
I
I
I
I
I
I
I
I
I
I
I
I
I
I
I
I
I
I
I
I
r
h
n
r
r
r
r
r
r
r
r
r
r
r
r
r
r
r
r
r
r
r
r
r
r
r
r
r
r
r
r
r
r
r
r
r
r
r
r
r
r
r
r
r
r
r
h
h
h
h
h
h
h
h
h
M
h
r
h
h
h
h
h
n
h
r
h
n
h
n
h
n
h
n
n
n
h
n
h
n
n
n
h
r
h
n
n
n
n
h
n
h
n
h
n
h
h
h
h
r
"}
(51,1,1) = {"
I
I
I
I
I
I
I
I
I
I
I
I
I
I
I
I
I
I
I
I
r
h
n
h
h
h
h
h
h
h
h
h
h
h
h
n
h
n
h
h
h
h
h
n
h
n
h
h
h
h
h
h
h
h
h
r
h
h
h
h
h
h
h
h
h
r
r
h
M
h
L
h
V
h
h
h
r
r
n
n
n
n
n
n
h
r
h
n
h
n
h
n
h
n
h
n
h
n
h
n
h
h
h
n
h
n
h
h
h
h
h
h
n
h
n
h
n
n
h
r
"}
(52,1,1) = {"
I
I
I
I
I
I
I
I
I
I
I
I
I
I
I
I
I
I
I
I
r
h
n
h
n
h
n
h
n
n
n
n
h
n
h
h
h
n
h
n
n
n
h
n
h
n
h
h
n
n
n
n
n
n
h
r
h
n
n
n
n
n
n
n
h
h
r
h
h
h
h
h
h
h
h
h
r
h
h
h
h
h
h
n
h
r
h
n
h
n
h
n
h
n
h
n
h
n
h
n
n
n
h
n
h
n
h
n
h
n
n
n
n
h
n
h
h
h
h
r
"}
(53,1,1) = {"
I
I
I
I
I
I
I
I
I
I
I
I
I
I
I
I
I
I
I
I
r
h
n
h
n
h
n
h
h
h
h
n
h
n
n
n
h
n
h
n
h
n
h
n
h
n
n
h
h
h
n
h
h
h
h
r
h
n
h
h
h
h
h
n
h
n
r
r
h
h
h
h
h
h
h
r
r
n
n
n
n
n
h
h
h
r
h
n
h
n
h
n
h
n
h
n
h
n
h
n
h
n
h
n
h
h
h
n
h
h
h
h
h
h
n
n
n
n
n
r
"}
(54,1,1) = {"
I
I
I
I
I
I
I
I
I
I
I
I
I
I
I
I
I
I
I
I
r
h
n
h
n
h
n
h
n
n
h
n
h
n
h
h
h
n
h
n
h
n
h
n
h
h
h
h
n
h
n
h
n
h
h
h
h
n
h
n
n
n
n
n
h
h
h
r
r
h
h
h
h
h
r
r
h
h
h
h
h
n
n
n
h
r
h
n
h
n
h
n
h
n
h
n
h
n
h
n
h
n
h
n
h
n
h
n
h
n
n
n
n
h
n
h
h
h
h
r
"}
(55,1,1) = {"
I
I
I
I
I
I
I
I
I
I
I
I
I
I
I
I
I
I
I
I
r
h
n
h
n
h
n
h
h
n
h
n
n
n
n
h
n
n
h
n
h
n
h
n
n
n
n
h
n
h
n
n
n
n
h
r
h
n
h
n
h
h
h
h
h
n
n
n
r
r
r
h
r
r
r
n
h
n
n
n
h
n
h
h
h
r
h
n
h
n
h
n
h
n
h
n
h
h
h
n
h
n
h
n
h
n
h
h
h
h
h
h
n
h
n
h
n
n
h
r
"}
(56,1,1) = {"
I
I
I
I
I
I
I
I
I
I
I
I
I
I
I
I
I
I
I
I
r
h
n
h
n
h
n
n
h
n
n
n
h
h
h
h
h
h
h
n
h
h
h
h
h
h
h
h
n
h
h
n
h
h
h
r
h
n
h
n
h
n
n
n
h
h
h
h
h
h
r
h
r
h
n
h
h
n
h
n
h
n
h
n
n
r
h
n
h
n
h
n
h
n
h
n
h
n
h
n
h
n
h
n
h
n
n
n
n
h
n
h
n
h
n
h
h
h
h
r
"}
(57,1,1) = {"
I
I
I
I
I
I
I
I
I
I
I
I
I
I
I
I
I
I
I
I
r
h
n
h
n
h
n
h
h
n
h
n
n
n
h
n
h
n
h
n
n
n
n
n
h
n
n
n
n
n
h
n
n
n
h
r
h
n
h
n
h
n
h
n
h
n
n
n
n
h
r
h
r
h
n
h
h
n
h
h
h
n
h
h
h
r
h
n
h
n
h
h
h
h
h
h
h
n
h
n
h
n
h
n
h
n
h
h
h
h
n
h
n
h
n
h
n
n
n
r
"}
(58,1,1) = {"
I
I
I
I
I
I
I
I
I
I
I
I
I
I
I
I
I
I
I
I
r
h
n
h
n
h
n
h
n
n
h
n
h
n
h
n
h
n
h
h
h
h
h
n
h
n
h
h
h
n
h
n
h
h
h
r
h
n
h
n
h
n
h
n
h
h
h
h
n
h
r
h
r
h
n
h
n
n
n
n
n
n
n
n
h
r
h
n
h
n
n
n
n
n
n
n
h
n
h
n
h
h
h
n
h
n
h
n
n
n
n
h
n
h
n
h
h
h
h
r
"}
(59,1,1) = {"
I
I
I
I
I
I
I
I
I
I
I
I
I
I
I
I
I
I
I
I
r
h
n
h
n
h
n
h
n
h
h
n
h
n
h
n
h
n
n
n
n
n
h
n
h
n
h
n
h
n
h
n
h
n
n
r
h
h
h
h
h
h
h
n
h
h
n
h
n
h
r
h
r
h
h
h
h
h
h
h
h
h
h
h
h
r
h
n
h
n
h
n
h
h
h
n
h
n
h
n
n
n
h
n
h
n
h
n
h
h
h
h
n
h
n
n
n
n
h
r
"}
(60,1,1) = {"
I
I
I
I
I
I
I
I
I
I
I
I
I
I
I
I
I
I
I
I
r
h
n
h
n
h
n
h
n
h
n
n
h
n
h
h
h
n
h
h
h
h
h
n
h
n
h
n
h
n
h
n
h
h
h
r
r
r
r
r
r
r
r
r
r
r
r
r
r
r
r
h
r
r
r
r
h
r
r
r
r
r
r
r
r
r
h
h
h
h
h
h
h
n
h
h
h
n
h
h
h
h
h
h
h
n
h
h
h
n
h
h
n
h
h
h
h
h
h
r
"}
(61,1,1) = {"
I
I
I
I
I
I
I
I
I
I
I
I
I
I
I
I
I
I
I
I
r
h
n
h
n
h
n
h
n
h
n
h
h
n
h
n
h
n
n
n
n
n
n
n
h
n
h
n
h
n
h
n
n
n
h
r
h
h
h
h
h
n
h
h
n
h
h
h
h
h
h
h
r
h
h
h
h
h
h
h
h
h
h
h
h
r
r
r
r
r
r
r
r
r
r
r
n
n
h
r
r
r
r
r
r
r
r
r
r
r
r
r
r
r
r
r
r
r
r
r
"}
(62,1,1) = {"
I
I
I
I
I
I
I
I
I
I
I
I
I
I
I
I
I
I
I
I
r
h
n
h
h
h
h
h
h
h
h
h
h
h
h
n
h
h
h
h
h
h
h
n
h
h
h
n
h
h
h
h
h
h
h
r
h
n
n
n
n
n
n
h
n
h
n
n
n
h
r
r
r
h
n
n
n
n
n
n
n
n
n
n
h
r
h
h
h
h
h
h
h
h
h
h
h
h
h
h
h
h
r
h
h
h
h
h
h
h
h
h
h
h
h
h
h
h
h
r
"}
(63,1,1) = {"
I
I
I
I
I
I
I
I
I
I
I
I
I
I
I
I
I
I
I
I
r
n
n
r
r
r
r
r
r
r
r
r
r
r
r
r
r
r
r
r
r
r
r
r
r
r
r
r
r
r
r
r
r
r
r
r
h
n
h
h
h
h
n
h
n
h
n
h
h
h
r
h
r
h
n
h
h
h
h
h
h
h
h
n
h
r
h
n
n
n
n
n
n
n
h
n
n
n
n
n
n
h
r
h
n
n
n
n
n
n
n
h
n
n
n
h
n
h
n
r
"}
(64,1,1) = {"
I
I
I
I
I
I
I
I
I
I
I
I
I
I
I
I
I
I
I
I
r
h
h
h
h
h
n
h
h
h
h
h
h
h
h
n
h
h
h
h
h
h
h
h
h
h
h
h
h
n
h
h
h
h
h
n
h
n
n
n
n
h
n
h
n
h
n
h
n
n
r
h
r
h
n
h
n
n
n
n
n
n
h
n
h
r
h
h
h
h
h
h
h
n
h
n
h
h
h
h
h
h
r
h
h
h
h
h
h
h
n
h
n
h
n
h
n
h
n
r
"}
(65,1,1) = {"
I
I
I
I
I
I
I
I
I
I
I
I
I
I
I
I
I
I
I
I
r
h
n
n
n
h
h
h
n
h
n
h
n
n
h
n
n
n
n
n
h
n
n
n
n
n
h
n
n
n
h
n
h
n
h
n
h
h
h
h
h
h
n
h
n
h
n
h
h
h
r
h
r
h
n
h
n
h
h
h
h
n
h
n
h
r
n
n
n
n
n
n
h
n
h
n
h
n
n
n
n
h
r
n
n
n
n
n
n
h
n
h
n
h
n
h
n
h
n
r
"}
(66,1,1) = {"
I
I
I
I
I
I
I
I
I
I
I
I
I
I
I
I
I
I
I
I
r
h
n
h
n
h
n
n
n
h
n
h
n
h
h
n
h
h
h
h
h
h
h
h
h
n
h
n
h
n
h
n
h
n
h
n
h
n
n
n
n
n
n
h
n
h
n
n
n
h
r
h
r
h
n
h
n
h
n
n
h
n
h
n
h
r
h
h
h
h
h
n
h
n
h
n
n
n
h
h
n
h
r
h
h
h
h
h
n
h
n
h
n
h
n
h
n
h
n
r
"}
(67,1,1) = {"
I
I
I
I
I
I
I
I
I
I
I
I
I
I
I
I
I
I
I
I
r
h
n
h
n
h
n
h
n
h
n
h
n
h
n
n
h
n
n
n
n
n
n
n
h
n
h
n
h
n
h
n
h
n
h
n
h
h
h
h
h
h
h
h
n
h
h
h
h
h
r
h
r
h
n
h
n
h
h
n
h
n
h
n
h
r
n
n
n
n
h
n
h
n
h
h
h
h
h
n
n
h
r
h
n
h
n
h
n
h
n
h
n
h
n
h
n
h
n
r
"}
(68,1,1) = {"
I
I
I
I
I
I
I
I
I
I
I
I
I
I
I
I
I
I
I
I
r
h
h
h
n
h
n
h
h
h
n
h
n
h
h
n
h
n
h
h
h
h
h
n
h
n
h
h
h
n
h
n
n
n
h
n
n
n
n
h
n
n
n
n
n
n
n
h
n
n
r
h
r
h
n
h
n
n
h
n
h
n
h
n
h
r
h
h
h
h
h
n
h
n
h
n
h
n
n
n
h
h
r
h
n
h
n
h
n
h
n
h
n
h
n
n
n
h
n
r
"}
(69,1,1) = {"
I
I
I
I
I
I
I
I
I
I
I
I
I
I
I
I
I
I
I
I
r
h
n
h
n
h
n
n
n
n
n
h
n
n
h
n
h
n
h
n
n
n
h
n
h
n
n
h
n
n
h
h
h
h
h
n
h
h
h
h
h
h
h
h
h
h
h
h
h
h
r
h
r
h
n
h
n
h
h
n
h
n
h
n
h
r
n
n
h
n
h
n
h
n
h
n
h
h
h
h
h
n
r
h
n
h
n
h
n
h
n
h
n
h
n
h
n
h
n
r
"}
(70,1,1) = {"
I
I
I
I
I
I
I
I
I
I
I
I
I
I
I
I
I
I
I
I
r
h
n
h
h
h
h
h
h
n
h
h
n
h
h
n
h
n
h
n
h
h
h
n
h
h
n
h
h
n
n
n
n
n
h
n
n
n
n
n
n
n
n
n
h
n
n
n
n
n
r
h
r
h
n
h
n
h
n
n
h
n
h
n
h
r
h
n
h
n
h
n
h
n
h
n
n
n
n
n
h
h
r
h
n
h
n
h
n
h
n
h
n
h
n
h
n
h
n
r
"}
(71,1,1) = {"
I
I
I
I
I
I
I
I
I
I
I
I
I
I
I
I
I
I
I
I
r
h
n
n
n
n
n
n
h
n
h
n
n
n
n
n
h
n
h
n
h
n
n
n
n
h
n
h
h
n
h
h
h
n
h
n
h
h
h
h
h
h
h
n
h
h
h
h
h
h
r
h
r
h
n
h
n
h
h
n
h
n
h
n
h
r
h
n
h
n
h
n
h
h
h
n
h
h
h
n
n
h
r
h
n
h
n
h
n
h
n
h
n
h
n
h
n
h
n
r
"}
(72,1,1) = {"
I
I
I
I
I
I
I
I
I
I
I
I
I
I
I
I
I
I
I
I
r
h
n
h
h
h
h
h
h
n
h
h
h
h
h
n
h
h
h
h
h
h
h
h
h
h
n
h
h
n
h
n
h
n
h
n
h
n
n
n
n
n
n
n
n
n
n
n
n
h
r
h
r
h
n
h
n
n
h
n
h
n
h
n
h
r
h
n
h
n
h
n
h
n
h
n
n
n
h
h
h
h
r
h
n
h
n
h
n
h
n
h
n
h
n
h
n
h
n
r
"}
(73,1,1) = {"
I
I
I
I
I
I
I
I
I
I
I
I
I
I
I
I
I
I
I
I
r
h
n
n
n
n
n
n
n
n
n
n
n
n
h
n
h
n
n
n
n
n
n
n
n
n
n
n
h
h
h
n
h
n
h
n
h
h
h
h
h
h
h
h
h
h
h
h
h
h
h
h
r
h
n
h
n
h
h
n
h
n
h
n
h
r
h
n
h
n
h
h
h
n
h
n
h
n
n
n
n
h
r
h
n
n
n
h
n
h
n
h
n
h
n
h
n
n
n
r
"}
(74,1,1) = {"
I
I
I
I
I
I
I
I
I
I
I
I
I
I
I
I
I
I
I
I
r
h
h
h
h
h
h
h
h
h
h
h
h
n
h
n
h
n
h
h
h
h
h
h
h
h
h
n
h
n
h
n
h
h
h
n
n
n
n
n
n
n
h
n
n
n
n
n
n
n
r
h
r
h
n
h
n
n
n
n
h
n
h
n
h
r
h
n
h
n
h
n
h
n
h
n
h
h
h
h
h
h
r
h
h
h
h
h
h
h
n
h
h
h
h
h
h
h
h
r
"}
(75,1,1) = {"
I
I
I
I
I
I
I
I
I
I
I
I
I
I
I
I
I
I
I
I
r
h
n
n
n
n
n
n
n
n
n
n
h
n
h
n
h
n
h
n
n
n
n
n
n
n
h
n
h
n
h
n
n
n
n
n
h
h
h
h
h
h
h
n
h
h
h
h
h
h
r
h
r
h
n
h
h
h
h
h
h
n
h
n
h
r
h
n
h
h
h
n
h
n
h
n
n
n
h
n
n
n
n
n
n
n
n
n
n
n
n
n
n
n
h
n
n
n
n
r
"}
(76,1,1) = {"
I
I
I
I
I
I
I
I
I
I
I
I
I
I
I
I
I
I
I
I
r
h
n
h
h
h
h
h
h
h
h
h
h
n
h
n
h
n
h
n
h
h
h
h
h
h
h
n
h
n
h
h
h
h
h
n
h
n
n
n
n
n
n
n
n
n
n
n
n
h
r
h
r
h
n
n
n
n
n
n
n
n
h
n
h
r
h
n
n
n
n
n
h
n
h
n
h
h
h
h
h
h
r
h
h
h
h
h
h
n
h
h
h
n
h
n
h
h
h
r
"}
(77,1,1) = {"
I
I
I
I
I
I
I
I
I
I
I
I
I
I
I
I
I
I
I
I
r
h
n
h
n
h
n
n
n
n
n
n
h
n
h
n
h
n
h
n
h
n
n
n
n
n
h
n
h
n
h
n
h
n
n
n
h
h
h
h
h
h
h
h
h
h
h
h
h
h
r
h
h
h
h
h
h
h
h
h
h
h
h
n
h
r
h
h
h
h
h
h
h
n
h
n
n
n
n
n
n
h
r
h
n
h
n
h
h
h
h
n
h
n
h
n
h
n
h
r
"}
(78,1,1) = {"
I
I
I
I
I
I
I
I
I
I
I
I
I
I
I
I
I
I
I
I
r
h
n
h
n
h
h
n
h
h
h
n
h
n
h
n
h
n
h
n
n
n
h
h
h
n
h
n
h
n
h
n
h
n
h
n
n
n
n
n
n
n
n
n
n
n
n
n
n
n
r
n
r
n
n
n
n
n
n
n
n
n
n
n
h
r
h
n
n
n
n
n
n
n
h
n
h
h
h
h
n
h
r
h
n
h
n
h
n
n
n
n
n
n
h
n
h
n
h
r
"}
(79,1,1) = {"
I
I
I
I
I
I
I
I
I
I
I
I
I
I
I
I
I
I
I
I
r
h
n
h
n
n
h
n
h
n
h
n
n
n
h
n
h
n
h
n
h
n
n
n
h
n
h
n
h
n
h
n
n
n
h
n
h
h
h
h
h
h
h
h
h
h
h
h
h
h
h
h
h
h
h
h
h
h
h
h
h
h
h
h
h
r
h
h
h
h
h
h
h
h
h
n
n
n
n
h
n
h
r
h
n
h
n
h
h
h
h
h
h
n
h
n
h
n
h
r
"}
(80,1,1) = {"
I
I
I
I
I
I
I
I
I
I
I
I
I
I
I
I
I
I
I
I
r
h
h
h
h
n
h
h
h
n
h
h
h
n
h
n
h
h
h
n
h
h
h
h
h
h
h
n
h
n
h
h
h
h
h
n
h
n
n
n
n
n
n
n
n
n
n
n
n
n
n
n
n
n
n
n
n
n
n
n
n
n
n
n
n
r
h
n
n
n
n
n
n
n
n
n
h
h
h
h
n
h
r
n
n
n
n
n
n
n
n
h
n
n
h
n
n
n
h
r
"}
(81,1,1) = {"
I
I
I
I
I
I
I
I
I
I
I
I
I
I
I
I
I
I
I
I
r
h
n
n
n
n
n
n
n
n
n
n
n
n
h
n
n
n
n
n
n
n
n
n
n
n
n
n
h
n
n
n
n
n
n
n
h
h
h
h
h
h
h
h
h
h
h
h
h
h
h
h
h
h
n
h
h
h
h
h
h
h
h
h
h
r
h
h
h
h
h
h
h
h
h
h
h
n
h
h
h
h
h
h
h
h
h
h
h
h
h
h
h
h
h
h
h
h
h
r
"}
(82,1,1) = {"
I
I
I
I
I
I
I
I
I
I
I
I
I
I
I
I
I
I
I
I
r
h
h
h
h
h
h
h
h
h
h
h
h
h
h
h
h
h
h
h
h
h
h
h
h
h
h
h
h
h
h
h
h
h
h
n
h
h
h
n
n
n
n
n
n
n
n
n
n
h
n
n
n
h
n
h
n
n
n
n
n
n
h
n
h
r
r
r
r
r
r
r
r
r
r
r
r
n
r
r
r
r
h
r
r
r
r
r
r
r
r
r
r
r
r
r
r
r
r
r
"}
(83,1,1) = {"
I
I
I
I
I
I
I
I
I
I
I
I
I
I
I
I
I
I
I
I
r
h
n
n
n
n
n
n
n
n
n
n
n
n
n
n
n
n
n
n
n
n
n
n
n
n
n
n
n
n
n
n
n
n
n
n
n
n
h
h
h
h
h
h
h
h
h
h
n
h
n
h
n
h
n
h
n
h
h
h
h
n
h
n
h
r
h
h
h
h
h
h
h
h
h
h
h
h
h
h
n
h
h
h
h
h
h
h
h
h
h
h
h
h
h
h
h
h
h
r
"}
(84,1,1) = {"
I
I
I
I
I
I
I
I
I
I
I
I
I
I
I
I
I
I
I
I
r
h
n
h
h
h
h
h
h
h
n
h
h
h
h
h
h
h
h
n
h
n
h
n
h
h
h
h
h
n
h
h
h
h
h
n
h
n
n
h
n
n
n
n
n
n
n
h
n
h
n
h
n
h
n
h
n
h
n
n
h
n
h
n
h
r
h
n
n
n
n
n
n
n
n
n
n
h
n
h
n
h
r
h
n
n
n
h
n
n
n
n
n
h
n
n
n
h
n
r
"}
(85,1,1) = {"
I
I
I
I
I
I
I
I
I
I
I
I
I
I
I
I
I
I
I
I
r
h
n
h
n
h
n
h
n
n
n
h
n
n
n
h
n
n
h
h
h
h
h
n
h
n
n
n
n
n
n
n
h
n
h
n
h
n
h
h
h
h
h
h
h
h
n
h
n
h
n
h
n
h
n
h
n
h
n
h
h
n
h
n
h
r
h
n
h
h
h
h
h
h
h
h
h
h
n
h
n
h
r
h
n
h
n
h
n
h
h
h
n
h
n
h
n
h
h
r
"}
(86,1,1) = {"
I
I
I
I
I
I
I
I
I
I
I
I
I
I
I
I
I
I
I
I
r
h
n
h
n
h
n
n
n
h
n
h
n
h
h
h
h
n
n
n
h
n
h
n
h
h
h
h
n
h
h
h
h
n
h
n
h
n
n
n
n
n
n
n
n
h
n
h
n
h
n
h
h
h
n
h
n
h
n
n
n
n
h
n
h
r
h
n
h
n
n
n
n
n
n
n
n
h
n
h
n
h
r
h
n
h
n
h
n
h
n
h
n
h
n
h
n
n
h
r
"}
(87,1,1) = {"
I
I
I
I
I
I
I
I
I
I
I
I
I
I
I
I
I
I
I
I
r
h
h
h
n
h
h
h
h
h
n
h
n
n
n
h
n
n
h
h
h
n
h
n
n
h
n
h
n
h
n
n
h
n
h
n
h
n
h
h
h
h
h
h
n
h
n
h
n
h
n
n
n
h
n
h
n
h
h
h
h
h
h
n
h
r
h
n
h
n
h
h
n
h
h
h
n
h
n
h
n
h
r
h
n
h
n
h
n
h
n
h
n
h
n
h
n
h
h
r
"}
(88,1,1) = {"
I
I
I
I
I
I
I
I
I
I
I
I
I
I
I
I
I
I
I
I
r
n
n
n
n
n
h
n
n
n
n
h
h
h
h
h
h
h
h
n
h
n
h
n
h
h
n
h
n
h
n
h
h
n
h
n
h
n
n
n
n
n
n
h
n
h
h
h
n
h
h
h
h
h
n
h
n
n
n
n
n
n
n
n
h
r
h
n
h
n
n
h
h
h
n
h
h
h
n
h
n
h
r
h
n
h
n
h
n
h
n
n
n
h
n
h
n
h
n
r
"}
(89,1,1) = {"
I
I
I
I
I
I
I
I
I
I
I
I
I
I
I
I
I
I
I
I
r
h
h
h
h
h
h
h
h
h
n
h
n
n
n
n
n
n
n
n
h
n
h
n
h
n
n
h
n
h
n
h
n
n
h
n
h
h
h
h
h
h
n
h
n
h
n
h
n
n
n
n
n
h
n
h
h
h
h
h
h
h
h
n
h
r
h
n
h
n
n
n
n
n
n
n
n
n
n
h
h
h
r
h
n
h
h
h
n
h
h
h
h
h
h
h
n
h
h
r
"}
(90,1,1) = {"
I
I
I
I
I
I
I
I
I
I
I
I
I
I
I
I
I
I
I
I
r
h
n
n
n
n
n
n
n
h
n
h
h
h
h
h
h
h
h
h
h
n
h
n
h
h
n
h
h
h
n
h
h
n
h
n
n
n
n
n
n
h
n
h
h
h
n
h
n
h
h
h
h
h
n
n
h
n
n
n
n
n
h
n
h
r
h
n
h
h
h
h
h
h
h
h
h
h
h
h
n
h
r
h
n
n
n
n
n
n
n
n
n
n
n
n
n
n
h
r
"}
(91,1,1) = {"
I
I
I
I
I
I
I
I
I
I
I
I
I
I
I
I
I
I
I
I
r
h
h
h
h
h
h
h
h
h
n
n
h
n
n
n
n
n
n
n
n
n
h
n
n
n
n
n
n
n
n
n
n
n
h
n
h
h
h
h
n
h
n
n
n
n
n
h
n
n
n
n
h
h
h
n
h
n
h
h
h
h
h
n
h
r
h
n
n
n
n
n
n
n
n
n
n
n
n
h
n
h
r
h
h
h
h
h
h
h
h
h
h
h
h
h
h
h
h
r
"}
(92,1,1) = {"
I
I
I
I
I
I
I
I
I
I
I
I
I
I
I
I
I
I
I
I
r
n
n
n
n
n
h
n
n
h
h
h
h
n
h
h
h
h
h
h
h
h
h
h
h
h
h
h
h
h
h
h
h
h
h
n
n
n
h
n
n
h
n
h
h
h
n
h
h
h
h
n
n
n
h
n
h
n
h
n
n
n
n
n
h
r
h
n
h
h
h
h
h
h
h
h
h
h
h
h
n
h
r
n
n
n
n
n
n
n
n
n
n
n
n
n
n
n
h
r
"}
(93,1,1) = {"
I
I
I
I
I
I
I
I
I
I
I
I
I
I
I
I
I
I
I
I
r
h
h
h
h
h
h
h
h
h
n
n
h
n
n
n
n
n
n
n
n
n
h
n
n
n
n
n
n
n
n
n
n
n
h
n
h
h
h
h
n
h
n
n
h
n
n
n
h
n
n
n
h
n
h
n
h
n
h
h
h
h
h
n
h
r
h
n
n
n
n
n
n
n
n
n
n
n
n
n
n
h
r
h
h
h
h
n
h
h
h
n
h
h
h
n
h
h
h
r
"}
(94,1,1) = {"
I
I
I
I
I
I
I
I
I
I
I
I
I
I
I
I
I
I
I
I
r
h
n
n
n
n
n
n
n
h
n
h
h
h
h
h
h
h
h
h
h
n
h
n
h
n
h
h
h
n
h
h
h
n
h
n
h
n
n
n
n
h
n
h
h
h
h
h
h
h
h
n
h
n
h
n
h
n
n
n
n
n
n
n
h
r
h
n
h
h
h
n
h
h
n
h
n
h
h
h
n
h
r
n
h
n
h
n
h
n
h
n
h
n
h
n
h
n
n
r
"}
(95,1,1) = {"
I
I
I
I
I
I
I
I
I
I
I
I
I
I
I
I
I
I
I
I
r
h
h
h
h
h
h
h
h
h
n
h
n
n
n
n
n
n
h
n
h
n
h
n
h
n
h
n
h
n
h
n
h
n
h
n
h
h
h
h
n
h
n
n
n
n
h
n
n
n
n
n
h
n
h
n
h
h
h
h
h
h
h
n
h
r
h
n
h
n
h
n
n
h
n
h
h
h
n
h
n
h
r
h
h
n
h
n
h
n
h
n
h
n
h
n
h
h
h
r
"}
(96,1,1) = {"
I
I
I
I
I
I
I
I
I
I
I
I
I
I
I
I
I
I
I
I
r
n
n
n
n
n
n
h
n
n
n
h
h
n
h
h
h
n
h
n
h
n
h
n
h
n
h
n
h
n
h
n
h
n
h
n
n
n
n
h
n
h
n
h
h
h
h
h
h
h
h
n
h
n
h
n
n
n
n
h
n
n
h
n
h
h
h
n
h
n
h
n
n
h
n
n
n
n
n
h
n
h
r
h
n
n
h
n
h
n
h
n
h
n
h
n
n
n
h
r
"}
(97,1,1) = {"
I
I
I
I
I
I
I
I
I
I
I
I
I
I
I
I
I
I
I
I
r
h
h
h
h
h
h
h
h
h
n
n
h
n
h
n
h
n
h
n
h
n
n
n
h
n
h
n
h
n
h
n
h
n
h
n
h
h
h
h
h
h
n
h
n
n
n
n
n
n
n
n
h
h
h
h
h
h
n
h
n
h
h
n
h
r
h
n
h
n
h
h
h
h
n
h
h
h
n
h
h
h
r
h
h
n
h
n
h
n
h
n
h
n
h
n
h
h
h
r
"}
(98,1,1) = {"
I
I
I
I
I
I
I
I
I
I
I
I
I
I
I
I
I
I
I
I
r
h
n
n
n
n
n
n
n
h
n
h
h
n
h
n
h
n
h
n
h
h
h
h
h
n
h
n
h
n
h
n
h
n
h
n
n
n
n
n
n
h
n
h
n
h
h
h
n
h
n
n
h
n
n
n
n
h
n
n
n
n
n
n
h
r
h
n
h
n
n
n
n
n
n
h
n
n
n
h
n
h
r
n
h
n
h
n
h
n
h
n
h
n
h
n
n
n
h
r
"}
(99,1,1) = {"
I
I
I
I
I
I
I
I
I
I
I
I
I
I
I
I
I
I
I
I
r
h
h
h
h
h
h
h
h
h
n
n
h
h
h
n
h
h
h
n
h
n
n
n
h
h
h
n
h
h
h
n
h
h
h
h
h
h
h
h
h
h
h
h
h
h
n
h
h
h
h
h
h
h
h
h
n
h
h
h
h
h
h
h
h
r
h
n
h
h
h
h
h
h
h
h
h
h
h
h
n
h
r
h
h
n
h
h
h
n
h
h
h
n
h
h
h
h
h
r
"}
(100,1,1) = {"
I
I
I
I
I
I
I
I
I
I
I
I
I
I
I
I
I
I
I
I
r
r
r
r
r
r
r
r
r
r
r
r
r
r
r
r
r
r
r
r
r
r
r
r
r
r
r
n
r
r
r
r
r
r
r
r
r
r
r
r
r
r
r
r
r
r
r
r
r
r
r
r
r
r
r
r
r
r
r
r
r
r
r
r
r
r
r
r
r
r
r
r
r
r
r
r
r
r
r
r
r
r
r
r
r
r
r
r
r
r
r
r
r
r
r
r
r
r
r
r
"}
