"a" = (/turf/simulated/wall/indestructible,/area/space)
"d" = (/turf/simulated/wall,/area/space)
"e" = (/obj/item/paper{text = To exit push the wall and always try to go west.},/turf/simulated/floor/plating/asteroid,/area/ruin/unpowered/no_grav)
"f" = (/obj/structure/table/glass,/obj/item/coin/gold,/turf/simulated/floor/plating/asteroid,/area/ruin/unpowered/no_grav)
"h" = (/turf/simulated/floor/plating/asteroid,/area/ruin/unpowered/no_grav)
"i" = (/obj/structure/window/reinforced{dir = 1},/obj/structure/dispenser{pixel_x = -1},/turf/simulated/floor/plasteel,/area/ruin/powered)
"k" = (/obj/effect/spawner/window/reinforced,/turf/space,/area/space)
"m" = (/obj/item/assembly/signaler/anomaly{name = "SCP-184"; pixel_y = 8},/obj/structure/table/holotable,/turf/simulated/floor/plating/asteroid,/area/ruin/unpowered/no_grav)
"n" = (/turf/simulated/wall,/area/ruin/unpowered/no_grav)
"p" = (/obj/machinery/power/smes/magical{desc = "A high-capacity superconducting magnetic energy storage (SMES) unit."; name = "power storage unit"},/turf/simulated/floor/plating,/area/ruin/powered)
"q" = (/obj/item/paper{text = "I am writing this just in case someone happens to find it. Yeah I know it sounds weird but I've been facing unending walls for the last 3 days and I need some rest. I was sent here by Nanotrasen to check what is inside this mess, but that does not matter anymore. I don't have much oxygen left and I can't identify the way I came here. I'm kind of screwed."},/turf/simulated/floor/plating/asteroid,/area/ruin/unpowered/no_grav)
"r" = (/turf/simulated/wall/indestructible,/area/ruin/unpowered/no_grav)
"s" = (/obj/structure/table/abductor,/obj/item/coin/diamond,/turf/simulated/floor/plating/asteroid,/area/ruin/unpowered/no_grav)
"v" = (/turf/simulated/wall/indestructible,/area/ruin/powered)
"x" = (/obj/machinery/door/airlock/external,/turf/simulated/floor/plasteel,/area/ruin/powered)
"z" = (/obj/structure/table/reinforced/brass,/obj/item/coin/mythril,/turf/simulated/floor/plating/asteroid,/area/ruin/unpowered/no_grav)
"E" = (/obj/structure/table/holotable/wood,/obj/item/coin/mime,/turf/simulated/floor/plating/asteroid,/area/ruin/unpowered/no_grav)
"F" = (/obj/structure/table,/obj/item/flashlight/lantern{pixel_x = -6; pixel_y = 14},/obj/item/flashlight/lantern{pixel_x = 7; pixel_y = 19},/obj/item/flashlight/lantern{pixel_x = 7; pixel_y = 8},/obj/item/flashlight/lantern{pixel_x = -3; pixel_y = 11},/obj/item/flashlight/lantern{pixel_x = -5; pixel_y = 3},/obj/machinery/light{dir = 8},/turf/simulated/floor/plasteel,/area/ruin/powered)
"I" = (/turf/space,/area/space)
"J" = (/obj/machinery/door/airlock/hatch{desc = "Twists and turns until you loose your head"; name = "Maze"},/turf/simulated/floor/plasteel,/area/ruin/powered)
"L" = (/obj/structure/table/wood/fancy,/obj/item/coin/clown,/turf/simulated/floor/plating/asteroid,/area/ruin/unpowered/no_grav)
"M" = (/mob/living/simple_animal/hostile/carp,/turf/simulated/floor/plating/asteroid,/area/ruin/unpowered/no_grav)
"N" = (/obj/structure/falsewall,/obj/effect/turf_decal/arrows{dir = 8},/turf/space,/area/ruin/unpowered/no_grav)
"O" = (/obj/structure/table,/obj/item/flashlight/lantern{pixel_x = 6; pixel_y = 16},/obj/item/flashlight/lantern{pixel_x = 8; pixel_y = 9},/obj/item/flashlight/lantern{pixel_x = 7; pixel_y = 2},/obj/item/flashlight/lantern{pixel_x = -2; pixel_y = 11},/obj/item/flashlight/lantern{pixel_x = -5; pixel_y = 3},/obj/machinery/light{dir = 4},/turf/simulated/floor/plasteel,/area/ruin/powered)
"S" = (/obj/machinery/door/poddoor{id_tag = "mazeExit"; name = "Blast Door"; opacity = 0},/turf/simulated/floor/plating,/area/ruin/powered)
"U" = (/obj/machinery/door_control{id = "mazeExit"; name = "Exit gate control"; pixel_x = -24; pixel_y = 6},/turf/simulated/floor/plating/asteroid,/area/ruin/powered)
"V" = (/obj/structure/table/abductor,/obj/item/coin/plasma,/turf/simulated/floor/plating/asteroid,/area/ruin/unpowered/no_grav)
"X" = (/turf/simulated/floor/plasteel,/area/ruin/powered)

(1,1,1) = {"
IIIIIIIIIIIIIIIIIIIIIIIIIIIIIIIIIIIIIIIIIIIIIIIIIIIIIIIIIIIIIIIIIIIIIIIIIIIIIIIIIIIIIIIIIIIIIIIIIIII
IIIIIIIIIIIIIIIIIIIIIIIIIIIIIIIIIIIIIIIIIIIIIIIIIIIIIIIIIIIIIIIIIIIIIIIIIIIIIIIIIIIIIIIIIIIIIIIIIIII
IIIIIIIIIIIIIIIIIIIIIIIIIIIIIIIIIIIIIIIIIIIIIIIIIIIIIIIIIIIIIIIIIIIIIIIIIIIIIIIIIIIIIIIIIIIIIIIIIIII
IIIIIIIIIIIIIIIIIIIIIIIIIIIIIIIIIIIIIIIIIIIIIIIIIIIIIIIIIIIIIIIIIIIIIIIIIIIIIIIIIIIIIIIIIIIIIIIIIIII
IIIIIIIIIIIIIIIIIIIIIIIIIIIIIIIIIIIIIIIIIIIIIIIIIIIIIIIIIIIIIIIIIIIIIIIIIIIIIIIIIIIIIIIIIIIIIIIIIIII
IIIIIIIIIIIIIIIIIIIIIIIIIIIIIIIIIIIIIIIIIIIIIIIIIIIIIIIIIIIIIIIIIIIIIIIIIIIIIIIIIIIIIIIIIIIIIIIIIIII
IIIIIIIIIIIIIIIIIIIIIIIIIIIIIIIIIIIIIIIIIIIIIIIIIIIIIIIIIIIIIIIIIIIIIIIIIIIIIIIIIIIIIIIIIIIIIIIIIIII
IIIIIIIIIIIIIIIIIIIIIIIIIIIIIIIIIIIIIIIIIIIIIIIIIIIIIIIIIIIIIIIIIIIIIIIIIIIIIIIIIIIIIIIIIIIIIIIIIIII
IIIIIIIIIIIIIIIIIIIIIIIIIIIIIIIIIIIIIIIIIIIIIIIIIIIIIIIIIIIIIIIIIIIIIIIIIIIIIIIIIIIIIIIIIIIIIIIIIIII
IIIIIIIIIIIIIIIIIIIIIIIIIIIIIIIIIIIIIIIIIIIIIIIIIIIIIIIIIIIIIIIIIIIIIIIIIIIIIIIIIIIIIIIIIIIIIIIIIIII
IIIIIIIIIIIIIIIIIIIIIIIIIIIIIIIIIIIIIIIIIIIIIIIIIIIIIIIIIIIIIIIIIIIIIIIIIIIIIIIIIIIIIIIIIIIIIIIIIIII
IIIIIIIIIIIIIIIIIIIIIIIIIIIIIIIIIIIIIIIIIIIIIIIIIIIIIIIIIIIIIIIIIIIIIIIIIIIIIIIIIIIIIIIIIIIIIIIIIIII
IIkxkIIIIIIIIIIIIIIIIIIIIIIIIIIIIIIIIIIIIIIIIIIIIIIIIIIIIIIIIIIIIIIIIIIIIIIIIIIIIIIIIIIIIIIIIIIIIIII
IIkXkIIIIIIIIIIIIIIIIIIIIIIIIIIIIIIIIIIIIIIIIIIIIIIIIIIIIIIIIIIIIIIIIIIIIIIIIIIIIIIIIIIIIIIIIIIIIIII
IIaxaIIIIIIIIIIIIIIIIIIIIIIIIIIIIIIIIIIIIIIIIIIIIIIIIIIIIIIIIIIIIIIIIIIIIIIIIIIIIIIIIIIIIIIIIIIIIIII
aavXvaaIIIIIIIIIIIIIIIIIIIIIIIIIIIIIIIIIIIIIIIIIIIIIIIIIIIIIIIIIIIIIIIIIIIIIIIIIIIIIIIIIIIIIIIIIIIII
apXXXXaIIIIIIIIIIIIIIIIIIIIIIIIIIIIIIIIIIIIIIIIIIIIIIIIIIIIIIIIIIIIIIIIIIIIIIIIIIIIIIIIIIIIIIIIIIIII
kiXXXXkIIIIIIIIIIIIIIIIIIIIIIIIIIIIIIIIIIIIIIIIIIIIIIIIIIIIIIIIIIIIIIIIIIIIIIIIIIIIIIIIIIIIIIIIIIIII
kXXXXXkIIIIIIIIIIIIIIIIIIIIIIIIIIIIIIIIIIIIIIIIIIIIIIIIIIIIIIIIIIIIIIIIIIIIIIIIIIIIIIIIIIIIIIIIIIIII
vFXXXOvIIIIIIIIIIIIIIIIIIIIIIIIIIIIIIIIIIIIIIIIIIIIIIIIIIIIIIIIIIIIIIIIIIIIIIIIIIIIIIIIIIIIIIIIIIIII
aaaJaaaaaaaaaaaaaaaaaaaaaaaaaaaaaaaaaaaaaaaaaaaaaaaaaaaaaaaaaaaaaaaaaaaaaaaaaaaaaaaaaaaaaaaaaaaaaaaa
ahhhhhhhhhhhhhhnhhhhhhhhhhhnhhhhhhhhhhhhhhhhhhhhhhhhhhhhhhhhhhnhhhhhhhhhhhhhhhhhhhhhhhhnhhhnhhhnhhha
ahnnnnnnhnnnnnnnhnhnhnnnhnhnhnnnnnhnhnnnnnnnnrnrNnnnnnnnnnnnnnnhnnnhnnnnnhnnnnnhnhnnnnhnhnhnhnhnhnha
ahnhhhhnhhhhhhhhhnhnhnhhhnhhhnhhhhhnhnhhhhhhhnhrSrhhhhhhhhhhhhrhnhhhhhnhnhnhhhhhnhnhhhhnhnhnhnhnhnha
ahnhnnnnhnnnnnnnnnnnhnhnnnhnhnnnnnnnhnhnnnhnhnhrUrhnnnnnnnnnnhrhnnnnnhnhnhnhnnnhnhnhnnnnhnhnhnhnhnha
ahnhhhhnhhhhhhhhhhhhhnhnhhhnhnhhhhhhhnhhhnhnhnhrerhhhhhhhhhhhhrhhhhhhhnhnhnhhhnnnhnhhhhnhnhnhnhnhnha
ahnnnnhnhnnnnnnnnnnnhnhnhnnnhnhnnnnnnnnnhnhnhnhrhrhnnnnnnnnnnhrnhnnnnhnhnhnhnhhhnhnhnnhhhnhhhnhnhnha
ahhhhhhnhhhhhhhhhhhnhnhnhnhhhnhnhhhhhhhnhnhnhnhrhrhhhhhnhhhhhhrhhnhhnhnhnhnhnnnhnhnhhnhnhnhnhnhhhnha
ahnnnnnnhnnnnnnnnnhnhhhnhnhnnnhnhnnnnnhnhnhnhnhrhrhnhnhhhnnnnhrhnnnhnhhhnhnhnhhhnhnhnnhnhnhnhnhnhnha
ahhhhhhhhhhhhhhhhnhnhnnnhnhnhhhnhnhhhnhnhnhnhnhrhrhnhnnnnnhhhhrhhhhhnnnnnhnhnhnnnhnhnhhnhhhhhhhnhhha
annnnnhnnnnnnnnnhnhnhhhhhnhnhnnnhhhnhnhnhnhnhnhrhrhnhhhnhhhnnhrhnnnnnhhhnhnhnhhhnhnnnnnnnnnhnnnnnnna
ahhhhhhhnhhhhhhnhnhnnnnnnnhnnnhhhnhnhnhnhnhnhhhrhrhnnnnnnnnnhhrhhhhhhhnhnhnhnnnhnhnhhhhhhhnhnhhhnhna
ahnhnnnhnhnnnnnnhnhhhhhhhhhhhhhnnnhnhnhnhhhnhnhrhrhhhhnhnhhhhhrhnnnnnnnhnhhhhhnhnhnhnnnhnhhhhhnhhhha
ahnhnhnnnhnhhhhhhnnnnnnnnnnnnnnnhhhnhnnnhnnnhnhrhrhnnnnhnnnnnhrhnhhhnhnhnnnnnnnnnhnhnhnhnhnnnhnnnnha
ahnhnhhhhhnhnnnnnnhhhhhhhhhhhhnhhnhnhnhhhhhnhnhrhrhhnhnhhhhhhhrhhhnhhhnhhhhhhhhhhhnhnhnhnhnhnhnhhhha
ahnhnhnnnhhhnhhhhhhnnnnnnnnnnhnnnnhnnnhnnnhnhnhrhrnhnhhhnnnhnnrnnnnnnnnnnnnnnnnnnhnhhhhhnhnhnhnhnnna
ahnhnhnhnhnnnhnnnnhhhnhhhhhhnhnhhhhnhhhhhnhnhnhrhrhhhhnhhhhhhhrhnhhhhhhhhhhhhhhhnhnhnhnhnhnhnhnhhhha
ahnhhhnhnhhhhhnhhhhnhnhnhnnnnhnnnnnnnnnnhnhnhnhrhrnnnnnhnnnnnhrhnhnnnnnhnnnnnnnhnhnhnnnhnhnhnhnnnnha
ahnnnnnhnnnnnnnhnnhnhnhnhhhhnhnhhhhhhhhhhnhnhnhrhrhhhhhhhhnhnhrhnhnhhhhhnhhhhhhhnhnhhnhhnhnhnhhhhhha
ahhhhhhhnhhhhhhhhnhnhhhnhhnhnhnhnnnnnnnnnnhnhnhrhrhnnnnnnhnhnhrhnhnhnnnhnhnnnnnnnhnnhnhnnhnhnhnnnnna
annnnnnnnnnnnnnnhnhnhnnnnhnhnhnhnhhhhhhhhnhnnnhrhrhnhhhhnhnhnhrhhhnhnhhhnhnhhnhhnhnhhhhhhhnhnhhhhhha
ahhhhhhhhhhhhhhhhnhnhhhhnhnhnhnhnhnnnnnhnnhhhnhrhrhnnnnhnhnhnhrhnhnhnhnhnhnhnnnhnhnnhnnnnnnhnnnnnhna
ahnhnhnhnnhnhnhnnnhnnhnhnhnhnhnhnhnhhhhhhnnnhnhrhrhhhhhhnhhhnhrhnhnhhhnhnhnhnhnhnhnhhhhhhhhhhhhhnhna
ahnhnhnhnhhnhnhhhnhnhhnhhhhhnhnhnhhhnhnhhhhnhnhrhrnnnnnhnnnnnnrhnhnnnnnhnhnhnhnhnhnnnnnnnnnhnnnnnhna
ahnhnhnhnhnnhnnnhnhnnnnnnnnnnhnhnnnnnnnhnnnnhnhrhrhhhhnhhhhhhhrhnhhhhhnhnhnhnhhhnhnhhhnhhhnhnhhhhhha
ahnhnhnhnhhnhnhhhhhhhhhhhhhhhhnhhhhhhhhhhhnhhnhrhrnnnhnhnnnnnhrhnnnnnhhhnhnhnnnhnhnhnhhhnhnhnnnnnnha
ahnhnhnhnnnnhnnnnnnnnnnnnnnnnnnnhnnnnnnnnhhhhhnrhrhhnhnhnhhhhhrhhhhhnnnnnhhhhhhhnhnhnhnnnnnhnhhhhhha
ahnhnhnhhhhhhnhnhhhhhhhhhhhhhhhnhnhnhhhhnnnnnnnrhrhhhhhhnhnnnnrhnnnhhhhhnnnnnnnnnhnhnhhhhhnhnhnnnnnd
ahnhnhnnnnnnnnhnhnnnnnnnnnnnnnhnhnhnhnhhhhhhhnhrhrhnhnnnnhhhhhrhnhhhnhhhhhhhhhhhhhnhnnnnnhnhnhhhhhha
ahnhnhhhhhhhhhhnhnnhhhhhhhhhhhhnhnhnhnhnhnnnnnhrhrhnhhhhnnnnnhrnnnnnnnnnhnnnnnnnnhnnnhhhhhnhnnnnnnha
ahnhnnnnnnnnnnnnhnnhnnnnnnnnnnnnhhhnhnhnhhhhhhhrhrhnnnnhhhhhhhrhhhhhhnhhhhhhhhhhnhnhnhnnnnnhnhhhhhha
ahnhhhhhhhhhhhhhhnnhnhhhhhhhhhhhhnhnhnhnhnnnnnhrhrhnhhnnnnnnnhrhnnnnhnhnnnnhnnnhnhnhnhnhhhnhnhnnnnna
ahnnnnnnnnnnnnnnnnnhnhnnnnnnnnnnhnhhhnhnhhhhhnhrhrhnhnnhnhhhnhrhhhhnhnhhhhnhhhnhnhnhhhhhnhnhnhhhhhha
ahhhhhhnhhhhhhhhhhhhnhnhhhhhhhhhhnhnnnnnnnnnnnnrhrhnhhnhnhnhnhrhnnnnhnnnnhnhnnnhnhnhnnnnnnnhnnnnnnha
ahnnnnhhhnnnnnnnnnnnnhnhnnnnnnhnhnhhhhhhhhhhhhhrhrhhhhhhhhnhhhrhhhhhhhhhhhnhnhhhnhnhhhhhhhhhhhhhhhha
ahhhhnnnnnhhhhhhnhhhnhnhhhhhhnhnhnrrrrrrrrrrrrrrhrrrrhrrrrrrrrrnnnnnnnnnnnnnnnnnnnnnnnnnnnnnnnnnnnha
ahnnhhhnhhhhnhnhhhnhnhnhnnnnhnhnhnhnhrhhhhhhhhhrhrhhhhhhhhhrhhhhhhhnhnhhhnhhhnhhhhnhhhhhhnhnhhhnhnha
ahnhhnhnnnnnnhnnnnnhnhnhhhhnhnhnhnhhhrhnnnnnnnnrhrhnnnnnnnhrhnnnhnhnhnhnhnhnhnhnhhnnnnnnhnhnhnhnhnha
ahhnhnhhhhhhhhhhhhhhnhnhnnhnhnhnhnnnhrhnhhhhhhhrhrhnhhhhhhhrhnhnhnhnhnhnhnhnhnhnhhhnhnhnhnhhhnhnhnha
ahnhhnnnnnnnnnnnnnnhnhnhhnhnhnhnhnhhhhhnhnnnnnhrhrhnhnnnnnhrhnhnhnhhhnhnhnhnhnhnhnhhhnhnhnhnhnhhhnha
ahhhhhhhhhhhhhhhhhhhhhhnhnhnhhhnhnhnnrhhhhhhhnhrhrhnhnhhhhhrhnhnhnhnhnhnhnhnhnhnhnhnhnhnhnnnnnnnhnha
annnnnnnnhnnnnnnnnnhnnhnhnhnnnnnhnhhhrhnnnnnhnhrhrhnhnhnnnhrnnhhhnhnhnhnhnhnhnhnhnhnhnhnhhhhhhhhhhha
ahhhhhhhhhhhhhhhhhnhnhhnhnhhhhhnhnnnhrhnhhhnhnhrhrhnhnhnhhhrhnnnnnhnhnhnhhhnhnhnhnhnhnhnnnnnnnnnnnha
ahnnnnhnnnnnnnnnnhnhnhnnhnnnnnnnhnhhhrhhhnhnhnhrhrhnnnhnnnnrhhhhhhhnhnnnhnnnhnhnhnhnhnhhhhnhnhnhhhha
ahnhhhhnhhhnhhhhnhnhnhnhhhhhhhhnhnhnhrnhnnnnnnhrhrhhhhhhhhhrnnnnnnnnhhhnhnhnhnhnhnhnhnnnnhnhhhnhnnha
ahnhnnhnhnhhhnnnnhnhnhnhnnnnnnhnhnhnhrhhhhnhhhrrhrrhnhnhnhhrhhhhhhhnhnhnhnhnhnhnhnhnhhhhhhnhnhnhnhha
ahnhnhhnhnnnnhhhhhnhnhnhnhhhhhhnhnhnhrnnnhhhrrrhhhrrrhnhnhnrhnnnnnhnhnhnhnhnhnhnhnhnnnnhnnnnnhhhnhna
ahnhnhnnhnhhhhnnnhnhnhnhnhnnnnhnhnhnhrhhhhnrrhhhhhhhrrnhnhhrhnhhhnhhhnhnhnhnhnhnhnhhhhhhhhhhnhnhnhha
ahnhnhhnhnhnnnnhhhnhnhnhnhhhhnhnhnhhhrhnnnrrhhMhhhMhhrrhnnnrhnhnhnhnhnhnhnhnhnhnhnnnnnnnnnnhhhnhnnha
ahnhnnnnhnhnhhhhnhnhnhnhnnnnhnhnhnnnhrhnhhrhhhhhshhhhhrhhhhrhhhnhhhnhnhhhnhhhnhnhhhhhhhhnhnhnhnhnhha
ahnhhhhhhhhnhnnnnhnhnhnhhhhhhnhnhnhhhrhnnhrhhhfhhhLhhhrrrrrrhrrrrrrrrrrrhrrrrrhnhnnnnnnhnhnhnhnhnnha
ahnnnnnnnnnnhhnhnhnhnhnnnnnnhnnnhnhnnrhhhhrhhhhhmhhhhhhhhhhhhrhhhhhhhhhhhhhhhnhnhnhhhhnhnhnnnnnnnnha
ahhhhhhhhhhhhhnhnhnhnhhhhhhnhnhhhnhhhrhnnnrhhhEhhhVhhhrrrrrrrrrrrrrrrrrrrrrrhrhnhnnnnhnhnhhnhhhhhhha
annnnnnnnnnnnhnhnnnhnnnnnnnnhnnnnnrrhrhhhhrhhhhhzhhhhhrhhhhrhhhhhhhhhhhhhhhhhnhnhhhhhhhhhhhnnnnnhnha
ahhhhhhhhhhhnhhhnhnhhhhhhhhhhnhhhhhrhrhnnhrrhhMhhhhhhrrnnnhrhnnnnnnnnnnnnnnnhnhnnnnnnnnnnnhhhhhhhnha
ahnnnnhnnnnhnnnnnhnhnnnnnnnnnnhrrrhrhrhhnhnrrhhhhMhhrrnhhhhrhnhhhhhhhhhhhhhnhnhnhhhhhhhhhnnnnnnnhnha
ahnhhhhnhhhhhhhhhhhhnhhhrhhhrhhrhhhrhrnhnhhhrrrhhhrrrhhhhnhhhnhnnnnnnnnnnnhnhnhnhnnnnnnnhhhhhhhnhnna
ahnnnnhnhnhnhnhnnnnnnhrhrhrhrrrrhrrrhrhhhhnhnhrrrrrhnhnnnnhrhnhnhhhnhhhnhnhnhnhnhnhhhhhnhnnnnnhnhhha
ahnhhhhnhnhnhnhnhhhhhhrhrhrhhrhrhrhhhrnnnnnhnhhhhhnhnhnhhnhrhnhnhnhhhnhhhnhnhnhnhnhnnnhnhnhhhnhnnnha
ahnhnnnnhnhnhnhnhrrrrrrrrrrrhrhrhrhnhrhhhhhhnnnnnhnhnhnnhnhrhnhnhnnnnnnnnnhnhnhnhnhnhnhnhnhnhnhhhnha
ahnhhhhnhnhnhnhnhrhhhhhhhhhhhrhrhrhnhrnnnhnnnhnnhhnhnhhhhnhrhnhnhhhhhhhhhhhnhnhnhnhhhnhnhnhnhnhnnnha
ahnnnnhnhnhnhnhnhrhrrrrrrrrrhrhrhrhnhrhhhhhnhhhnnhnhnnnnnnhrhnhnnnnnnnnnnnnnhnhnhnnnnnhnhnhnhnhnhnha
ahnhhhhnhnhnhnhnhrhhhrhhhhhhhhhrhrhnhrhnnnnnhnhhhhnhhnhhhnhrhnhhhhhhhhhhhhhhhnhnhhhhhhhnhhhnhnhhhnha
ahnhnnnnhnhnhnhnhrhrrrhrrrrrrrhrhrhnhrhnhhhnhnhnnnnnhnhnhnhrhnnnnnnnnnnnnnnnnnhnhnnnnnnnnnnnnnnnnnha
ahnhhhhhhnhnhnhnhrhhhrhrhhhhhhhhhrhnhrhhhnhhhnhhhhhhhhhnhhhrhhhhhhhhhhhhhhhhhhhnhhhhhhhhhhhhhhhhhhha
ahnnnnnnhnhnhnhnhrhrrrhrhrrrrrrrrrhrrrrrrrrrrrrrnrrrrrrrrrrrrrrrrrrrrrrrrrrrrrrrrrrrrrrrrrrrrrrhrrra
ahnhhhhhhnhnhnhnhrhhhhhrhrhhhhhhhhhhhhhhhhhhhnhhhhhhhhhhhhhhrhhhnhnhnhhhhhhhhhhhhrhhhhhhhhhhhhhhhhha
ahnnnnnnnnhnhnhnhrhrrrhrhrhrrrrrhnnnnnnnnnhnnnnnnnnnnnnnnnnhrhnhnhnhnnnnnnnnhnhnhrhnnnnnnnnnnnnnnnna
ahhhhhhhhnnnnnnnhrhhhrhrhrhrhrhrhnhnhnhhhnhnhnhhhhhhhhhhhhhhrhnhnhnhhhhhhhhnhnhnhrhnhhhhhhnhnhhhhhha
annnnnnnhnhhhhhnhrhrhrhhhrhrhrhrhnhnhnhnhnhnhnnnnnnnnnnnnnnhrhnhnhnhnnnnnnhnhnhnhrhnhnnnnhnhnhnnnnha
ahhhhhhhhnnnhnnnhrrrrrrrrrhrhrhrhnhnhnhnhnhnhnhhhhhhhhhhhnhhrhnhnhhhhhhhhhhnhnhnhrhnhnhnnhnhnhhhhnha
ahnnnnnnhhhhqhhhhhhhhhhhhhhrhhhrhnhnhnhnhnhnhnnnnnnnnnnnhnnhrhnhnnnnnnnnhnnnhnhnhrhnhnhhnhnhnnnnhnha
ahhhhhhnnnnnhnnnnnnnnnnrrrrrrrhrhnhhhnhnhnhnhhhnhhhhhhhhhnhhrhnhhhhhhhhhhhhhhnhnhrhnhnnhnhnhnhnnhnha
arrrrrrrhhhhhhhhhhhhhhhhhhhhhhhrhnhnhnhnhnhnhnhnnnnnnnnnhnhnrhnnnnnnnnhnnnnnnnhnhrhnhnhhnhnhnhhhhnha
ahhhhhhhhrrrhrrrrrrrhrhrhrrrrrrrhnhnhnhnhnhnhnhhhnhhhhhhhnhhrhhhhhhhhhhhhhhhhhhnhrhnhnhnnhnhnnnnnnha
ahrrrrrrhhhrhrhhhhhhhrhrhhhhhhhrhnhnhnhnhhhnhnhnhnnnnnnnhnnhrhnnnnhnnnnnnnnnnnnnhrhnhnhhnhnhnhhnhhha
ahrhhhhrrrhrhrhrrrrrhrhrhrrrrrhrhnhnhhhnhnhnhnhnhhhhhhhhhhhhnhnhhnhhhnhnhhnhnhnhhrhnhnnhnhnhnnhnhnha
ahrrrrhhhhhrhrhhhhhrhrhrhrhhhhhrhhhnhnhnhnhnhnhnnnnnnnhnnnnnnhnhnnhnhnhnnhnhnhnhnnhhhhhhnhnhnhhnhnha
ahrhhhhrrrhrhrhrrrrrhrhrhrhrrrhrhnhnhnhnhnhnhnhnhhhhhhhhhhhhhhnhnhhnhnhhnhhhnhnhhrhnnnnnnhnhnhnnnnha
ahrrrrrrhhhhhrhhhrhrhrhrhrhrhhhrhnhnhnhhhnhnhnhnhnnnnnnnnnnhrhnhnhnnhnnhnhnhnhhhhrhhhhhhhhhhnhhhhhha
ahhhhhhhhrrrhrhrhrhrhrhrhrhrhrhrhnhnhnhnhnhnhnhhhnhnhhhhhhnhrhnhnnnhhhnhnhnhnnnnhrnnnnnnhnnnnnnnhnna
ahrrrrrrrrhhhrhrrrhrhrhrhrhrrrhrhnhnhnhnhhhnhnhnnnhnnnnnnhnhrhhhhhhhnhhhhhnhhhhhhrhhhhhhhhhhhhhhhhha
ahhhhhhhhhhrhrhhhhhhhrhrhhhhhhhrhnhhhnhnhhhnhnhhhhhhhhhhhhhhrrrrrrrrrrrrrrnrrrrrhhhrrrrrrrrrrrrrrrra
arrrrrrrrrrrrrrrrrrrrrhrrrrrrrrrrrrrrrrrrrrrrrrrrrnnnnnnnnnhrhhhnhhhhhhhhhnhhhhnhrhhhhhhhhhnhnhhhnha
ahhhhhhhrhhhhhhhhhhhhhhhhhhhrhhhhhhhhhhhhhhhhhhhhhhhhhhhhhhhrhnhnhnnnnnnnhnhnnnnhrhnnnnnnnhnhhhnhhha
ahrrrrrhrhrrrrrrrhrrrrrrrrrhrrrrrrrrrrrrrrrhrnnnnnnnhnnnnnnnrhnhnhhhhhhhnhnhhhhnhrhnhhhhhnhnhnnnnnna
ahrhhhrhrhhhhhhhrhhhhrhhhhhhrhhhhhhhhhhhhhrhrhhhhnhhhhhnhhhhrhnhnhnnnnnnnhnhnnnnhrhnnnnnhnhnhhhhhhha
ahrhrhrhrrrrrrrhrrrrhrhrrrrrrhrrrrrrrrrrrrrhrhnnhnhnnnhnhnnhrhnhnhhhhhhhhhnhhhhnhrhhhhhhhnhnnnnnnnha
ahrhrhrhrhhhhhhhrhhhhrhhhhhhrhrhhhhhhhhhhhhhrhhnhnhhhhhnhnhhrhnhnnnnnnnnnhnhhnhnhrhnnnnnnnhnhhhhhhha
ahrhrhrhrhrrrhrhrhrrrrrrrrrhrhrrrrrrrrrrrhrhrnhnhhhnhnhhhnhnrhnhhhhhhhhhhhnnhnhnhrhnhhhhhnhnhnnnnnna
ahrhrhrhrhrhrhrhrhrhhrhhhhhhrhhhhhhhhhhhhhrhrhhnnnhnhnhnnnhhrhnnnnnnnnnnnnnhhnhnhrhnhnnnhnhnhhhhhhha
ahhhrhrhrhrhrhrhrhrhrrrhrrrrrhrrrrrrrrrrrrrhrhhhhhhnhnhhhhhhrhhhhhhhhhhhhhnhnnhhhrhnhhhnhnhnnnnnnnha
ahrrrhrhrhrhrhrhrhrhrhhhhhhhrhrhhhhhhhhhhhrhrnnnnnnnhnnnnnnnrhnnnnnnnnnnnhnhhnhnhrhnnnnnhnhnhhhhhhha
ahrhhhrhrhrhrhrhrhrhrhrrrrrhrhrrrrrrrrrrrhrhrhhhhhhhhhhhhhhhrhnhhhhhhhhhhhnnnnnnhrhhhhhhhnhnhnnnnnna
ahrrrrrhrhrhrrrhrhrhrhhhrhrhrhrhhhhhrhhhhhrhrhnnnnnnnnnnnnnhrhnnnnnnnnnnnhhhhhhhhrhnnnnnhnhnhhhhhhha
ahhhhhrhrhrhhhrhrhrhrhrhrhrhrhrrrrrhrhrrrrrhrhnhhhhhnhhhhhnhrhhhhhhnhhhhhhnnnnnnhrhnhhhhhnhnnnnnnnha
ahrrrhrhrhrrrhrhrhrhhhrhrhrhrhhhhhhhrhrhhhrhrhnhnhnhnhnhnhnhrhnnnnnnnnnnnhnhhhhnhrhnnnnnnnhnhhhnhnha
ahhhrhrhrhrhrhrhrhrrrrrhrhrhrhrrrrrrrhrhrhrhrhnhnhnhnhnhnhnhrhhhhhhhhhhhnhnhnnnnhrhhhnhhhnhnhnhnhnha
ahrhhhrhhhrhhhhhrhhhhhrhrhhhnhhhhhhhhhhhrhhhrhhhnhhhnhhhnhhhrhnnnnnnnnnnnhnhhhhhhrhnhhhnhhhhhnhhhhha
aaaaaaaaaaaaaaaaaaaaaaaaaaaaaaaaaaaaaaaaaaaaaaaaaaaaaaaaaaaaaaaaaaaaaaaaaaaaaaaaaaaaaaaaaaaaaaaaaaaa
"}
