"a" = (/turf/space,/area/space)
"b" = (/turf/simulated/wall/shuttle{icon_state = "swall_s6";dir = 2},/area/ruin/powered)
"c" = (/obj/structure/grille,/obj/structure/window/reinforced/fulltile,/turf/simulated/floor/plating,/area/ruin/powered)
"d" = (/turf/simulated/wall/shuttle{icon_state = "swall_s10";dir = 2},/area/ruin/powered)
"e" = (/turf/simulated/wall/shuttle{icon_state = "swall3";dir = 2},/area/ruin/powered)
"f" = (/obj/structure/closet/crate/secure/loot,/obj/effect/decal/cleanable/cobweb,/turf/simulated/floor/plasteel/shuttle,/area/ruin/powered)
"g" = (/obj/structure/closet/crate/secure/loot,/turf/simulated/floor/plasteel/shuttle,/area/ruin/powered)
"h" = (/obj/structure/table,/obj/machinery/button/door{id = "mechaship1";name = "Mecha Cargo Ship Doors"},/turf/simulated/floor/plasteel/shuttle,/area/ruin/powered)
"i" = (/obj/structure/table,/obj/effect/decal/cleanable/dirt,/turf/simulated/floor/plasteel/shuttle,/area/ruin/powered)
"j" = (/obj/machinery/computer/shuttle,/turf/simulated/floor/plasteel/shuttle,/area/ruin/powered)
"k" = (/obj/effect/decal/cleanable/vomit/old,/turf/simulated/floor/plasteel/shuttle,/area/ruin/powered)
"l" = (/obj/effect/decal/remains/human,/turf/simulated/floor/plasteel/shuttle,/area/ruin/powered)
"m" = (/obj/effect/decal/cleanable/dirt,/turf/simulated/floor/plasteel/shuttle,/area/ruin/powered)
"n" = (/obj/structure/chair/office/dark{dir = 1},/turf/simulated/floor/plasteel/shuttle,/area/ruin/powered)
"o" = (/turf/simulated/wall/shuttle{icon_state = "swall13";dir = 2},/area/ruin/powered)
"p" = (/obj/machinery/door/airlock/hatch{name = "Cockpit";req_access_txt = "101"},/turf/simulated/floor/plasteel/shuttle{icon_state = "shuttlefloor3"},/area/ruin/powered)
"q" = (/turf/simulated/wall/shuttle{icon_state = "swall12";dir = 2},/area/ruin/powered)
"r" = (/obj/effect/decal/cleanable/dirt,/obj/effect/decal/cleanable/cobweb,/turf/simulated/floor/plasteel/airless/shuttle/white,/area/ruin/powered)
"s" = (/turf/simulated/floor/plasteel/airless/shuttle/white,/area/ruin/powered)
"t" = (/obj/effect/decal/cleanable/dirt,/turf/simulated/floor/plasteel/airless/shuttle/white,/area/ruin/powered)
"u" = (/obj/effect/decal/cleanable/cobweb2,/turf/simulated/floor/plasteel/airless/shuttle/white,/area/ruin/powered)
"v" = (/obj/structure/mecha_wreckage/phazon,/turf/simulated/floor/plasteel/airless/shuttle/yellow,/area/ruin/powered)
"w" = (/turf/simulated/floor/plasteel/airless/shuttle/yellow,/area/ruin/powered)
"x" = (/obj/structure/mecha_wreckage/ripley/firefighter,/turf/simulated/floor/plasteel/airless/shuttle/yellow,/area/ruin/powered)
"y" = (/obj/effect/decal/cleanable/dirt,/turf/simulated/floor/plasteel/airless/shuttle/yellow,/area/ruin/powered)
"z" = (/obj/structure/mecha_wreckage/ripley,/turf/simulated/floor/plasteel/airless/shuttle/yellow,/area/ruin/powered)
"A" = (/obj/mecha/working/ripley,/turf/simulated/floor/plasteel/airless/shuttle/yellow,/area/ruin/powered)
"B" = (/obj/effect/decal/cleanable/oil,/turf/simulated/floor/plasteel/airless/shuttle/yellow,/area/ruin/powered)
"C" = (/obj/effect/decal/cleanable/robot_debris/up,/turf/simulated/floor/plasteel/airless/shuttle/yellow,/area/ruin/powered)
"D" = (/obj/machinery/door/poddoor{id = "mechaship1";name = "Cargo Bay Door"},/turf/simulated/floor/plasteel/airless/shuttle/yellow,/area/ruin/powered)
"E" = (/obj/effect/decal/cleanable/robot_debris,/turf/simulated/floor/plasteel/airless/shuttle/yellow,/area/ruin/powered)
"F" = (/obj/structure/mecha_wreckage/durand,/turf/simulated/floor/plasteel/airless/shuttle/yellow,/area/ruin/powered)
"G" = (/obj/item/stack/tile/plasteel,/turf/simulated/floor/plating/airless,/area/ruin/powered)
"H" = (/turf/simulated/floor/plating/airless,/area/ruin/powered)
"I" = (/obj/structure/lattice,/turf/space,/area/space)
"J" = (/obj/machinery/computer/mecha,/turf/simulated/floor/plasteel/shuttle,/area/ruin/powered)
"K" = (/obj/effect/decal/cleanable/robot_debris/gib,/turf/simulated/floor/plating/airless,/area/ruin/powered)
"L" = (/obj/effect/decal/cleanable/robot_debris,/obj/item/stack/tile/plasteel,/turf/simulated/floor/plasteel/airless/shuttle/yellow,/area/ruin/powered)
"M" = (/turf/simulated/floor/plating{icon_state = "platingdmg1";initial_gas_mix = "TEMP=2.7"},/area/ruin/powered)
"N" = (/turf/simulated/floor/plating{icon_state = "platingdmg2";initial_gas_mix = "TEMP=2.7"},/area/ruin/powered)
"O" = (/obj/structure/mecha_wreckage/odysseus,/turf/simulated/floor/plasteel/airless/shuttle/yellow,/area/ruin/powered)
"P" = (/obj/item/stack/sheet/metal,/turf/space,/area/space)
"Q" = (/obj/structure/mecha_wreckage/gygax,/turf/simulated/floor/plasteel/airless/shuttle/white,/area/ruin/powered)
"R" = (/turf/simulated/floor/plating{icon_state = "platingdmg3";initial_gas_mix = "TEMP=2.7"},/area/space)
"S" = (/obj/item/stack/rods,/turf/simulated/floor/plating/airless,/area/ruin/powered)
"T" = (/turf/simulated/wall/shuttle{icon_state = "swall14";dir = 2},/area/ruin/powered)
"U" = (/turf/simulated/wall/shuttle{icon_state = "swall_s9";dir = 2},/area/ruin/powered)
"V" = (/obj/item/stack/rods,/turf/space,/area/space)
"W" = (/turf/simulated/wall/shuttle{icon_state = "swall15";dir = 2},/area/ruin/powered)
"X" = (/obj/structure/shuttle/engine/propulsion,/turf/space,/area/ruin/powered)

(1,1,1) = {"
abcccccda
aefghijea
aeklmnJea
bopqqqqod
erststtue
evwwxyzAe
eBwCwzwyD
eEFGwwwwD
GHwFyHywD
ISHwKLwBD
MHNGOOwyD
PIIHsHQse
aRIPSHqTU
aVaaIabWd
aaaaaaXXX
"}
