"aa" = (/turf/space,/area/space)
"ab" = (/obj/structure/lattice,/obj/structure/cable{d1 = 2; d2 = 4; icon_state = "2-4"},/turf/space,/area/space)
"ac" = (/obj/structure/lattice,/obj/structure/cable{d1 = 4; d2 = 8; icon_state = "4-8"},/turf/space,/area/space)
"ad" = (/obj/structure/lattice,/obj/structure/cable{d1 = 2; d2 = 8; icon_state = "2-8"},/turf/space,/area/space)
"ae" = (/obj/structure/lattice,/obj/item/stack/cable_coil/cut{amount = 2; dir = 2; icon_state = "coil_red2"},/turf/space,/area/space)
"af" = (/obj/structure/lattice,/obj/structure/cable{d1 = 1; d2 = 8; icon_state = "1-8"},/turf/space,/area/space)
"ag" = (/turf/simulated/wall,/area/ruin/onehalf/dorms_med)
"ah" = (/obj/structure/grille,/obj/structure/window/reinforced/fulltile,/turf/simulated/floor/plating,/area/ruin/onehalf/dorms_med)
"ai" = (/obj/structure/lattice,/obj/structure/cable{d1 = 1; d2 = 2; icon_state = "1-2"},/turf/space,/area/space)
"aj" = (/turf/simulated/floor/plating/airless,/area/ruin/onehalf/hallway)
"ak" = (/turf/simulated/wall,/area/ruin/onehalf/hallway)
"al" = (/obj/machinery/sleeper/syndie{dir = 4},/turf/simulated/floor/plasteel/white,/area/ruin/onehalf/dorms_med)
"am" = (/turf/simulated/floor/plasteel/white,/area/ruin/onehalf/dorms_med)
"an" = (/obj/structure/table,/obj/item/weapon/storage/firstaid/toxin{pixel_x = 3; pixel_y = 3},/obj/item/weapon/storage/firstaid/fire,/turf/simulated/floor/plasteel/white,/area/ruin/onehalf/dorms_med)
"ao" = (/obj/structure/bed,/obj/item/weapon/bedsheet/black,/turf/simulated/floor/plasteel,/area/ruin/onehalf/dorms_med)
"ap" = (/turf/simulated/floor/plasteel,/area/ruin/onehalf/dorms_med)
"aq" = (/obj/machinery/door/airlock/external,/obj/structure/cable{d1 = 1; d2 = 2; icon_state = "1-2"},/turf/simulated/floor/plating,/area/ruin/onehalf/drone_bay)
"ar" = (/turf/simulated/wall,/area/ruin/onehalf/drone_bay)
"as" = (/obj/machinery/door/poddoor{id = "onehalf_drone1ext"; name = "mining drone bay blast door"},/turf/simulated/floor/plating/airless{dir = 1; icon_state = "warnplate"},/area/ruin/onehalf/drone_bay)
"at" = (/obj/machinery/door/poddoor{id = "onehalf_drone2ext"; name = "mining drone bay blast door"},/turf/simulated/floor/plating/airless{dir = 1; icon_state = "warnplate"},/area/ruin/onehalf/drone_bay)
"au" = (/obj/machinery/door/poddoor/preopen{id = "onehalf_drone3ext"; name = "mining drone bay blast door"},/turf/simulated/floor/plating/airless{dir = 1; icon_state = "warnplate"},/area/ruin/onehalf/drone_bay)
"av" = (/obj/machinery/door/poddoor{id = "onehalf_drone4ext"; name = "mining drone bay blast door"},/turf/simulated/floor/plating/airless{dir = 1; icon_state = "warnplate"},/area/ruin/onehalf/drone_bay)
"aw" = (/obj/structure/lattice,/turf/space,/area/space)
"ax" = (/obj/structure/lattice,/turf/space,/area/ruin/onehalf/hallway)
"ay" = (/obj/structure/table_frame,/turf/simulated/floor/plasteel/airless{icon_state = "damaged3"},/area/ruin/onehalf/hallway)
"az" = (/obj/machinery/washing_machine,/turf/simulated/floor/plasteel/airless,/area/ruin/onehalf/hallway)
"aA" = (/obj/item/roller,/turf/simulated/floor/plasteel/white,/area/ruin/onehalf/dorms_med)
"aB" = (/obj/machinery/light{icon_state = "tube1"; dir = 4},/obj/structure/table,/obj/item/weapon/storage/firstaid/brute{pixel_x = 3; pixel_y = 3},/obj/item/weapon/storage/firstaid/regular,/turf/simulated/floor/plasteel/white,/area/ruin/onehalf/dorms_med)
"aC" = (/obj/machinery/light{dir = 8},/turf/simulated/floor/plasteel,/area/ruin/onehalf/dorms_med)
"aD" = (/obj/structure/cable{d1 = 1; d2 = 2; icon_state = "1-2"},/obj/machinery/light/small{dir = 8},/turf/simulated/floor/plating,/area/ruin/onehalf/drone_bay)
"aE" = (/obj/structure/disposalpipe/trunk,/turf/simulated/floor/plating/airless,/area/ruin/onehalf/drone_bay)
"aF" = (/obj/structure/disposalpipe/trunk,/obj/item/weapon/ore/diamond,/turf/simulated/floor/plating/airless,/area/ruin/onehalf/drone_bay)
"aG" = (/turf/simulated/floor/plating/airless{dir = 1; icon_state = "warnplate"},/area/ruin/onehalf/drone_bay)
"aH" = (/obj/item/stack/rods,/turf/space,/area/ruin/onehalf/hallway)
"aI" = (/turf/simulated/floor/plating/airless{icon_state = "platingdmg3"},/area/ruin/onehalf/hallway)
"aJ" = (/turf/simulated/floor/plasteel/airless{icon_state = "damaged5"},/area/ruin/onehalf/hallway)
"aK" = (/obj/machinery/iv_drip,/turf/simulated/floor/plasteel/white,/area/ruin/onehalf/dorms_med)
"aL" = (/obj/structure/cable{d1 = 2; d2 = 4; icon_state = "2-4"},/turf/simulated/floor/plasteel/white,/area/ruin/onehalf/dorms_med)
"aM" = (/obj/structure/cable{d2 = 8; icon_state = "0-8"},/obj/structure/closet/crate/medical,/obj/item/clothing/tie/stethoscope,/obj/item/device/healthanalyzer,/obj/item/weapon/reagent_containers/blood/OMinus,/obj/item/weapon/reagent_containers/blood/OMinus,/obj/machinery/power/apc{dir = 4; name = "Crew Quarters APC"; pixel_x = 26; pixel_y = 0},/turf/simulated/floor/plasteel/white,/area/ruin/onehalf/dorms_med)
"aN" = (/obj/structure/disposalpipe/segment,/obj/machinery/door/poddoor{id = "onehalf_drone1int"; name = "mining drone bay blast door"},/turf/simulated/floor/plating,/area/ruin/onehalf/drone_bay)
"aO" = (/obj/structure/disposalpipe/segment,/obj/machinery/door/poddoor{id = "onehalf_drone2int"; name = "mining drone bay blast door"},/turf/simulated/floor/plating,/area/ruin/onehalf/drone_bay)
"aP" = (/obj/structure/disposalpipe/segment,/obj/machinery/door/poddoor{id = "onehalf_drone3int"; name = "mining drone bay blast door"},/turf/simulated/floor/plating,/area/ruin/onehalf/drone_bay)
"aQ" = (/obj/structure/disposalpipe/segment,/obj/machinery/door/poddoor{id = "onehalf_drone4int"; name = "mining drone bay blast door"},/turf/simulated/floor/plating,/area/ruin/onehalf/drone_bay)
"aR" = (/obj/structure/disposaloutlet{dir = 1},/obj/structure/disposalpipe/trunk,/turf/simulated/floor/plating/airless,/area/ruin/onehalf/drone_bay)
"aS" = (/obj/structure/lattice,/obj/item/weapon/storage/toolbox/syndicate,/turf/space,/area/space)
"aT" = (/obj/structure/cable{d1 = 1; d2 = 2; icon_state = "1-2"},/turf/simulated/floor/plasteel/airless{icon_state = "damaged3"},/area/ruin/onehalf/hallway)
"aU" = (/turf/simulated/floor/plasteel/airless{icon_state = "damaged1"},/area/ruin/onehalf/hallway)
"aV" = (/obj/machinery/door/airlock/glass_medical,/obj/structure/cable{d1 = 1; d2 = 2; icon_state = "1-2"},/turf/simulated/floor/plasteel/white,/area/ruin/onehalf/dorms_med)
"aW" = (/obj/machinery/door/airlock,/turf/simulated/floor/plasteel,/area/ruin/onehalf/dorms_med)
"aX" = (/obj/structure/cable{d1 = 1; d2 = 4; icon_state = "1-4"},/obj/structure/cable{d1 = 1; d2 = 2; icon_state = "1-2"},/turf/simulated/floor/plasteel{dir = 9; icon_state = "warning"},/area/ruin/onehalf/drone_bay)
"aY" = (/obj/structure/cable{d2 = 8; icon_state = "0-8"},/obj/machinery/power/apc{cell_type = 2500; dir = 1; name = "Mining Drone Bay APC"; pixel_y = 24},/turf/simulated/floor/plasteel{dir = 1; icon_state = "warning"},/area/ruin/onehalf/drone_bay)
"aZ" = (/obj/structure/disposalpipe/segment,/turf/simulated/floor/plasteel{dir = 1; icon_state = "warning"},/area/ruin/onehalf/drone_bay)
"ba" = (/obj/machinery/button/door{id = "onehalf_drone2int"; name = "Drone 2 Internal Hatch Override"; pixel_x = 8; pixel_y = 27},/obj/machinery/button/door{id = "onehalf_drone2ext"; name = "Drone 2 External Hatch Override"; pixel_x = 8; pixel_y = 37},/obj/machinery/button/door{id = "onehalf_drone1int"; name = "Drone 1 Internal Hatch Override"; pixel_x = -8; pixel_y = 27},/obj/machinery/button/door{id = "onehalf_drone1ext"; name = "Drone 1 External Hatch Override"; pixel_x = -8; pixel_y = 37},/turf/simulated/floor/plasteel{dir = 1; icon_state = "warning"},/area/ruin/onehalf/drone_bay)
"bb" = (/turf/simulated/floor/plasteel{dir = 1; icon_state = "warning"},/area/ruin/onehalf/drone_bay)
"bc" = (/obj/machinery/button/door{id = "onehalf_drone3int"; name = "Drone 3 Internal Hatch Override"; pixel_x = -8; pixel_y = 27},/obj/machinery/button/door{id = "onehalf_drone3ext"; name = "Drone 3 External Hatch Override"; pixel_x = -8; pixel_y = 37},/obj/machinery/button/door{id = "onehalf_drone4ext"; name = "Drone 4 External Hatch Override"; pixel_x = 8; pixel_y = 37},/obj/machinery/button/door{id = "onehalf_drone4int"; name = "Drone 4 Internal Hatch Override"; pixel_x = 8; pixel_y = 27},/turf/simulated/floor/plasteel{dir = 1; icon_state = "warning"},/area/ruin/onehalf/drone_bay)
"bd" = (/obj/structure/disposalpipe/segment,/turf/simulated/floor/plasteel{dir = 5; icon_state = "warning"},/area/ruin/onehalf/drone_bay)
"be" = (/obj/structure/grille,/obj/structure/window/reinforced/fulltile,/turf/simulated/floor/plating,/area/ruin/onehalf/drone_bay)
"bf" = (/obj/item/stack/sheet/metal,/turf/simulated/floor/plating/airless{broken = 1; icon_state = "platingdmg1"},/area/ruin/onehalf/hallway)
"bg" = (/obj/structure/disposalpipe/broken{tag = "icon-pipe-b (EAST)"; icon_state = "pipe-b"; dir = 4},/obj/item/stack/cable_coil/cut{amount = 2; dir = 2; icon_state = "coil_red2"},/turf/simulated/floor/plating/airless{broken = 1; icon_state = "platingdmg2"},/area/ruin/onehalf/hallway)
"bh" = (/obj/structure/disposalpipe/segment{dir = 4},/obj/structure/cable{d1 = 4; d2 = 8; icon_state = "4-8"},/obj/structure/cable{d1 = 1; d2 = 4; icon_state = "1-4"},/turf/simulated/floor/plasteel/airless{icon_state = "damaged3"},/area/ruin/onehalf/hallway)
"bi" = (/obj/structure/disposalpipe/segment{dir = 4},/obj/structure/cable{d1 = 4; d2 = 8; icon_state = "4-8"},/turf/simulated/floor/plasteel/airless{icon_state = "damaged5"},/area/ruin/onehalf/hallway)
"bj" = (/obj/structure/disposalpipe/segment{dir = 4},/obj/structure/cable{d1 = 4; d2 = 8; icon_state = "4-8"},/turf/simulated/floor/plasteel/airless,/area/ruin/onehalf/hallway)
"bk" = (/obj/structure/disposalpipe/junction{icon_state = "pipe-j1"; dir = 4},/obj/structure/cable{d1 = 1; d2 = 4; icon_state = "1-4"},/obj/structure/cable{d1 = 4; d2 = 8; icon_state = "4-8"},/turf/simulated/floor/plasteel/airless{icon_state = "damaged1"},/area/ruin/onehalf/hallway)
"bl" = (/obj/structure/disposalpipe/segment{dir = 4},/obj/structure/cable{d1 = 4; d2 = 8; icon_state = "4-8"},/obj/structure/cable{d1 = 2; d2 = 8; icon_state = "2-8"},/turf/simulated/floor/plasteel/airless,/area/ruin/onehalf/hallway)
"bm" = (/obj/structure/disposalpipe/junction{icon_state = "pipe-j1"; dir = 4},/obj/structure/cable{d1 = 4; d2 = 8; icon_state = "4-8"},/turf/simulated/floor/plasteel/airless,/area/ruin/onehalf/hallway)
"bn" = (/obj/structure/disposalpipe/segment{dir = 4},/obj/machinery/door/airlock/glass,/obj/structure/cable{d1 = 4; d2 = 8; icon_state = "4-8"},/turf/simulated/floor/plasteel,/area/ruin/onehalf/drone_bay)
"bo" = (/obj/structure/disposalpipe/segment{dir = 4},/obj/structure/cable{d1 = 1; d2 = 8; icon_state = "1-8"},/turf/simulated/floor/plasteel,/area/ruin/onehalf/drone_bay)
"bp" = (/obj/structure/disposalpipe/segment{dir = 4},/turf/simulated/floor/plasteel,/area/ruin/onehalf/drone_bay)
"bq" = (/obj/structure/disposalpipe/segment{dir = 4},/obj/structure/disposalpipe/segment,/turf/simulated/floor/plasteel,/area/ruin/onehalf/drone_bay)
"br" = (/obj/structure/disposalpipe/segment{dir = 4},/obj/machinery/door/airlock/maintenance_hatch,/turf/simulated/floor/plasteel,/area/ruin/onehalf/drone_bay)
"bs" = (/obj/structure/disposalpipe/segment{dir = 4},/obj/machinery/light/small{dir = 1},/turf/simulated/floor/plasteel{icon_state = "floorgrime"},/area/ruin/onehalf/drone_bay)
"bt" = (/obj/structure/disposalpipe/junction{icon_state = "pipe-y"; dir = 1},/turf/simulated/floor/plasteel{icon_state = "floorgrime"},/area/ruin/onehalf/drone_bay)
"bu" = (/obj/structure/disposalpipe/trunk{dir = 8},/obj/machinery/disposal/bin,/turf/simulated/floor/plating,/area/ruin/onehalf/drone_bay)
"bv" = (/obj/structure/disposalpipe/broken{tag = "icon-pipe-b (EAST)"; icon_state = "pipe-b"; dir = 4},/turf/simulated/floor/plating/airless{icon_state = "platingdmg3"},/area/ruin/onehalf/hallway)
"bw" = (/obj/structure/disposalpipe/segment{dir = 4},/turf/simulated/floor/plasteel/airless{icon_state = "damaged3"},/area/ruin/onehalf/hallway)
"bx" = (/obj/structure/disposalpipe/segment{dir = 4},/turf/simulated/floor/plasteel/airless,/area/ruin/onehalf/hallway)
"by" = (/obj/structure/disposalpipe/segment,/obj/structure/disposalpipe/segment{dir = 4},/turf/simulated/floor/plasteel/airless{icon_state = "damaged1"},/area/ruin/onehalf/hallway)
"bz" = (/obj/structure/disposalpipe/segment{dir = 4},/obj/structure/cable,/obj/machinery/power/apc{dir = 2; name = "Hallway APC"; pixel_y = -24},/turf/simulated/floor/plasteel/airless,/area/ruin/onehalf/hallway)
"bA" = (/obj/structure/disposalpipe/segment{dir = 4},/turf/simulated/floor/plasteel/airless{icon_state = "damaged4"},/area/ruin/onehalf/hallway)
"bB" = (/obj/structure/disposalpipe/segment,/obj/structure/disposalpipe/segment{dir = 4},/turf/simulated/floor/plasteel/airless,/area/ruin/onehalf/hallway)
"bC" = (/obj/machinery/door/airlock/glass,/obj/structure/disposalpipe/segment{dir = 4},/turf/simulated/floor/plasteel,/area/ruin/onehalf/drone_bay)
"bD" = (/obj/structure/disposalpipe/junction{dir = 8; icon_state = "pipe-j1"},/turf/simulated/floor/plasteel,/area/ruin/onehalf/drone_bay)
"bE" = (/obj/structure/disposalpipe/segment{dir = 4},/obj/machinery/light,/turf/simulated/floor/plasteel,/area/ruin/onehalf/drone_bay)
"bF" = (/obj/structure/disposalpipe/segment{dir = 8; icon_state = "pipe-c"},/turf/simulated/floor/plasteel,/area/ruin/onehalf/drone_bay)
"bG" = (/turf/simulated/floor/plasteel,/area/ruin/onehalf/drone_bay)
"bH" = (/obj/machinery/portable_atmospherics/canister/oxygen,/turf/simulated/floor/plasteel{icon_state = "floorgrime"},/area/ruin/onehalf/drone_bay)
"bI" = (/turf/simulated/floor/plasteel{icon_state = "floorgrime"},/area/ruin/onehalf/drone_bay)
"bJ" = (/obj/structure/chair/office{tag = "icon-chair (EAST)"; icon_state = "chair"; dir = 4},/turf/simulated/floor/plasteel{icon_state = "floorgrime"},/area/ruin/onehalf/drone_bay)
"bK" = (/obj/structure/girder,/turf/simulated/floor/plating/airless,/area/ruin/onehalf/hallway)
"bL" = (/obj/structure/closet/emcloset,/turf/simulated/floor/plasteel/airless{icon_state = "damaged4"},/area/ruin/onehalf/hallway)
"bM" = (/obj/machinery/vending/coffee,/turf/simulated/floor/plasteel/airless{icon_state = "damaged4"},/area/ruin/onehalf/hallway)
"bN" = (/obj/machinery/vending/snack,/turf/simulated/floor/plasteel/airless{icon_state = "damaged2"},/area/ruin/onehalf/hallway)
"bO" = (/obj/structure/disposalpipe/trunk{dir = 1},/obj/machinery/disposal/bin,/turf/simulated/floor/plasteel/airless,/area/ruin/onehalf/hallway)
"bP" = (/obj/structure/girder/reinforced,/obj/item/stack/sheet/plasteel,/turf/simulated/floor/plating/airless,/area/ruin/onehalf/hallway)
"bQ" = (/obj/structure/girder/reinforced,/turf/simulated/floor/plating/airless,/area/ruin/onehalf/hallway)
"bR" = (/turf/simulated/wall/r_wall,/area/ruin/onehalf/hallway)
"bS" = (/turf/simulated/floor/plasteel/airless{icon_state = "damaged2"},/area/ruin/onehalf/hallway)
"bT" = (/obj/structure/disposalpipe/segment,/turf/simulated/floor/plasteel/airless,/area/ruin/onehalf/hallway)
"bU" = (/turf/simulated/wall/r_wall,/area/ruin/onehalf/bridge)
"bV" = (/obj/item/stack/sheet/metal,/turf/space,/area/space)
"bW" = (/turf/simulated/floor/plating/airless{broken = 1; icon_state = "platingdmg1"},/area/ruin/onehalf/hallway)
"bX" = (/obj/structure/disposalpipe/segment,/obj/item/stack/rods,/turf/simulated/floor/plasteel/airless{icon_state = "damaged5"},/area/ruin/onehalf/hallway)
"bY" = (/obj/structure/grille,/turf/simulated/floor/plating/airless,/area/ruin/onehalf/hallway)
"bZ" = (/obj/structure/grille,/obj/structure/window/reinforced/fulltile,/obj/machinery/door/poddoor/preopen{id = "bridge_onehalf"; name = "bridge blast door"},/turf/simulated/floor/plating,/area/ruin/onehalf/bridge)
"ca" = (/obj/structure/table/reinforced,/obj/item/device/flashlight/lamp,/turf/simulated/floor/plasteel,/area/ruin/onehalf/bridge)
"cb" = (/obj/structure/table/reinforced,/obj/item/weapon/paper,/obj/item/weapon/pen,/turf/simulated/floor/plasteel,/area/ruin/onehalf/bridge)
"cc" = (/obj/structure/closet/emcloset,/turf/simulated/floor/plasteel,/area/ruin/onehalf/bridge)
"cd" = (/obj/machinery/light{dir = 1},/obj/structure/frame/computer,/turf/simulated/floor/plasteel,/area/ruin/onehalf/bridge)
"ce" = (/obj/structure/frame/computer,/turf/simulated/floor/plasteel,/area/ruin/onehalf/bridge)
"cf" = (/obj/structure/cable{icon_state = "0-4"; d2 = 4},/obj/machinery/power/apc{cell_type = 2500; dir = 1; name = "Bridge APC"; pixel_y = 24},/turf/simulated/floor/plasteel,/area/ruin/onehalf/bridge)
"cg" = (/obj/structure/cable{d1 = 2; d2 = 8; icon_state = "2-8"},/obj/structure/table/reinforced,/obj/item/stack/spacecash/c500{pixel_y = 8},/obj/item/stack/spacecash/c1000,/turf/simulated/floor/plasteel,/area/ruin/onehalf/bridge)
"ch" = (/obj/structure/girder/reinforced,/turf/simulated/floor/plating/airless,/area/space)
"ci" = (/obj/structure/disposalpipe/junction{tag = "icon-pipe-j1 (NORTH)"; icon_state = "pipe-j1"; dir = 1},/obj/item/weapon/shard,/turf/simulated/floor/plating/airless{broken = 1; icon_state = "platingdmg2"},/area/ruin/onehalf/hallway)
"cj" = (/obj/structure/lattice,/obj/structure/disposalpipe/broken{tag = "icon-pipe-b (EAST)"; icon_state = "pipe-b"; dir = 4},/obj/structure/disposalpipe/broken{tag = "icon-pipe-b (WEST)"; icon_state = "pipe-b"; dir = 8},/obj/item/stack/rods,/turf/space,/area/ruin/onehalf/hallway)
"ck" = (/obj/structure/lattice,/obj/structure/disposalpipe/segment{dir = 4},/obj/item/weapon/shard{icon_state = "small"},/turf/space,/area/space)
"cl" = (/obj/structure/grille,/obj/structure/window/reinforced/fulltile,/obj/structure/disposalpipe/segment{dir = 4},/obj/machinery/door/poddoor/preopen{id = "bridge_onehalf"; name = "bridge blast door"},/turf/simulated/floor/plating,/area/ruin/onehalf/bridge)
"cm" = (/obj/structure/disposalpipe/segment{dir = 2; icon_state = "pipe-c"},/obj/structure/table/reinforced,/obj/item/weapon/paper_bin{amount = 12},/turf/simulated/floor/plasteel,/area/ruin/onehalf/bridge)
"cn" = (/obj/structure/chair/office{dir = 8},/turf/simulated/floor/plasteel,/area/ruin/onehalf/bridge)
"co" = (/turf/simulated/floor/plasteel,/area/ruin/onehalf/bridge)
"cp" = (/obj/structure/chair/office{tag = "icon-chair (NORTH)"; icon_state = "chair"; dir = 1},/turf/simulated/floor/plasteel,/area/ruin/onehalf/bridge)
"cq" = (/obj/structure/cable{d1 = 1; d2 = 4; icon_state = "1-4"},/obj/structure/cable{d1 = 2; d2 = 4; icon_state = "2-4"},/obj/structure/table/reinforced,/obj/item/weapon/lighter,/turf/simulated/floor/plasteel,/area/ruin/onehalf/bridge)
"cr" = (/obj/structure/grille,/obj/structure/window/reinforced/fulltile,/obj/structure/cable{icon_state = "0-4"; d2 = 4},/obj/structure/cable{icon_state = "0-2"; pixel_y = 1; d2 = 2},/obj/structure/cable{d2 = 8; icon_state = "0-8"},/obj/machinery/door/poddoor/preopen{id = "bridge_onehalf"; name = "bridge blast door"},/turf/simulated/floor/plating,/area/ruin/onehalf/bridge)
"cs" = (/obj/item/stack/rods,/turf/space,/area/space)
"ct" = (/turf/simulated/floor/plating/airless,/area/space)
"cu" = (/obj/item/stack/sheet/plasteel{amount = 10},/obj/structure/lattice,/turf/space,/area/space)
"cv" = (/obj/structure/lattice,/obj/item/weapon/shard{icon_state = "medium"},/turf/space,/area/ruin/onehalf/hallway)
"cw" = (/obj/structure/disposalpipe/segment,/turf/simulated/floor/plasteel/airless{icon_state = "damaged5"},/area/ruin/onehalf/hallway)
"cx" = (/obj/structure/girder/reinforced,/turf/simulated/floor/plating/airless,/area/ruin/onehalf/bridge)
"cy" = (/obj/structure/disposalpipe/trunk{dir = 1},/obj/machinery/disposal/bin,/turf/simulated/floor/plasteel,/area/ruin/onehalf/bridge)
"cz" = (/obj/item/stack/tile/plasteel,/turf/simulated/floor/plasteel,/area/ruin/onehalf/bridge)
"cA" = (/obj/machinery/power/solar_control,/obj/structure/cable,/turf/simulated/floor/plasteel,/area/ruin/onehalf/bridge)
"cB" = (/obj/structure/grille,/obj/structure/window/reinforced/fulltile,/obj/structure/cable,/obj/structure/cable{icon_state = "0-2"; pixel_y = 1; d2 = 2},/obj/machinery/door/poddoor/preopen{id = "bridge_onehalf"; name = "bridge blast door"},/turf/simulated/floor/plating,/area/ruin/onehalf/bridge)
"cC" = (/obj/item/stack/tile/wood,/turf/space,/area/space)
"cD" = (/turf/space,/area/ruin/onehalf/hallway)
"cE" = (/obj/structure/lattice,/obj/structure/cable{d1 = 2; d2 = 8; icon_state = "2-8"},/turf/space,/area/ruin/onehalf/hallway)
"cF" = (/obj/structure/lattice,/obj/structure/disposalpipe/broken{tag = "icon-pipe-b (WEST)"; icon_state = "pipe-b"; dir = 8},/obj/structure/disposalpipe/broken{tag = "icon-pipe-b (NORTH)"; icon_state = "pipe-b"; dir = 1},/turf/space,/area/ruin/onehalf/hallway)
"cG" = (/obj/machinery/door/airlock/glass_command{name = "Bridge"},/turf/simulated/floor/plasteel,/area/ruin/onehalf/bridge)
"cH" = (/obj/machinery/light/small,/turf/simulated/floor/plasteel,/area/ruin/onehalf/bridge)
"cI" = (/obj/machinery/door/poddoor/preopen{id = "bridge_onehalf"; name = "bridge blast door"},/obj/machinery/door/airlock/glass_command{name = "Bridge"},/turf/simulated/floor/plasteel,/area/ruin/onehalf/bridge)
"cJ" = (/obj/item/weapon/crowbar/red,/obj/item/device/multitool,/turf/simulated/floor/plating,/area/ruin/onehalf/bridge)
"cK" = (/obj/structure/safe/floor,/obj/item/weapon/tank/internals/oxygen/red,/obj/item/clothing/mask/gas/syndicate,/obj/item/clothing/suit/space/hardsuit/syndi,/obj/item/weapon/reagent_containers/food/drinks/bottle/rum,/obj/item/weapon/reagent_containers/food/drinks/bottle/rum,/obj/item/weapon/folder/syndicate/mining,/turf/simulated/floor/plating,/area/ruin/onehalf/bridge)
"cL" = (/obj/structure/chair/comfy/black{dir = 4},/turf/simulated/floor/plasteel,/area/ruin/onehalf/bridge)
"cM" = (/obj/structure/lattice,/obj/item/stack/cable_coil/cut{amount = 2; dir = 2; icon_state = "coil_red2"},/turf/space,/area/ruin/onehalf/hallway)
"cN" = (/turf/simulated/floor/plating/airless{broken = 1; icon_state = "platingdmg2"},/area/ruin/onehalf/hallway)
"cO" = (/obj/machinery/light{dir = 8},/obj/machinery/vending/sovietsoda,/turf/simulated/floor/plasteel,/area/ruin/onehalf/bridge)
"cP" = (/obj/item/stack/sheet/plasteel,/turf/space,/area/space)
"cQ" = (/obj/structure/lattice,/obj/structure/cable{d1 = 1; d2 = 2; icon_state = "1-2"},/turf/space,/area/ruin/onehalf/hallway)
"cR" = (/turf/simulated/floor/plasteel/airless{icon_state = "damaged3"},/area/ruin/onehalf/hallway)
"cS" = (/obj/structure/grille,/obj/structure/window/reinforced/fulltile,/turf/simulated/floor/plating,/area/ruin/onehalf/hallway)
"cT" = (/obj/structure/table/reinforced,/obj/machinery/recharger,/turf/simulated/floor/plasteel,/area/ruin/onehalf/bridge)
"cU" = (/obj/structure/chair/office,/turf/simulated/floor/plasteel,/area/ruin/onehalf/bridge)
"cV" = (/obj/machinery/button/door{id = "bridge_onehalf"; name = "Bridge Blast Door"; pixel_x = 32; pixel_y = 5},/turf/simulated/floor/plasteel,/area/ruin/onehalf/bridge)
"cW" = (/obj/structure/table/reinforced,/turf/simulated/floor/plasteel,/area/ruin/onehalf/bridge)
"cX" = (/obj/structure/grille,/obj/structure/window/reinforced/fulltile,/obj/structure/cable{icon_state = "0-4"; d2 = 4},/obj/structure/cable,/obj/machinery/door/poddoor/preopen{id = "bridge_onehalf"; name = "bridge blast door"},/turf/simulated/floor/plating,/area/ruin/onehalf/bridge)
"cY" = (/obj/structure/lattice,/obj/structure/cable{d1 = 1; d2 = 2; icon_state = "1-2"},/obj/structure/cable{d1 = 2; d2 = 8; icon_state = "2-8"},/turf/space,/area/space)
"cZ" = (/obj/structure/cable{d1 = 1; d2 = 2; icon_state = "1-2"},/turf/simulated/floor/plasteel/airless{icon_state = "damaged5"},/area/ruin/onehalf/hallway)
"da" = (/obj/structure/table/reinforced,/obj/item/device/flashlight,/turf/simulated/floor/plasteel,/area/ruin/onehalf/bridge)
"db" = (/obj/structure/table/reinforced,/obj/item/weapon/ore/bluespace_crystal,/obj/item/weapon/coin/plasma,/turf/simulated/floor/plasteel,/area/ruin/onehalf/bridge)
"dc" = (/obj/structure/closet/firecloset/full,/turf/simulated/floor/plasteel,/area/ruin/onehalf/bridge)
"dd" = (/obj/machinery/light,/obj/structure/table/reinforced,/obj/item/weapon/storage/firstaid/regular,/turf/simulated/floor/plasteel,/area/ruin/onehalf/bridge)
"de" = (/obj/structure/girder/reinforced,/obj/item/stack/sheet/plasteel,/turf/simulated/floor/plating/airless,/area/space)
"df" = (/turf/simulated/floor/plating/airless{broken = 1; icon_state = "platingdmg2"},/area/space)
"dg" = (/obj/structure/grille{density = 0; icon_state = "brokengrille"},/obj/structure/cable{d1 = 1; d2 = 2; icon_state = "1-2"},/turf/simulated/floor/plating/airless{broken = 1; icon_state = "platingdmg1"},/area/ruin/onehalf/hallway)
"dh" = (/obj/structure/grille,/obj/item/weapon/shard,/turf/simulated/floor/plating/airless{icon_state = "platingdmg3"},/area/ruin/onehalf/hallway)
"di" = (/obj/structure/grille,/obj/structure/window/reinforced/fulltile,/obj/structure/cable{icon_state = "0-2"; pixel_y = 1; d2 = 2},/obj/structure/cable{icon_state = "0-4"; d2 = 4},/obj/machinery/door/poddoor/preopen{id = "bridge_onehalf"; name = "bridge blast door"},/turf/simulated/floor/plating,/area/ruin/onehalf/bridge)
"dj" = (/obj/structure/grille,/obj/structure/window/reinforced/fulltile,/obj/structure/cable{icon_state = "0-4"; d2 = 4},/obj/structure/cable{d2 = 8; icon_state = "0-8"},/obj/machinery/door/poddoor/preopen{id = "bridge_onehalf"; name = "bridge blast door"},/turf/simulated/floor/plating,/area/ruin/onehalf/bridge)
"dk" = (/obj/structure/grille,/obj/structure/window/reinforced/fulltile,/obj/structure/cable{icon_state = "0-2"; pixel_y = 1; d2 = 2},/obj/structure/cable{d2 = 8; icon_state = "0-8"},/obj/machinery/door/poddoor/preopen{id = "bridge_onehalf"; name = "bridge blast door"},/turf/simulated/floor/plating,/area/ruin/onehalf/bridge)
"dl" = (/obj/structure/lattice,/obj/item/stack/sheet/plasteel,/turf/space,/area/space)
"dm" = (/obj/structure/lattice,/obj/structure/cable{d1 = 4; d2 = 8; icon_state = "4-8"},/obj/item/weapon/shard{icon_state = "medium"},/turf/space,/area/space)
"dn" = (/obj/structure/lattice,/obj/structure/cable{d1 = 4; d2 = 8; icon_state = "4-8"},/obj/structure/cable{d1 = 1; d2 = 4; icon_state = "1-4"},/obj/item/stack/rods,/turf/space,/area/space)
"do" = (/obj/structure/lattice,/obj/structure/cable{d1 = 1; d2 = 8; icon_state = "1-8"},/obj/structure/cable{d1 = 4; d2 = 8; icon_state = "4-8"},/turf/space,/area/space)
"dp" = (/obj/item/stack/cable_coil/cut{amount = 2; dir = 2; icon_state = "coil_red2"},/turf/space,/area/space)

(1,1,1) = {"
aaaaaaaaaaaaaaaaaaaaaaaaaaaaaaaaaaaaaaaaaaaaaaaaaaaaaaaaaaaaaaaa
aaaaaaaaaaaaabacacacacacacacacacadaaaaaaaaaaaaaaaaaaaaaaaaaaaaaa
aaaaaaaaaeacafagagagagagagahagagaiaaaaaaaaaaaaaaaaaaaaaaaaaaaaaa
aaaaaaajakakakagalamanagaoapaoagaqarasaratarauaravaraaaaaaaaaaaa
aaaaawaxaxayazagaAamaBagaCapaoagaDaraEaraFaraEaraEarawaraGaraaaa
aaaaaaaHaIaxaJagaKaLaMagaoapaoagaqaraNaraOaraParaQaraaaraRaraaaa
aaaaaSajaxaTaUagagaVagagagaWagagaXaYaZbaaZbbaZbcbdarararbeararaa
aaaaawbfbgbhbibjbjbkbibiblbjbmbnbobpbqbpbqbpbqbpbqbpbrbsbtbubeaa
aaaaaabvbwbwbxbxbwbybxbxbzbAbBbCbpbpbDbEbDbpbDbEbFbGarbHbIbJbeaa
aaaaaabKajakbLbMbNbObPbQbRbSbTbUbUbUbUbUbUbUbUbUbUbUararbeararaa
aaaaaaaabVbWbKakbQbRajawbRbWbXbYaabZcacbcccdcecfcgbUawaaaaaaaaaa
aaaaaaaaaaaaaaaachaaaabVaxaxcicjckclcmcncocpcococqcradaaaaaaaaaa
aaaaaaaaaaaaaacsctcuaaaaajcvcwcxbUbUcycoczcocococAcBaiaaaaaaaaaa
aaaaaaaaaaaaaaaaaaawcCaacDcEcFcGcHcIcoczcJcKcocLcecBaiaaaaaaaaaa
aaaaaaaaaaaaaaaaaaaacsawajcMcNbUbUbUcOcocococococecBaiaaaaaaaaaa
aaaaaaaaaaaaaaaaaaaacPcCaxcQcRcSawbZcTcncocUcocVcWcXcYaaaaaaaaaa
aaaaaaaaaaaaaaaaaacsaaaabRcZaJcSaabZdadbdccececoddbUaiaaaaaaaaaa
aaaaaaaaaaaaaaaaaadeawdfbQdgdhbUbUbUbUdidjdjdjdkbUbUaiaaaaaaaaaa
aaaaaaaaaaaaaaaaaaaaaadldmdnacacacacacdoacacacdoacacafaaaaaaaaaa
aaaaaaaaaaaaaaaaaaaadpaaaaaaaaaaaaaaaaaaaaaaaaaaaaaaaaaaaaaaaaaa
"}
