//MAP CONVERTED BY dmm2tgm.py THIS HEADER COMMENT PREVENTS RECONVERSION, DO NOT REMOVE
"a" = (
/turf/template_noop,
/area/awaycontent)
"b" = (
/obj/effect/decal/cleanable/blood/drip,
/turf/simulated/floor/plating/asteroid,
/area/ruin/powered)
"d" = (
/obj/item/holosign_creator/atmos,
/turf/simulated/floor/plating/asteroid,
/area/ruin/powered)
"e" = (
/obj/effect/decal/cleanable/blood/drip,
/obj/item/toy/russian_revolver,
/turf/simulated/floor/plating/asteroid,
/area/ruin/powered)
"i" = (
/obj/item/flashlight/lantern,
/turf/simulated/floor/plating/asteroid,
/area/ruin/powered)
"l" = (
/turf/simulated/floor/plating/asteroid,
/area/ruin/powered)
"o" = (
/obj/structure/inflatable/door,
/turf/simulated/floor/plating/asteroid/airless,
/area/ruin/powered)
"p" = (
/obj/structure/chair/office,
/obj/item/restraints/handcuffs/cable/zipties/used,
/obj/effect/decal/cleanable/blood/drip,
/obj/effect/decal/cleanable/blood/old,
/turf/simulated/floor/plating/asteroid,
/area/ruin/powered)
"v" = (
/turf/simulated/mineral,
/area/ruin/powered)
"y" = (
/obj/item/clothing/shoes/workboots,
/turf/simulated/floor/plating/asteroid/airless,
/area/ruin/powered)
"B" = (
/obj/item/storage/briefcase/inflatable,
/turf/simulated/floor/plating/asteroid,
/area/ruin/powered)
"E" = (
/obj/item/extinguisher/mini,
/turf/simulated/floor/plating/asteroid,
/area/ruin/powered)
"F" = (
/obj/structure/table/tray,
/obj/item/hemostat,
/obj/item/circular_saw{
	pixel_y = 6
	},
/turf/simulated/floor/plating/asteroid,
/area/ruin/powered)
"J" = (
/obj/item/paper{
	info = "So, you decided to not listen what dangerous men say to you Atmos Technician. Now you will stay here forever with your stupid toys you love so much! By the way, I left a present for you. See if you have same strenght as you had before to ignore our warnings. Have fun"
	},
/turf/simulated/floor/plating/asteroid,
/area/ruin/powered)
"L" = (
/obj/effect/decal/remains/human{
	desc = "They look like human remains. You see two large holes in the skull. Seems the guy shot himself.";
	name = "Human remains"
	},
/obj/effect/decal/cleanable/blood,
/turf/simulated/floor/plating/asteroid,
/area/ruin/powered)
"M" = (
/turf/simulated/floor/plating/asteroid/airless,
/area/ruin/powered)
"O" = (
/obj/item/scalpel,
/turf/simulated/floor/plating/asteroid,
/area/ruin/powered)
"P" = (
/obj/item/clothing/under/rank/atmospheric_technician,
/turf/simulated/floor/plating/asteroid/airless,
/area/ruin/powered)
"T" = (
/mob/living/simple_animal/hostile/carp,
/turf/template_noop,
/area/awaycontent)
"V" = (
/mob/living/simple_animal/hostile/carp,
/turf/simulated/floor/plating/asteroid,
/area/ruin/powered)
"Z" = (
/obj/item/clothing/suit/storage/suragi_jacket/atmos,
/turf/simulated/floor/plating/asteroid/airless,
/area/ruin/powered)

(1,1,1) = {"
a
a
a
a
M
v
v
v
v
M
a
a
a
a
a
"}
(2,1,1) = {"
T
a
a
M
v
v
v
v
v
v
v
a
a
a
a
"}
(3,1,1) = {"
a
a
M
v
v
v
v
v
v
v
v
a
a
a
a
"}
(4,1,1) = {"
a
Z
M
M
v
v
v
v
v
v
v
v
M
M
T
"}
(5,1,1) = {"
M
v
v
M
P
M
v
v
v
v
v
v
v
v
M
"}
(6,1,1) = {"
v
v
v
v
v
o
v
v
v
v
v
v
v
v
v
"}
(7,1,1) = {"
v
v
v
v
v
b
l
V
v
v
v
v
v
v
v
"}
(8,1,1) = {"
v
v
v
v
B
J
d
e
i
v
v
v
v
v
v
"}
(9,1,1) = {"
v
v
v
v
l
p
b
L
l
v
v
v
v
v
v
"}
(10,1,1) = {"
v
v
v
v
l
F
l
l
l
o
M
M
v
v
M
"}
(11,1,1) = {"
v
v
M
o
l
E
O
v
v
v
v
M
M
M
a
"}
(12,1,1) = {"
v
v
M
v
v
v
v
v
v
v
v
v
M
a
a
"}
(13,1,1) = {"
M
M
M
v
v
v
v
v
v
v
v
v
a
a
a
"}
(14,1,1) = {"
a
M
v
v
v
v
v
v
v
v
v
M
a
a
a
"}
(15,1,1) = {"
a
y
v
v
v
v
v
v
v
M
a
a
a
a
a
"}
(16,1,1) = {"
a
a
a
a
M
v
v
a
a
a
a
a
a
a
a
"}
