//MAP CONVERTED BY dmm2tgm.py THIS HEADER COMMENT PREVENTS RECONVERSION, DO NOT REMOVE
"a" = (
/obj/structure/fans/tiny,
/obj/machinery/door/poddoor/preopen{
	id_tag = "main cargo door";
	name = "Loading Door"
	},
/turf/simulated/floor/plating,
/area/ruin/space/unpowered)
"b" = (
/obj/effect/turf_decal/stripes/line,
/obj/effect/mapping_helpers/turfs/damage,
/turf/simulated/floor/plasteel/dark,
/area/ruin/space/unpowered)
"c" = (
/obj/structure/machine_frame,
/turf/simulated/floor/bluegrid,
/area/ruin/space/unpowered)
"d" = (
/obj/machinery/light,
/obj/structure/cable{
	icon_state = "1-8"
	},
/obj/effect/turf_decal/tiles/department/engineering/corner{
	dir = 1
	},
/turf/simulated/floor/plasteel/dark,
/area/ruin/space/unpowered)
"e" = (
/obj/structure/chair/comfy/shuttle{
	dir = 4
	},
/obj/structure/cable{
	icon_state = "0-2"
	},
/obj/machinery/power/apc/important/directional/north,
/turf/simulated/floor/mineral/plastitanium,
/area/ruin/space/unpowered)
"f" = (
/turf/template_noop,
/area/template_noop)
"g" = (
/obj/machinery/power/smes/engineering,
/obj/structure/cable{
	icon_state = "0-4"
	},
/turf/simulated/floor/plasteel/dark,
/area/ruin/space/unpowered)
"h" = (
/obj/effect/turf_decal/stripes/line,
/turf/simulated/floor/plasteel/dark,
/area/ruin/space/unpowered)
"j" = (
/obj/effect/turf_decal/tiles/department/science/side,
/turf/simulated/floor/plasteel/dark,
/area/ruin/space/unpowered)
"k" = (
/obj/structure/cable{
	icon_state = "1-8"
	},
/obj/effect/turf_decal/stripes/line{
	dir = 8
	},
/turf/simulated/floor/mineral/plastitanium,
/area/ruin/space/unpowered)
"l" = (
/obj/structure/cable{
	icon_state = "2-4"
	},
/obj/effect/turf_decal/tiles/department/science/side{
	dir = 8
	},
/turf/simulated/floor/plasteel/dark,
/area/ruin/space/unpowered)
"n" = (
/obj/machinery/optable,
/obj/effect/mapping_helpers/turfs/damage,
/obj/effect/turf_decal/tiles/department/command/side{
	dir = 6
	},
/turf/simulated/floor/plasteel/dark,
/area/ruin/space/unpowered)
"o" = (
/obj/structure/sign/electricshock{
	pixel_x = -32
	},
/turf/simulated/wall/mineral/plastitanium/nodiagonal,
/area/ruin/space/unpowered)
"q" = (
/obj/machinery/computer/nonfunctional{
	dir = 8
	},
/turf/simulated/floor/mineral/plastitanium,
/area/ruin/space/unpowered)
"r" = (
/obj/machinery/light{
	dir = 1;
	on = 1
	},
/obj/effect/turf_decal/tiles/department/engineering/corner,
/turf/simulated/floor/plasteel/dark,
/area/ruin/space/unpowered)
"s" = (
/obj/effect/mapping_helpers/turfs/damage,
/turf/simulated/floor/mineral/plastitanium,
/area/ruin/space/unpowered)
"u" = (
/obj/structure/shuttle/engine/heater{
	dir = 8
	},
/obj/structure/window/reinforced/survival_pod{
	dir = 4
	},
/obj/structure/window/reinforced/survival_pod,
/turf/simulated/floor/plating/airless,
/area/ruin/space/unpowered)
"v" = (
/obj/structure/statue/diamond/captain,
/obj/structure/window/reinforced{
	dir = 4
	},
/turf/simulated/floor/plasteel/dark,
/area/ruin/space/unpowered)
"w" = (
/obj/structure/railing{
	dir = 1
	},
/obj/machinery/iv_drip,
/obj/effect/turf_decal/tiles/department/command/side{
	dir = 5
	},
/turf/simulated/floor/plasteel/dark,
/area/ruin/space/unpowered)
"x" = (
/obj/structure/railing{
	dir = 8
	},
/obj/structure/table/glass/reinforced/plastitanium,
/obj/machinery/turretid/lethal{
	locked = 0
	},
/turf/simulated/floor/mineral/plastitanium,
/area/ruin/space/unpowered)
"z" = (
/obj/structure/shuttle/engine/heater{
	dir = 8
	},
/obj/structure/window/reinforced/survival_pod{
	dir = 4
	},
/obj/structure/window/reinforced/survival_pod{
	dir = 1
	},
/turf/simulated/floor/plating/airless,
/area/ruin/space/unpowered)
"A" = (
/obj/structure/cable/yellow{
	icon_state = "0-2"
	},
/obj/machinery/power/port_gen/pacman,
/obj/item/stack/sheet/mineral/plasma/ten,
/turf/simulated/floor/plasteel/dark,
/area/ruin/space/unpowered)
"B" = (
/turf/simulated/wall/mineral/plastitanium/nodiagonal,
/area/ruin/space/unpowered)
"C" = (
/obj/structure/railing{
	dir = 10
	},
/obj/structure/table/glass/reinforced/plastitanium,
/obj/machinery/door_control{
	id = "main cargo doors";
	name = "Loading Doors Control"
	},
/obj/item/reagent_containers/drinks/coffee{
	pixel_x = 11;
	pixel_y = 18
	},
/obj/item/newspaper{
	pixel_x = -7;
	pixel_y = 11
	},
/turf/simulated/floor/mineral/plastitanium,
/area/ruin/space/unpowered)
"D" = (
/obj/machinery/light,
/obj/structure/cable{
	icon_state = "4-8"
	},
/obj/effect/turf_decal/tiles/department/engineering/corner{
	dir = 4
	},
/turf/simulated/floor/plasteel/dark,
/area/ruin/space/unpowered)
"E" = (
/obj/structure/cable{
	icon_state = "4-8"
	},
/turf/simulated/floor/plasteel/stairs{
	dir = 8
	},
/area/ruin/space/unpowered)
"F" = (
/obj/structure/cable{
	icon_state = "1-2"
	},
/turf/simulated/floor/mineral/plastitanium,
/area/ruin/space/unpowered)
"H" = (
/obj/machinery/light{
	dir = 1;
	on = 1
	},
/obj/effect/turf_decal/tiles/department/engineering/corner{
	dir = 8
	},
/turf/simulated/floor/plasteel/dark,
/area/ruin/space/unpowered)
"J" = (
/obj/machinery/power/terminal,
/obj/structure/cable/yellow,
/turf/simulated/floor/catwalk,
/area/ruin/space/unpowered)
"K" = (
/obj/structure/shelf/science,
/obj/item/circuitboard/tcomms/relay,
/obj/item/stock_parts/manipulator,
/obj/item/stock_parts/manipulator,
/obj/item/paper/tcommskey,
/obj/item/stack/cable_coil/ten,
/turf/simulated/floor/bluegrid,
/area/ruin/space/unpowered)
"L" = (
/obj/machinery/porta_turret,
/turf/simulated/wall/mineral/plastitanium/nodiagonal,
/area/ruin/space/unpowered)
"M" = (
/obj/machinery/suit_storage_unit/cmo/sec_storage/secure,
/obj/structure/railing{
	dir = 8
	},
/obj/effect/turf_decal/tiles/department/command/side{
	dir = 10
	},
/turf/simulated/floor/plasteel/dark,
/area/ruin/space/unpowered)
"N" = (
/obj/structure/shuttle/engine/propulsion{
	dir = 8
	},
/turf/simulated/floor/engine/airless,
/area/ruin/space/unpowered)
"O" = (
/obj/effect/spawner/window/plastitanium,
/turf/simulated/floor/plating,
/area/ruin/space/unpowered)
"P" = (
/obj/effect/turf_decal/stripes/line{
	dir = 1
	},
/turf/simulated/floor/plasteel/dark,
/area/ruin/space/unpowered)
"Q" = (
/obj/effect/turf_decal/tiles/department/command/side,
/turf/simulated/floor/plasteel/dark,
/area/ruin/space/unpowered)
"R" = (
/turf/simulated/wall/mineral/plastitanium,
/area/ruin/space/unpowered)
"U" = (
/obj/structure/cable{
	icon_state = "4-8"
	},
/obj/effect/turf_decal/tiles/department/science/side{
	dir = 1
	},
/turf/simulated/floor/plasteel/dark,
/area/ruin/space/unpowered)
"V" = (
/obj/effect/mapping_helpers/turfs/damage,
/obj/effect/turf_decal/tiles/department/science/side{
	dir = 4
	},
/turf/simulated/floor/plasteel/dark,
/area/ruin/space/unpowered)
"W" = (
/obj/effect/turf_decal/tiles/department/command/side{
	dir = 1
	},
/turf/simulated/floor/plasteel/dark,
/area/ruin/space/unpowered)
"Y" = (
/obj/structure/railing{
	dir = 9
	},
/obj/structure/closet/crate/medical,
/obj/item/storage/surgical_tray{
	pixel_x = 11;
	pixel_y = -5
	},
/obj/item/reagent_containers/glass/bottle/morphine{
	pixel_x = -5;
	pixel_y = -5
	},
/obj/item/storage/firstaid/adv{
	pixel_x = 12;
	pixel_y = -2
	},
/obj/item/storage/firstaid/regular{
	pixel_x = -3;
	pixel_y = 4
	},
/obj/effect/turf_decal/tiles/department/command/side{
	dir = 9
	},
/turf/simulated/floor/plasteel/dark,
/area/ruin/space/unpowered)
"Z" = (
/obj/effect/turf_decal/stripes/line{
	dir = 1
	},
/obj/effect/mapping_helpers/turfs/damage,
/turf/simulated/floor/plasteel/dark,
/area/ruin/space/unpowered)

(1,1,1) = {"
f
R
N
R
N
R
f
"}
(2,1,1) = {"
f
R
u
v
z
R
f
"}
(3,1,1) = {"
L
B
A
J
g
B
L
"}
(4,1,1) = {"
B
o
r
V
D
B
B
"}
(5,1,1) = {"
a
Z
j
c
U
h
a
"}
(6,1,1) = {"
a
P
j
K
U
b
a
"}
(7,1,1) = {"
B
R
H
l
d
R
B
"}
(8,1,1) = {"
R
x
C
E
Y
M
R
"}
(9,1,1) = {"
R
e
F
k
W
Q
R
"}
(10,1,1) = {"
R
q
q
s
w
n
R
"}
(11,1,1) = {"
L
O
O
O
R
R
L
"}
