//MAP CONVERTED BY dmm2tgm.py THIS HEADER COMMENT PREVENTS RECONVERSION, DO NOT REMOVE
"bh" = (
/obj/effect/decal/cleanable/dirt,
/obj/effect/turf_decal/tiles/department/command/side{
	dir = 1
	},
/turf/simulated/floor/plasteel/dark,
/area/ruin/space/derelict/teleporter)
"bk" = (
/obj/effect/decal/cleanable/dirt,
/obj/machinery/computer/teleporter,
/turf/simulated/floor/plasteel/dark,
/area/ruin/space/derelict/teleporter)
"dj" = (
/obj/effect/mapping_helpers/turfs/damage,
/obj/effect/spawner/random/pool/spaceloot/syndicate/mixed,
/turf/simulated/floor/plating/airless,
/area/space/nearstation)
"ds" = (
/turf/simulated/wall/mineral/titanium/nodiagonal,
/area/ruin/space/derelict/teleporter)
"dJ" = (
/obj/machinery/light,
/obj/effect/decal/cleanable/dirt,
/obj/effect/turf_decal/tiles/department/command/side{
	dir = 6
	},
/turf/simulated/floor/plasteel/dark,
/area/ruin/space/derelict/teleporter)
"eR" = (
/obj/machinery/light{
	dir = 1
	},
/obj/effect/decal/cleanable/dirt,
/obj/item/flag/ussp,
/obj/effect/turf_decal/tiles/department/command/side{
	dir = 9
	},
/turf/simulated/floor/plasteel/dark,
/area/ruin/space/derelict/teleporter)
"fX" = (
/obj/effect/decal/cleanable/dirt,
/obj/effect/turf_decal/tiles/department/command/side,
/turf/simulated/floor/plasteel/dark,
/area/ruin/space/derelict/teleporter)
"gr" = (
/obj/effect/decal/cleanable/dirt,
/obj/structure/table/reinforced,
/obj/item/clipboard,
/obj/item/paper/ussp_tele,
/obj/effect/turf_decal/tiles/department/command/side{
	dir = 10
	},
/turf/simulated/floor/plasteel/dark,
/area/ruin/space/derelict/teleporter)
"gA" = (
/obj/effect/decal/cleanable/dirt,
/obj/effect/turf_decal/stripes/line{
	dir = 1
	},
/obj/structure/chair/stool{
	dir = 1
	},
/turf/simulated/floor/plasteel/dark,
/area/ruin/space/derelict/teleporter)
"gE" = (
/obj/structure/lattice/catwalk,
/turf/template_noop,
/area/ruin/space/derelict/teleporter)
"hg" = (
/mob/living/basic/carp,
/turf/template_noop,
/area/template_noop)
"ic" = (
/obj/effect/turf_decal/stripes/line,
/obj/effect/mapping_helpers/turfs/burn,
/obj/machinery/light{
	dir = 8
	},
/turf/simulated/floor/plasteel/dark/airless,
/area/ruin/space/derelict/teleporter)
"iQ" = (
/obj/effect/decal/cleanable/dirt,
/obj/structure/table/reinforced,
/obj/machinery/cell_charger,
/obj/item/stock_parts/cell/high,
/obj/effect/turf_decal/tiles/department/command/side{
	dir = 8
	},
/turf/simulated/floor/plasteel/dark,
/area/ruin/space/derelict/teleporter)
"iS" = (
/obj/effect/spawner/airlock/w_to_e,
/turf/simulated/wall/mineral/titanium/nodiagonal,
/area/ruin/space/derelict/teleporter)
"kg" = (
/obj/machinery/power/apc/worn_out/directional/north,
/obj/structure/cable{
	icon_state = "0-8"
	},
/obj/item/flag/ussp,
/obj/effect/turf_decal/tiles/department/command/side{
	dir = 5
	},
/turf/simulated/floor/plasteel/dark,
/area/ruin/space/derelict/teleporter)
"kX" = (
/obj/structure/cable{
	icon_state = "4-8"
	},
/obj/structure/sign/poster/contraband/communist_state/directional/north,
/obj/effect/decal/cleanable/dirt,
/obj/effect/turf_decal/tiles/department/command/side{
	dir = 1
	},
/turf/simulated/floor/plasteel/dark,
/area/ruin/space/derelict/teleporter)
"mq" = (
/obj/effect/turf_decal/stripes/line{
	dir = 4
	},
/obj/effect/decal/cleanable/dirt,
/obj/structure/railing{
	dir = 4
	},
/turf/simulated/floor/plasteel/dark,
/area/ruin/space/derelict/teleporter)
"mY" = (
/obj/effect/mapping_helpers/turfs/burn,
/turf/simulated/floor/plasteel/dark/airless,
/area/ruin/space/derelict/teleporter)
"od" = (
/obj/machinery/door/airlock/command/glass{
	name = "experimental teleporter access"
	},
/obj/structure/cable{
	icon_state = "1-2"
	},
/obj/machinery/door/firedoor/closed,
/turf/simulated/floor/plasteel/dark,
/area/ruin/space/derelict/teleporter)
"og" = (
/obj/effect/turf_decal/stripes/line,
/obj/structure/cable{
	icon_state = "1-2"
	},
/obj/effect/mapping_helpers/turfs/burn,
/obj/effect/decal/remains/human,
/turf/simulated/floor/plasteel/dark/airless,
/area/ruin/space/derelict/teleporter)
"oy" = (
/obj/effect/decal/cleanable/dirt,
/obj/machinery/teleport/station,
/turf/simulated/floor/plasteel/dark,
/area/ruin/space/derelict/teleporter)
"oK" = (
/obj/machinery/atmospherics/unary/portables_connector{
	layer = 2
	},
/obj/machinery/atmospherics/portable/canister/air,
/obj/effect/turf_decal/delivery/hollow,
/obj/effect/turf_decal/tiles/department/command/side{
	dir = 5
	},
/turf/simulated/floor/plasteel/dark,
/area/ruin/space/derelict/teleporter)
"pD" = (
/obj/structure/cable{
	icon_state = "1-4"
	},
/obj/effect/decal/cleanable/dirt,
/turf/simulated/floor/plasteel/dark,
/area/ruin/space/derelict/teleporter)
"pZ" = (
/obj/effect/turf_decal/stripes/line,
/obj/effect/mapping_helpers/turfs/burn,
/turf/simulated/floor/plasteel/dark/airless,
/area/ruin/space/derelict/teleporter)
"qQ" = (
/turf/template_noop,
/area/template_noop)
"sY" = (
/obj/effect/turf_decal/stripes/corner{
	dir = 4
	},
/obj/effect/decal/cleanable/dirt,
/obj/structure/railing/cap/normal{
	dir = 1
	},
/obj/effect/turf_decal/tiles/department/command/corner{
	dir = 8
	},
/turf/simulated/floor/plasteel/dark,
/area/ruin/space/derelict/teleporter)
"tF" = (
/turf/simulated/floor/plating,
/area/ruin/space/derelict/teleporter)
"uD" = (
/obj/item/kirbyplants/large/dead{
	desc = "A dead potted plant. Must have died from lack of EVA equipment."
	},
/obj/effect/decal/cleanable/dirt,
/obj/effect/turf_decal/tiles/department/command/side{
	dir = 6
	},
/turf/simulated/floor/plasteel/dark,
/area/ruin/space/derelict/teleporter)
"vr" = (
/obj/effect/decal/cleanable/dirt,
/obj/effect/spawner/random/pool/spaceloot/syndicate/mixed,
/obj/effect/turf_decal/tiles/department/command/side{
	dir = 10
	},
/turf/simulated/floor/plasteel/dark,
/area/ruin/space/derelict/teleporter)
"vx" = (
/obj/structure/lattice,
/turf/template_noop,
/area/space/nearstation)
"vE" = (
/obj/effect/decal/cleanable/dirt,
/obj/effect/turf_decal/stripes/line{
	dir = 1
	},
/obj/item/storage/toolbox/mechanical{
	pixel_x = 6;
	pixel_y = 10
	},
/turf/simulated/floor/plasteel/dark,
/area/ruin/space/derelict/teleporter)
"vG" = (
/obj/effect/turf_decal/stripes/corner{
	dir = 1
	},
/obj/effect/decal/cleanable/dirt,
/obj/structure/railing/cap/reversed{
	dir = 1
	},
/obj/item/beacon,
/obj/effect/turf_decal/tiles/department/command/corner,
/turf/simulated/floor/plasteel/dark,
/area/ruin/space/derelict/teleporter)
"vT" = (
/obj/structure/lattice,
/obj/item/stack/cable_coil/cut{
	amount = 1
	},
/turf/template_noop,
/area/space/nearstation)
"vX" = (
/obj/effect/turf_decal/stripes/corner,
/obj/effect/decal/cleanable/dirt,
/obj/structure/railing/corner,
/obj/effect/turf_decal/tiles/department/command/corner{
	dir = 1
	},
/turf/simulated/floor/plasteel/dark,
/area/ruin/space/derelict/teleporter)
"wd" = (
/obj/structure/railing,
/obj/effect/turf_decal/stripes/line,
/obj/effect/decal/cleanable/dirt,
/turf/simulated/floor/plasteel/dark,
/area/ruin/space/derelict/teleporter)
"wh" = (
/obj/structure/railing,
/obj/effect/turf_decal/stripes/line,
/obj/effect/turf_decal/caution/stand_clear{
	dir = 1
	},
/obj/effect/decal/cleanable/dirt,
/turf/simulated/floor/plasteel/dark,
/area/ruin/space/derelict/teleporter)
"wj" = (
/obj/effect/spawner/window/shuttle,
/turf/simulated/floor/plating,
/area/ruin/space/derelict/teleporter)
"Aj" = (
/obj/effect/turf_decal/stripes/corner{
	dir = 8
	},
/obj/effect/decal/cleanable/dirt,
/obj/structure/railing/corner{
	dir = 8
	},
/obj/effect/turf_decal/tiles/department/command/corner{
	dir = 4
	},
/turf/simulated/floor/plasteel/dark,
/area/ruin/space/derelict/teleporter)
"Av" = (
/obj/effect/mapping_helpers/turfs/damage,
/turf/simulated/floor/plating/airless,
/area/ruin/space/derelict/teleporter)
"Dp" = (
/obj/machinery/light/small{
	dir = 1
	},
/turf/simulated/floor/plating,
/area/ruin/space/derelict/teleporter)
"DX" = (
/obj/machinery/atmospherics/pipe/simple/visible{
	dir = 5
	},
/obj/effect/decal/cleanable/dirt,
/turf/simulated/floor/plasteel/dark,
/area/ruin/space/derelict/teleporter)
"FQ" = (
/obj/effect/mapping_helpers/turfs/damage,
/obj/structure/grille/broken,
/obj/effect/decal/cleanable/glass,
/turf/simulated/floor/plating/airless,
/area/ruin/space/derelict/teleporter)
"HC" = (
/obj/effect/mapping_helpers/turfs/damage,
/obj/effect/decal/cleanable/glass,
/turf/simulated/floor/plating/airless,
/area/ruin/space/derelict/teleporter)
"HL" = (
/mob/living/basic/carp/megacarp,
/obj/effect/mapping_helpers/turfs/damage,
/turf/simulated/floor/plating/airless,
/area/ruin/space/derelict/teleporter)
"Io" = (
/obj/structure/sign/vacuum,
/turf/simulated/wall/mineral/titanium/nodiagonal,
/area/ruin/space/derelict/teleporter)
"NU" = (
/obj/effect/turf_decal/stripes/line{
	dir = 8
	},
/obj/structure/railing{
	dir = 8
	},
/obj/effect/decal/cleanable/dirt,
/turf/simulated/floor/plasteel/dark,
/area/ruin/space/derelict/teleporter)
"PS" = (
/turf/simulated/wall/mineral/titanium,
/area/ruin/space/derelict/teleporter)
"SQ" = (
/obj/effect/decal/cleanable/dirt,
/obj/effect/turf_decal/loading_area{
	dir = 1
	},
/turf/simulated/floor/plasteel/dark,
/area/ruin/space/derelict/teleporter)
"Um" = (
/obj/structure/cable{
	icon_state = "1-2"
	},
/obj/effect/mapping_helpers/turfs/damage,
/turf/simulated/floor/plasteel/dark/airless,
/area/ruin/space/derelict/teleporter)
"Vc" = (
/obj/machinery/teleport/hub,
/obj/effect/decal/cleanable/dirt,
/turf/simulated/floor/plasteel/dark,
/area/ruin/space/derelict/teleporter)
"Vu" = (
/obj/effect/mapping_helpers/turfs/damage,
/obj/structure/cable{
	icon_state = "0-2"
	},
/turf/simulated/floor/plating/airless,
/area/ruin/space/derelict/teleporter)
"We" = (
/obj/effect/decal/cleanable/dirt,
/obj/structure/shelf,
/obj/item/salvage/ruin/soviet,
/obj/item/stack/cable_coil,
/obj/item/salvage/ruin/soviet,
/obj/item/clothing/under/new_soviet,
/obj/item/storage/toolbox/electrical,
/obj/item/clothing/head/sovietsidecap,
/obj/effect/turf_decal/tiles/department/command/side{
	dir = 9
	},
/turf/simulated/floor/plasteel/dark,
/area/ruin/space/derelict/teleporter)
"Wu" = (
/obj/effect/spawner/window/shuttle,
/obj/effect/mapping_helpers/turfs/damage,
/turf/simulated/floor/plating/airless,
/area/ruin/space/derelict/teleporter)
"Zl" = (
/obj/effect/spawner/window/shuttle,
/turf/simulated/floor/plating/airless,
/area/ruin/space/derelict/teleporter)
"ZI" = (
/obj/structure/lattice,
/obj/item/shard{
	icon_state = "small"
	},
/turf/template_noop,
/area/space/nearstation)
"ZM" = (
/obj/item/shard,
/obj/structure/lattice,
/turf/template_noop,
/area/space/nearstation)
"ZN" = (
/obj/effect/mapping_helpers/turfs/damage,
/turf/simulated/floor/plasteel/dark/airless,
/area/ruin/space/derelict/teleporter)

(1,1,1) = {"
qQ
qQ
qQ
qQ
qQ
qQ
qQ
qQ
qQ
qQ
qQ
qQ
qQ
qQ
qQ
qQ
qQ
qQ
"}
(2,1,1) = {"
qQ
qQ
vx
qQ
qQ
qQ
qQ
qQ
qQ
qQ
qQ
PS
wj
wj
wj
PS
qQ
qQ
"}
(3,1,1) = {"
qQ
qQ
vx
vx
qQ
hg
qQ
qQ
qQ
qQ
PS
ds
We
iQ
gr
ds
PS
qQ
"}
(4,1,1) = {"
qQ
qQ
qQ
vx
ZI
HC
FQ
Wu
Zl
PS
ds
eR
vX
mq
sY
vr
ds
qQ
"}
(5,1,1) = {"
qQ
qQ
qQ
qQ
vT
vx
HL
ZN
mY
ic
ds
bh
wd
bk
gA
fX
wj
qQ
"}
(6,1,1) = {"
qQ
vx
vx
qQ
qQ
vx
Av
Vu
Um
og
od
pD
wh
oy
vE
fX
wj
qQ
"}
(7,1,1) = {"
qQ
qQ
vx
vT
dj
vx
ZM
Av
ZN
pZ
ds
kX
wd
Vc
SQ
fX
wj
qQ
"}
(8,1,1) = {"
qQ
qQ
qQ
qQ
vx
vx
vx
FQ
Wu
PS
ds
kg
Aj
NU
vG
dJ
ds
qQ
"}
(9,1,1) = {"
qQ
qQ
qQ
qQ
qQ
vx
vx
qQ
qQ
qQ
PS
ds
oK
DX
uD
ds
PS
qQ
"}
(10,1,1) = {"
qQ
qQ
qQ
qQ
qQ
vx
qQ
qQ
qQ
qQ
qQ
PS
Io
tF
iS
PS
qQ
qQ
"}
(11,1,1) = {"
qQ
qQ
qQ
qQ
qQ
qQ
qQ
qQ
qQ
qQ
qQ
qQ
PS
Dp
PS
qQ
qQ
qQ
"}
(12,1,1) = {"
qQ
qQ
qQ
qQ
qQ
qQ
hg
qQ
qQ
qQ
qQ
qQ
ds
tF
ds
qQ
qQ
qQ
"}
(13,1,1) = {"
qQ
qQ
qQ
qQ
qQ
qQ
qQ
qQ
qQ
qQ
qQ
qQ
gE
gE
gE
qQ
qQ
qQ
"}
(14,1,1) = {"
qQ
qQ
qQ
qQ
qQ
qQ
qQ
qQ
qQ
qQ
qQ
qQ
qQ
qQ
qQ
qQ
qQ
qQ
"}
(15,1,1) = {"
qQ
qQ
qQ
qQ
qQ
qQ
qQ
qQ
qQ
qQ
qQ
qQ
qQ
qQ
qQ
qQ
qQ
qQ
"}
(16,1,1) = {"
qQ
qQ
qQ
qQ
qQ
qQ
qQ
hg
qQ
qQ
qQ
qQ
qQ
qQ
qQ
qQ
qQ
qQ
"}
(17,1,1) = {"
qQ
qQ
qQ
qQ
qQ
qQ
qQ
qQ
qQ
qQ
qQ
qQ
qQ
qQ
qQ
qQ
hg
qQ
"}
(18,1,1) = {"
qQ
qQ
qQ
qQ
qQ
qQ
qQ
qQ
qQ
qQ
qQ
qQ
qQ
qQ
qQ
qQ
qQ
qQ
"}
