//MAP CONVERTED BY dmm2tgm.py THIS HEADER COMMENT PREVENTS RECONVERSION, DO NOT REMOVE
"bh" = (
/obj/effect/decal/cleanable/dirt,
/turf/simulated/floor/plasteel{
	dir = 1;
	icon_state = "darkblue"
	},
/area/ruin/space/derelict/teleporter)
"bk" = (
/obj/effect/decal/cleanable/dirt,
/obj/machinery/computer/teleporter,
/turf/simulated/floor/plasteel{
	icon_state = "dark"
	},
/area/ruin/space/derelict/teleporter)
"dj" = (
/obj/effect/landmark/damageturf,
/turf/simulated/floor/plating/airless,
/area/space/nearstation)
"ds" = (
/turf/simulated/wall/mineral/titanium/nodiagonal,
/area/ruin/space/derelict/teleporter)
"dJ" = (
/obj/machinery/light,
/obj/effect/decal/cleanable/dirt,
/turf/simulated/floor/plasteel{
	dir = 6;
	icon_state = "darkblue"
	},
/area/ruin/space/derelict/teleporter)
"eR" = (
/obj/machinery/light{
	dir = 1
	},
/obj/effect/decal/cleanable/dirt,
/obj/item/flag/ussp,
/turf/simulated/floor/plasteel{
	dir = 9;
	icon_state = "darkblue"
	},
/area/ruin/space/derelict/teleporter)
"fX" = (
/obj/effect/decal/cleanable/dirt,
/turf/simulated/floor/plasteel{
	icon_state = "darkblue"
	},
/area/ruin/space/derelict/teleporter)
"gr" = (
/obj/effect/decal/cleanable/dirt,
/obj/structure/table/reinforced,
/obj/item/clipboard,
/obj/item/paper/ussp_tele,
/turf/simulated/floor/plasteel{
	dir = 10;
	icon_state = "darkblue"
	},
/area/ruin/space/derelict/teleporter)
"gA" = (
/obj/effect/decal/cleanable/dirt,
/obj/effect/turf_decal/stripes/line{
	dir = 1
	},
/obj/structure/chair/stool{
	dir = 1
	},
/turf/simulated/floor/plasteel{
	icon_state = "dark"
	},
/area/ruin/space/derelict/teleporter)
"gE" = (
/turf/template_noop,
/area/template_noop)
"hg" = (
/obj/structure/lattice,
/obj/item/shard{
	icon_state = "small"
	},
/turf/template_noop,
/area/space/nearstation)
"ic" = (
/obj/effect/turf_decal/stripes/line,
/obj/effect/landmark/burnturf,
/obj/machinery/light{
	dir = 8
	},
/turf/simulated/floor/plasteel/airless{
	icon_state = "dark"
	},
/area/ruin/space/derelict/teleporter)
"iQ" = (
/obj/effect/decal/cleanable/dirt,
/obj/structure/table/reinforced,
/obj/machinery/cell_charger,
/obj/item/stock_parts/cell/high,
/turf/simulated/floor/plasteel{
	dir = 8;
	icon_state = "darkblue"
	},
/area/ruin/space/derelict/teleporter)
"iS" = (
/obj/effect/spawner/airlock/w_to_e,
/turf/simulated/wall/mineral/titanium/nodiagonal,
/area/ruin/space/derelict/teleporter)
"kg" = (
/obj/machinery/power/apc/worn_out/directional/north,
/obj/structure/cable{
	d2 = 8;
	icon_state = "0-8"
	},
/obj/item/flag/ussp,
/turf/simulated/floor/plasteel{
	dir = 5;
	icon_state = "darkblue"
	},
/area/ruin/space/derelict/teleporter)
"kX" = (
/obj/structure/cable{
	d1 = 4;
	d2 = 8;
	icon_state = "4-8"
	},
/obj/structure/sign/poster/contraband/communist_state{
	pixel_y = 32
	},
/obj/effect/decal/cleanable/dirt,
/turf/simulated/floor/plasteel{
	dir = 1;
	icon_state = "darkblue"
	},
/area/ruin/space/derelict/teleporter)
"mq" = (
/obj/effect/turf_decal/stripes/line{
	dir = 4
	},
/obj/effect/decal/cleanable/dirt,
/obj/structure/railing{
	dir = 4
	},
/turf/simulated/floor/plasteel{
	icon_state = "dark"
	},
/area/ruin/space/derelict/teleporter)
"mY" = (
/obj/effect/landmark/burnturf,
/turf/simulated/floor/plasteel/airless{
	icon_state = "dark"
	},
/area/ruin/space/derelict/teleporter)
"od" = (
/obj/machinery/door/airlock/command/glass{
	name = "experimental teleporter access"
	},
/obj/structure/cable{
	d1 = 1;
	d2 = 2;
	icon_state = "1-2"
	},
/obj/machinery/door/firedoor/closed,
/turf/simulated/floor/plasteel{
	icon_state = "dark"
	},
/area/ruin/space/derelict/teleporter)
"og" = (
/obj/effect/turf_decal/stripes/line,
/obj/structure/cable{
	d1 = 1;
	d2 = 2;
	icon_state = "1-2"
	},
/obj/effect/landmark/burnturf,
/obj/effect/decal/remains/human,
/turf/simulated/floor/plasteel/airless{
	icon_state = "dark"
	},
/area/ruin/space/derelict/teleporter)
"oy" = (
/obj/effect/decal/cleanable/dirt,
/obj/machinery/teleport/station,
/turf/simulated/floor/plasteel{
	icon_state = "dark"
	},
/area/ruin/space/derelict/teleporter)
"oK" = (
/obj/machinery/atmospherics/unary/portables_connector{
	layer = 2
	},
/obj/machinery/atmospherics/portable/canister/air,
/obj/effect/turf_decal/delivery/hollow,
/turf/simulated/floor/plasteel{
	dir = 5;
	icon_state = "darkblue"
	},
/area/ruin/space/derelict/teleporter)
"pD" = (
/obj/structure/cable{
	d1 = 1;
	d2 = 4;
	icon_state = "1-4"
	},
/obj/effect/decal/cleanable/dirt,
/turf/simulated/floor/plasteel{
	icon_state = "dark"
	},
/area/ruin/space/derelict/teleporter)
"pZ" = (
/obj/effect/turf_decal/stripes/line,
/obj/effect/landmark/burnturf,
/turf/simulated/floor/plasteel/airless{
	icon_state = "dark"
	},
/area/ruin/space/derelict/teleporter)
"qQ" = (
/obj/structure/lattice,
/obj/item/stack/cable_coil/cut{
	amount = 1
	},
/turf/template_noop,
/area/space/nearstation)
"sY" = (
/obj/effect/turf_decal/stripes/corner{
	dir = 4
	},
/obj/effect/decal/cleanable/dirt,
/obj/structure/railing/cap/normal{
	dir = 1
	},
/turf/simulated/floor/plasteel{
	dir = 8;
	icon_state = "darkbluecorners"
	},
/area/ruin/space/derelict/teleporter)
"tF" = (
/turf/simulated/floor/plating,
/area/ruin/space/derelict/teleporter)
"uD" = (
/obj/item/kirbyplants/dead{
	desc = "A dead potted plant. Must have died from lack of EVA equipment.";
	item_state = "plant-dead"
	},
/obj/effect/decal/cleanable/dirt,
/turf/simulated/floor/plasteel{
	dir = 6;
	icon_state = "darkblue"
	},
/area/ruin/space/derelict/teleporter)
"vr" = (
/obj/effect/decal/cleanable/dirt,
/turf/simulated/floor/plasteel{
	dir = 10;
	icon_state = "darkblue"
	},
/area/ruin/space/derelict/teleporter)
"vx" = (
/obj/structure/lattice,
/turf/template_noop,
/area/space/nearstation)
"vE" = (
/obj/effect/decal/cleanable/dirt,
/obj/effect/turf_decal/stripes/line{
	dir = 1
	},
/obj/item/storage/toolbox/mechanical{
	pixel_x = 6;
	pixel_y = 10
	},
/turf/simulated/floor/plasteel{
	icon_state = "dark"
	},
/area/ruin/space/derelict/teleporter)
"vG" = (
/obj/effect/turf_decal/stripes/corner{
	dir = 1
	},
/obj/effect/decal/cleanable/dirt,
/obj/structure/railing/cap/reversed{
	dir = 1
	},
/obj/item/beacon,
/turf/simulated/floor/plasteel{
	icon_state = "darkbluecorners"
	},
/area/ruin/space/derelict/teleporter)
"vT" = (
/obj/item/shard,
/obj/structure/lattice,
/turf/template_noop,
/area/space/nearstation)
"vX" = (
/obj/effect/turf_decal/stripes/corner,
/obj/effect/decal/cleanable/dirt,
/obj/structure/railing/corner,
/turf/simulated/floor/plasteel{
	dir = 1;
	icon_state = "darkbluecorners"
	},
/area/ruin/space/derelict/teleporter)
"wd" = (
/obj/structure/railing,
/obj/effect/turf_decal/stripes/line,
/obj/effect/decal/cleanable/dirt,
/turf/simulated/floor/plasteel{
	icon_state = "dark"
	},
/area/ruin/space/derelict/teleporter)
"wh" = (
/obj/structure/railing,
/obj/effect/turf_decal/stripes/line,
/obj/effect/turf_decal/caution/stand_clear{
	dir = 1
	},
/obj/effect/decal/cleanable/dirt,
/turf/simulated/floor/plasteel{
	icon_state = "dark"
	},
/area/ruin/space/derelict/teleporter)
"wj" = (
/obj/effect/spawner/window/shuttle,
/turf/simulated/floor/plating,
/area/ruin/space/derelict/teleporter)
"Aj" = (
/obj/effect/turf_decal/stripes/corner{
	dir = 8
	},
/obj/effect/decal/cleanable/dirt,
/obj/structure/railing/corner{
	dir = 8
	},
/turf/simulated/floor/plasteel{
	dir = 4;
	icon_state = "darkbluecorners"
	},
/area/ruin/space/derelict/teleporter)
"Av" = (
/obj/effect/landmark/damageturf,
/turf/simulated/floor/plating/airless,
/area/ruin/space/derelict/teleporter)
"Dp" = (
/obj/machinery/light/small{
	dir = 1
	},
/turf/simulated/floor/plating,
/area/ruin/space/derelict/teleporter)
"DX" = (
/obj/machinery/atmospherics/pipe/simple/visible{
	dir = 5
	},
/obj/effect/decal/cleanable/dirt,
/turf/simulated/floor/plasteel{
	icon_state = "dark"
	},
/area/ruin/space/derelict/teleporter)
"FQ" = (
/obj/effect/landmark/damageturf,
/obj/structure/grille/broken,
/obj/effect/decal/cleanable/glass,
/turf/simulated/floor/plating/airless,
/area/ruin/space/derelict/teleporter)
"HC" = (
/obj/effect/landmark/damageturf,
/obj/effect/decal/cleanable/glass,
/turf/simulated/floor/plating/airless,
/area/ruin/space/derelict/teleporter)
"HL" = (
/mob/living/simple_animal/hostile/carp/megacarp,
/obj/effect/landmark/damageturf,
/turf/simulated/floor/plating/airless,
/area/ruin/space/derelict/teleporter)
"Io" = (
/obj/structure/sign/vacuum,
/turf/simulated/wall/mineral/titanium/nodiagonal,
/area/ruin/space/derelict/teleporter)
"NU" = (
/obj/effect/turf_decal/stripes/line{
	dir = 8
	},
/obj/structure/railing{
	dir = 8
	},
/obj/effect/decal/cleanable/dirt,
/turf/simulated/floor/plasteel{
	icon_state = "dark"
	},
/area/ruin/space/derelict/teleporter)
"PS" = (
/turf/simulated/wall/mineral/titanium,
/area/ruin/space/derelict/teleporter)
"SQ" = (
/obj/effect/decal/cleanable/dirt,
/obj/effect/turf_decal/loading_area{
	dir = 1
	},
/turf/simulated/floor/plasteel{
	icon_state = "dark"
	},
/area/ruin/space/derelict/teleporter)
"Um" = (
/obj/structure/cable{
	d1 = 1;
	d2 = 2;
	icon_state = "1-2"
	},
/obj/effect/landmark/damageturf,
/turf/simulated/floor/plasteel/airless{
	icon_state = "dark"
	},
/area/ruin/space/derelict/teleporter)
"Vc" = (
/obj/machinery/teleport/hub,
/obj/effect/decal/cleanable/dirt,
/turf/simulated/floor/plasteel{
	icon_state = "dark"
	},
/area/ruin/space/derelict/teleporter)
"Vu" = (
/obj/effect/landmark/damageturf,
/obj/structure/cable{
	d2 = 2;
	icon_state = "0-2"
	},
/turf/simulated/floor/plating/airless,
/area/ruin/space/derelict/teleporter)
"We" = (
/obj/effect/decal/cleanable/dirt,
/obj/structure/shelf,
/obj/item/salvage/ruin/soviet,
/obj/item/stack/cable_coil,
/obj/item/salvage/ruin/soviet,
/obj/item/clothing/under/new_soviet,
/obj/item/storage/toolbox/electrical,
/obj/item/clothing/head/sovietsidecap,
/turf/simulated/floor/plasteel{
	dir = 9;
	icon_state = "darkblue"
	},
/area/ruin/space/derelict/teleporter)
"Wu" = (
/obj/effect/spawner/window/shuttle,
/obj/effect/landmark/damageturf,
/turf/simulated/floor/plating/airless,
/area/ruin/space/derelict/teleporter)
"Zl" = (
/obj/effect/spawner/window/shuttle,
/turf/simulated/floor/plating/airless,
/area/ruin/space/derelict/teleporter)
"ZI" = (
/mob/living/simple_animal/hostile/carp,
/turf/template_noop,
/area/template_noop)
"ZM" = (
/obj/structure/lattice/catwalk,
/turf/template_noop,
/area/ruin/space/derelict/teleporter)
"ZN" = (
/obj/effect/landmark/damageturf,
/turf/simulated/floor/plasteel/airless{
	icon_state = "dark"
	},
/area/ruin/space/derelict/teleporter)

(1,1,1) = {"
gE
vx
gE
gE
gE
gE
gE
gE
gE
gE
PS
wj
wj
wj
PS
gE
"}
(2,1,1) = {"
gE
vx
vx
gE
ZI
gE
gE
gE
gE
PS
ds
We
iQ
gr
ds
PS
"}
(3,1,1) = {"
gE
gE
vx
hg
HC
FQ
Wu
Zl
PS
ds
eR
vX
mq
sY
vr
ds
"}
(4,1,1) = {"
gE
gE
gE
qQ
vx
HL
ZN
mY
ic
ds
bh
wd
bk
gA
fX
wj
"}
(5,1,1) = {"
vx
vx
gE
gE
vx
Av
Vu
Um
og
od
pD
wh
oy
vE
fX
wj
"}
(6,1,1) = {"
gE
vx
qQ
dj
vx
vT
Av
ZN
pZ
ds
kX
wd
Vc
SQ
fX
wj
"}
(7,1,1) = {"
gE
gE
gE
vx
vx
vx
FQ
Wu
PS
ds
kg
Aj
NU
vG
dJ
ds
"}
(8,1,1) = {"
gE
gE
gE
gE
vx
vx
gE
gE
gE
PS
ds
oK
DX
uD
ds
PS
"}
(9,1,1) = {"
gE
gE
gE
gE
vx
gE
gE
gE
gE
gE
PS
Io
tF
iS
PS
gE
"}
(10,1,1) = {"
gE
gE
gE
gE
gE
gE
gE
gE
gE
gE
gE
PS
Dp
PS
gE
gE
"}
(11,1,1) = {"
gE
gE
gE
gE
gE
ZI
gE
gE
gE
gE
gE
ds
tF
ds
gE
gE
"}
(12,1,1) = {"
gE
gE
gE
gE
gE
gE
gE
gE
gE
gE
gE
ZM
ZM
ZM
gE
gE
"}
(13,1,1) = {"
gE
gE
gE
gE
gE
gE
gE
gE
gE
gE
gE
gE
gE
gE
gE
gE
"}
(14,1,1) = {"
gE
gE
gE
gE
gE
gE
gE
gE
gE
gE
gE
gE
gE
gE
gE
gE
"}
(15,1,1) = {"
gE
gE
gE
gE
gE
gE
ZI
gE
gE
gE
gE
gE
gE
gE
gE
gE
"}
(16,1,1) = {"
gE
gE
gE
gE
gE
gE
gE
gE
gE
gE
gE
gE
gE
gE
gE
ZI
"}
