//MAP CONVERTED BY dmm2tgm.py THIS HEADER COMMENT PREVENTS RECONVERSION, DO NOT REMOVE
"a" = (
/turf/template_noop,
/area/template_noop)
"b" = (
/turf/simulated/mineral/random/space,
/area/ruin/space/unpowered/no_grav/way_home)
"c" = (
/turf/simulated/floor/plating/asteroid/airless,
/area/ruin/space/unpowered/no_grav/way_home)
"d" = (
/obj/structure/signpost/ruin{
	name = "salvation"
	},
/turf/simulated/floor/plating/asteroid/airless,
/area/ruin/space/unpowered/no_grav/way_home)
"g" = (
/obj/structure/spawner/mining/hivelord/space,
/turf/simulated/floor/plating/asteroid/airless,
/area/ruin/space/unpowered/no_grav/way_home)
"n" = (
/turf/simulated/mineral/random/high_chance/clown,
/area/ruin/space/unpowered/no_grav/way_home)
"s" = (
/mob/living/basic/carp/megacarp,
/turf/template_noop,
/area/template_noop)
"z" = (
/obj/structure/spawner/mining/basilisk/space,
/turf/simulated/floor/plating/asteroid/airless,
/area/ruin/space/unpowered/no_grav/way_home)
"O" = (
/obj/item/salvage/ruin/tablet,
/turf/simulated/floor/plating/asteroid/airless,
/area/ruin/space/unpowered/no_grav/way_home)
"P" = (
/mob/living/basic/carp,
/turf/template_noop,
/area/template_noop)
"R" = (
/turf/simulated/mineral/random/high_chance/space,
/area/ruin/space/unpowered/no_grav/way_home)

(1,1,1) = {"
a
a
a
a
a
a
a
a
a
a
a
a
a
a
a
a
a
a
a
a
a
a
a
a
a
a
a
a
a
a
a
"}
(2,1,1) = {"
a
a
a
a
a
a
a
a
a
a
a
a
a
a
a
a
a
a
a
a
a
a
a
a
a
a
a
a
P
a
a
"}
(3,1,1) = {"
a
a
a
a
a
a
a
a
a
a
a
a
a
a
a
a
a
a
a
a
a
a
a
a
a
R
R
a
a
a
a
"}
(4,1,1) = {"
a
a
a
a
a
a
a
a
a
a
a
a
a
a
a
a
a
a
a
a
a
a
a
a
a
R
R
R
a
a
a
"}
(5,1,1) = {"
a
a
a
a
a
a
a
a
a
a
a
a
a
a
a
a
a
a
a
a
a
a
a
a
a
a
R
a
a
P
a
"}
(6,1,1) = {"
a
a
a
a
a
a
a
a
a
a
a
a
a
a
a
a
a
a
a
a
a
a
a
a
a
a
a
a
a
a
a
"}
(7,1,1) = {"
a
a
a
a
a
a
a
a
a
a
a
a
a
b
b
a
a
a
a
a
a
a
a
a
a
a
a
P
a
a
a
"}
(8,1,1) = {"
a
a
a
a
a
a
a
a
a
a
a
b
b
R
b
b
b
a
a
a
a
a
a
a
a
a
a
a
a
a
a
"}
(9,1,1) = {"
a
a
a
a
a
a
a
a
a
a
b
R
R
R
R
b
b
a
a
a
a
a
a
a
a
a
a
a
a
a
a
"}
(10,1,1) = {"
a
a
a
a
a
a
a
a
b
b
b
b
R
R
b
b
a
a
P
a
a
a
a
a
a
a
a
a
a
a
a
"}
(11,1,1) = {"
a
a
a
a
a
b
a
b
b
b
b
b
b
R
b
c
a
a
a
a
a
s
a
a
a
a
a
a
a
a
a
"}
(12,1,1) = {"
a
a
a
a
a
b
b
b
b
R
R
b
b
b
b
c
c
a
a
a
a
a
a
a
a
a
a
a
a
a
a
"}
(13,1,1) = {"
a
a
a
a
a
b
b
b
R
R
b
b
b
b
c
c
c
a
a
a
a
a
a
a
P
a
a
a
a
a
a
"}
(14,1,1) = {"
a
a
a
a
b
b
b
R
R
b
b
b
b
b
c
g
c
c
c
c
a
a
a
a
a
a
a
a
a
a
a
"}
(15,1,1) = {"
a
a
a
b
b
b
R
R
b
R
b
b
c
c
c
c
c
c
c
c
c
c
a
a
a
a
a
b
a
a
a
"}
(16,1,1) = {"
a
a
a
a
b
b
b
b
b
b
b
c
O
c
a
a
c
c
d
c
c
c
c
c
c
a
b
b
a
a
a
"}
(17,1,1) = {"
a
a
a
a
a
b
b
b
b
b
b
b
c
a
a
a
a
c
c
O
c
c
c
b
b
b
b
a
a
a
a
"}
(18,1,1) = {"
a
a
a
a
a
b
b
b
b
b
b
b
a
a
a
a
a
a
c
c
c
b
b
b
n
b
b
a
a
a
a
"}
(19,1,1) = {"
a
a
a
a
a
b
b
a
a
b
b
b
a
a
a
a
a
a
a
c
c
z
b
R
n
n
b
a
a
a
a
"}
(20,1,1) = {"
a
a
a
a
a
a
a
a
a
a
b
a
a
a
a
a
a
a
a
a
c
c
c
b
n
n
b
b
a
a
a
"}
(21,1,1) = {"
a
a
a
a
a
a
a
a
a
a
a
a
a
a
a
a
a
a
a
a
a
a
c
b
b
n
n
b
a
a
a
"}
(22,1,1) = {"
a
a
a
a
a
a
a
a
a
a
a
a
a
a
a
a
a
a
a
a
a
a
a
a
b
b
b
b
a
a
a
"}
(23,1,1) = {"
a
a
a
a
a
a
a
a
a
a
a
a
a
a
a
a
a
a
a
a
a
a
a
a
a
b
b
a
a
a
a
"}
(24,1,1) = {"
a
a
a
a
a
a
a
a
a
a
a
a
a
a
a
a
a
a
a
a
a
a
a
a
a
a
R
R
a
a
a
"}
(25,1,1) = {"
a
a
a
a
a
a
a
a
a
a
a
a
a
a
a
a
a
a
a
a
a
a
a
a
a
a
a
a
a
a
a
"}
(26,1,1) = {"
a
a
P
a
a
a
a
a
a
a
a
a
a
a
a
a
a
a
a
a
a
a
a
a
a
a
a
a
a
a
a
"}
(27,1,1) = {"
a
a
a
P
a
a
a
a
a
a
a
a
a
a
a
a
a
a
a
a
a
a
a
a
a
a
a
a
a
a
a
"}
(28,1,1) = {"
a
a
a
P
a
a
a
a
a
a
a
a
a
a
a
a
a
a
a
a
a
a
a
a
a
a
a
a
a
a
a
"}
(29,1,1) = {"
a
a
P
P
a
a
a
a
a
a
a
a
a
a
a
a
a
a
a
a
a
a
a
a
a
a
a
a
a
a
a
"}
(30,1,1) = {"
a
s
a
a
a
a
a
a
a
a
a
a
a
a
a
a
a
a
a
a
a
a
a
a
a
a
a
a
a
a
a
"}
(31,1,1) = {"
a
a
a
a
a
a
a
a
a
a
a
a
a
a
a
a
a
a
a
a
a
a
a
a
a
a
a
a
a
a
a
"}
