//MAP CONVERTED BY dmm2tgm.py THIS HEADER COMMENT PREVENTS RECONVERSION, DO NOT REMOVE
"a" = (
/turf/template_noop,
/area/template_noop)
"b" = (
/turf/simulated/mineral/random,
/area/ruin/space/unpowered/no_grav/way_home)
"c" = (
/turf/simulated/floor/plating/asteroid/airless,
/area/ruin/space/unpowered/no_grav/way_home)
"d" = (
/obj/structure/signpost{
	name = "salvation"
	},
/turf/simulated/floor/plating/asteroid/airless,
/area/ruin/space/unpowered/no_grav/way_home)
"f" = (
/obj/structure/spawner/mining/basilisk,
/turf/simulated/floor/plating/asteroid/airless,
/area/ruin/space/unpowered/no_grav/way_home)
"g" = (
/mob/living/simple_animal/hostile/carp/megacarp,
/turf/template_noop,
/area/template_noop)
"p" = (
/turf/simulated/mineral/random/high_chance/clown,
/area/ruin/space/unpowered/no_grav/way_home)
"r" = (
/turf/simulated/mineral/random/high_chance,
/area/ruin/space/unpowered/no_grav/way_home)
"x" = (
/obj/structure/spawner/mining/hivelord,
/turf/simulated/floor/plating/asteroid/airless,
/area/ruin/space/unpowered/no_grav/way_home)
"E" = (
/obj/item/salvage/ruin/tablet,
/turf/simulated/floor/plating/asteroid/airless,
/area/ruin/space/unpowered/no_grav/way_home)
"P" = (
/mob/living/simple_animal/hostile/carp,
/turf/template_noop,
/area/template_noop)

(1,1,1) = {"
a
a
a
a
a
a
a
a
a
a
a
a
a
a
a
a
a
a
a
a
a
a
a
a
a
a
a
a
a
a
"}
(2,1,1) = {"
a
a
a
a
a
a
a
a
a
a
a
a
a
a
a
a
a
a
a
a
a
a
a
a
a
a
a
P
a
a
"}
(3,1,1) = {"
a
a
a
a
a
a
a
a
a
a
a
a
a
a
a
a
a
a
a
a
a
a
a
a
r
r
a
a
a
a
"}
(4,1,1) = {"
a
a
a
a
a
a
a
a
a
a
a
a
a
a
a
a
a
a
a
a
a
a
a
a
r
r
r
a
a
a
"}
(5,1,1) = {"
a
a
a
a
a
a
a
a
a
a
a
a
a
a
a
a
a
a
a
a
a
a
a
a
a
r
a
a
P
a
"}
(6,1,1) = {"
a
a
a
a
a
a
a
a
a
a
a
a
a
a
a
a
a
a
a
a
a
a
a
a
a
a
a
a
a
a
"}
(7,1,1) = {"
a
a
a
a
a
a
a
a
a
a
a
a
b
b
a
a
a
a
a
a
a
a
a
a
a
a
P
a
a
a
"}
(8,1,1) = {"
a
a
a
a
a
a
a
a
a
a
b
b
r
b
b
b
a
a
a
a
a
a
a
a
a
a
a
a
a
a
"}
(9,1,1) = {"
a
a
a
a
a
a
a
a
a
b
r
r
r
r
b
b
a
a
a
a
a
a
a
a
a
a
a
a
a
a
"}
(10,1,1) = {"
a
a
a
a
a
a
a
b
b
b
b
r
r
b
b
a
a
P
a
a
a
a
a
a
a
a
a
a
a
a
"}
(11,1,1) = {"
a
a
a
a
b
a
b
b
b
b
b
b
r
b
c
a
a
a
a
a
g
a
a
a
a
a
a
a
a
a
"}
(12,1,1) = {"
a
a
a
a
b
b
b
b
r
r
b
b
b
b
c
c
a
a
a
a
a
a
a
a
a
a
a
a
a
a
"}
(13,1,1) = {"
a
a
a
a
b
b
b
r
r
b
b
b
b
c
c
c
a
a
a
a
a
a
a
P
a
a
a
a
a
a
"}
(14,1,1) = {"
a
a
a
b
b
b
r
r
b
b
b
b
b
c
x
c
c
c
c
a
a
a
a
a
a
a
a
a
a
a
"}
(15,1,1) = {"
a
a
b
b
b
r
r
b
r
b
b
c
c
c
c
c
c
c
c
c
c
a
a
a
a
a
b
a
a
a
"}
(16,1,1) = {"
a
a
a
b
b
b
b
b
b
b
c
E
c
a
a
c
c
d
c
c
c
c
c
c
a
b
b
a
a
a
"}
(17,1,1) = {"
a
a
a
a
b
b
b
b
b
b
b
c
a
a
a
a
c
c
E
c
c
c
b
b
b
b
a
a
a
a
"}
(18,1,1) = {"
a
a
a
a
b
b
b
b
b
b
b
a
a
a
a
a
a
c
c
c
b
b
b
p
b
b
a
a
a
a
"}
(19,1,1) = {"
a
a
a
a
b
b
a
a
b
b
b
a
a
a
a
a
a
a
c
c
f
b
r
p
p
b
a
a
a
a
"}
(20,1,1) = {"
a
a
a
a
a
a
a
a
a
b
a
a
a
a
a
a
a
a
a
c
c
c
b
p
p
b
b
a
a
a
"}
(21,1,1) = {"
a
a
a
a
a
a
a
a
a
a
a
a
a
a
a
a
a
a
a
a
a
c
b
b
p
p
b
a
a
a
"}
(22,1,1) = {"
a
a
a
a
a
a
a
a
a
a
a
a
a
a
a
a
a
a
a
a
a
a
a
b
b
b
b
a
a
a
"}
(23,1,1) = {"
a
a
a
a
a
a
a
a
a
a
a
a
a
a
a
a
a
a
a
a
a
a
a
a
b
b
a
a
a
a
"}
(24,1,1) = {"
a
a
a
a
a
a
a
a
a
a
a
a
a
a
a
a
a
a
a
a
a
a
a
a
a
r
r
a
a
a
"}
(25,1,1) = {"
a
a
a
a
a
a
a
a
a
a
a
a
a
a
a
a
a
a
a
a
a
a
a
a
a
a
a
a
a
a
"}
(26,1,1) = {"
a
P
a
a
a
a
a
a
a
a
a
a
a
a
a
a
a
a
a
a
a
a
a
a
a
a
a
a
a
a
"}
(27,1,1) = {"
a
a
P
a
a
a
a
a
a
a
a
a
a
a
a
a
a
a
a
a
a
a
a
a
a
a
a
a
a
a
"}
(28,1,1) = {"
a
a
P
a
a
a
a
a
a
a
a
a
a
a
a
a
a
a
a
a
a
a
a
a
a
a
a
a
a
a
"}
(29,1,1) = {"
a
P
P
a
a
a
a
a
a
a
a
a
a
a
a
a
a
a
a
a
a
a
a
a
a
a
a
a
a
a
"}
(30,1,1) = {"
g
a
a
a
a
a
a
a
a
a
a
a
a
a
a
a
a
a
a
a
a
a
a
a
a
a
a
a
a
a
"}
