//MAP CONVERTED BY dmm2tgm.py THIS HEADER COMMENT PREVENTS RECONVERSION, DO NOT REMOVE
"at" = (
/obj/structure/sign/vacuum/external{
	pixel_y = -32
	},
/obj/effect/spawner/random_spawners/dirt_often,
/turf/simulated/floor/plating,
/area/shuttle/abandoned)
"cf" = (
/obj/effect/spawner/random_spawners/oil_often,
/turf/simulated/floor/plating,
/area/shuttle/abandoned)
"cA" = (
/obj/structure/table,
/obj/item/scalpel{
	pixel_y = 7
	},
/turf/simulated/floor/mineral/titanium/blue,
/area/shuttle/abandoned)
"em" = (
/obj/effect/spawner/airlock/w_to_e/long/square{
	req_access_txt = null
	},
/turf/simulated/wall/mineral/titanium,
/area/shuttle/abandoned)
"eo" = (
/obj/structure/sign/greencross,
/turf/simulated/wall/mineral/titanium,
/area/shuttle/abandoned)
"ez" = (
/obj/machinery/atmospherics/pipe/simple/hidden{
	dir = 5
	},
/turf/simulated/floor/plating,
/area/shuttle/abandoned)
"eE" = (
/obj/machinery/computer/nonfunctional{
	dir = 4
	},
/turf/simulated/floor/mineral/plastitanium,
/area/shuttle/abandoned)
"eW" = (
/obj/structure/table,
/obj/item/radio{
	pixel_x = -6;
	pixel_y = 6
	},
/obj/item/radio{
	pixel_y = 4
	},
/obj/item/radio{
	pixel_x = 6;
	pixel_y = 6
	},
/turf/simulated/floor/mineral/titanium,
/area/shuttle/abandoned)
"fI" = (
/obj/machinery/atmospherics/pipe/simple/hidden{
	dir = 4
	},
/obj/machinery/light/small{
	dir = 1
	},
/turf/simulated/floor/plating,
/area/shuttle/abandoned)
"gd" = (
/obj/machinery/door/airlock/titanium/glass,
/turf/simulated/floor/mineral/titanium/blue,
/area/shuttle/abandoned)
"hz" = (
/obj/structure/shuttle/engine/propulsion{
	dir = 4;
	icon_state = "burst_r"
	},
/turf/simulated/floor/plating/airless,
/area/shuttle/abandoned)
"jk" = (
/obj/machinery/light/small{
	dir = 1
	},
/turf/simulated/floor/mineral/titanium,
/area/shuttle/abandoned)
"jn" = (
/obj/machinery/door/airlock/titanium/glass,
/turf/simulated/floor/wood,
/area/shuttle/abandoned)
"ka" = (
/turf/simulated/floor/wood,
/area/shuttle/abandoned)
"kO" = (
/obj/structure/sign/poster/official/random{
	pixel_y = 32
	},
/turf/simulated/floor/mineral/titanium,
/area/shuttle/abandoned)
"nC" = (
/obj/structure/table,
/obj/item/storage/firstaid/regular{
	pixel_y = 0
	},
/turf/simulated/floor/mineral/titanium/blue,
/area/shuttle/abandoned)
"oh" = (
/obj/structure/table,
/obj/item/tank/internals/oxygen{
	pixel_y = 1;
	pixel_x = -2
	},
/obj/item/tank/internals/oxygen{
	pixel_x = 3;
	pixel_y = 1
	},
/turf/simulated/floor/mineral/titanium/blue,
/area/shuttle/abandoned)
"qm" = (
/turf/simulated/wall/mineral/titanium/nodiagonal,
/area/shuttle/abandoned)
"qF" = (
/obj/machinery/economy/vending/coffee,
/turf/simulated/floor/wood,
/area/shuttle/abandoned)
"qK" = (
/obj/structure/table/reinforced,
/obj/item/gun/energy/laser/retro,
/turf/simulated/floor/mineral/plastitanium,
/area/shuttle/abandoned)
"ri" = (
/obj/structure/table,
/obj/item/storage/toolbox/mechanical,
/obj/item/multitool{
	pixel_x = -6
	},
/turf/simulated/floor/plating,
/area/shuttle/abandoned)
"rB" = (
/obj/machinery/light{
	dir = 4
	},
/obj/structure/chair/comfy/shuttle{
	dir = 8
	},
/turf/simulated/floor/mineral/plastitanium,
/area/shuttle/abandoned)
"sk" = (
/obj/structure/sign/poster/official/random{
	pixel_y = -32
	},
/turf/simulated/floor/mineral/titanium,
/area/shuttle/abandoned)
"sm" = (
/obj/effect/spawner/random_spawners/dirt_often,
/obj/machinery/door/airlock/titanium,
/turf/simulated/floor/plating,
/area/shuttle/abandoned)
"sK" = (
/obj/structure/table/wood/poker,
/turf/simulated/floor/wood,
/area/shuttle/abandoned)
"tV" = (
/obj/machinery/door/airlock/multi_tile/glass{
	dir = 1
	},
/turf/simulated/floor/mineral/plastitanium,
/area/shuttle/abandoned)
"uo" = (
/obj/structure/table/wood,
/obj/item/flashlight/lamp/green{
	pixel_y = 2
	},
/turf/simulated/floor/wood,
/area/shuttle/abandoned)
"ux" = (
/turf/simulated/floor/plating,
/area/shuttle/abandoned)
"uA" = (
/obj/structure/extinguisher_cabinet{
	name = "north bump";
	pixel_y = 30
	},
/turf/simulated/floor/mineral/titanium,
/area/shuttle/abandoned)
"vz" = (
/obj/effect/spawner/random_spawners/dirt_often,
/obj/machinery/atmospherics/pipe/simple/hidden{
	dir = 4
	},
/turf/simulated/floor/mineral/titanium,
/area/shuttle/abandoned)
"vB" = (
/turf/simulated/floor/mineral/titanium,
/area/shuttle/abandoned)
"wh" = (
/obj/machinery/door/airlock/titanium/glass,
/turf/simulated/floor/mineral/titanium,
/area/shuttle/abandoned)
"ws" = (
/obj/machinery/light{
	dir = 1
	},
/turf/simulated/floor/mineral/titanium/blue,
/area/shuttle/abandoned)
"wF" = (
/turf/simulated/floor/mineral/plastitanium,
/area/shuttle/abandoned)
"wN" = (
/obj/structure/rack,
/obj/item/stack/sheet/glass{
	amount = 10;
	pixel_x = 3;
	pixel_y = 3
	},
/obj/item/stack/sheet/metal{
	amount = 10
	},
/turf/simulated/floor/plating,
/area/shuttle/abandoned)
"ys" = (
/obj/structure/table,
/obj/item/storage/box/lights/mixed,
/obj/item/stock_parts/cell{
	charge = 100;
	maxcharge = 15000;
	pixel_x = -3;
	pixel_y = -3
	},
/turf/simulated/floor/plating,
/area/shuttle/abandoned)
"yC" = (
/obj/docking_port/stationary/whiteship{
	dir = 8;
	id = "whiteship_away";
	name = "Deep Space"
	},
/obj/docking_port/mobile{
	dir = 8;
	id = "whiteship";
	name = "NEV Cherub";
	dwidth = 6;
	height = 19;
	width = 12
	},
/turf/simulated/floor/plating,
/area/shuttle/abandoned)
"yF" = (
/obj/machinery/light/small,
/turf/simulated/floor/mineral/titanium,
/area/shuttle/abandoned)
"zH" = (
/obj/machinery/light/small,
/turf/simulated/floor/plating,
/area/shuttle/abandoned)
"zM" = (
/turf/template_noop,
/area/template_noop)
"zO" = (
/turf/simulated/wall/mineral/titanium,
/area/shuttle/abandoned)
"zV" = (
/obj/structure/closet/crate,
/obj/item/flashlight/flare,
/obj/item/flashlight/flare,
/obj/item/flashlight/flare,
/obj/item/flashlight/flare/glowstick/blue,
/obj/item/flashlight/flare/glowstick/blue,
/obj/item/flashlight/flare/glowstick/blue,
/turf/simulated/floor/mineral/titanium,
/area/shuttle/abandoned)
"AS" = (
/obj/machinery/light/small{
	dir = 4
	},
/turf/simulated/floor/mineral/titanium,
/area/shuttle/abandoned)
"Ct" = (
/obj/structure/table/wood/poker,
/obj/item/deck/cards,
/turf/simulated/floor/wood,
/area/shuttle/abandoned)
"CE" = (
/obj/structure/shuttle/engine/heater{
	dir = 4
	},
/obj/structure/window/reinforced{
	dir = 8
	},
/turf/simulated/floor/plating/airless,
/area/shuttle/abandoned)
"Fr" = (
/obj/effect/spawner/window/shuttle,
/turf/simulated/floor/plating,
/area/shuttle/abandoned)
"Gs" = (
/obj/structure/table/reinforced,
/obj/item/analyzer,
/turf/simulated/floor/mineral/plastitanium,
/area/shuttle/abandoned)
"GX" = (
/obj/machinery/atmospherics/pipe/simple/hidden,
/obj/machinery/door/airlock/titanium,
/turf/simulated/floor/plating,
/area/shuttle/abandoned)
"Jf" = (
/obj/structure/chair/wood,
/turf/simulated/floor/wood,
/area/shuttle/abandoned)
"Kd" = (
/obj/effect/spawner/random_spawners/dirt_often,
/turf/simulated/floor/mineral/titanium,
/area/shuttle/abandoned)
"KX" = (
/obj/structure/bed,
/obj/item/bedsheet,
/turf/simulated/floor/mineral/titanium/blue,
/area/shuttle/abandoned)
"Mj" = (
/obj/machinery/light/small{
	dir = 4
	},
/turf/simulated/floor/wood,
/area/shuttle/abandoned)
"Mp" = (
/obj/effect/turf_decal/delivery/hollow,
/obj/structure/closet,
/obj/item/gps/ruin{
	gpstag = "NT Medical Ship";
	pixel_x = -32
	},
/turf/simulated/floor/plating,
/area/shuttle/abandoned)
"ML" = (
/obj/machinery/atmospherics/pipe/simple/hidden{
	dir = 6
	},
/turf/simulated/floor/mineral/titanium,
/area/shuttle/abandoned)
"Of" = (
/turf/simulated/floor/mineral/titanium/blue,
/area/shuttle/abandoned)
"Pe" = (
/obj/structure/chair/wood,
/obj/structure/sign/poster/contraband/random{
	pixel_y = 32
	},
/turf/simulated/floor/wood,
/area/shuttle/abandoned)
"Pi" = (
/obj/structure/closet/crate/can,
/turf/simulated/floor/wood,
/area/shuttle/abandoned)
"Pu" = (
/obj/machinery/light/small{
	dir = 1
	},
/obj/effect/spawner/random_spawners/dirt_often,
/turf/simulated/floor/plating,
/area/shuttle/abandoned)
"Ro" = (
/obj/structure/chair/wood{
	dir = 8
	},
/turf/simulated/floor/wood,
/area/shuttle/abandoned)
"SS" = (
/obj/structure/chair/comfy/shuttle{
	dir = 8
	},
/turf/simulated/floor/mineral/plastitanium,
/area/shuttle/abandoned)
"Vd" = (
/obj/effect/spawner/random_spawners/dirt_often,
/turf/simulated/floor/plating,
/area/shuttle/abandoned)
"VD" = (
/obj/machinery/light/small{
	dir = 8
	},
/turf/simulated/floor/plating,
/area/shuttle/abandoned)
"WJ" = (
/obj/machinery/atmospherics/unary/portables_connector{
	dir = 8
	},
/obj/machinery/atmospherics/portable/canister/air,
/turf/simulated/floor/plating,
/area/shuttle/abandoned)
"WX" = (
/obj/machinery/sleeper{
	dir = 4
	},
/turf/simulated/floor/mineral/titanium/blue,
/area/shuttle/abandoned)
"Xq" = (
/obj/effect/turf_decal/delivery/hollow,
/obj/structure/closet,
/turf/simulated/floor/plating,
/area/shuttle/abandoned)
"Yr" = (
/obj/machinery/computer/shuttle/white_ship{
	dir = 4
	},
/turf/simulated/floor/mineral/plastitanium,
/area/shuttle/abandoned)

(1,1,1) = {"
zM
zM
zM
zM
zO
Fr
Fr
zO
zM
zM
zM
zM
"}
(2,1,1) = {"
zM
zM
zM
zO
zO
eE
Yr
zO
zO
zM
zM
zM
"}
(3,1,1) = {"
zM
zM
zM
zO
Gs
SS
SS
qK
zO
zM
zM
zM
"}
(4,1,1) = {"
zM
zM
zM
zO
rB
wF
wF
SS
zO
zM
zM
zM
"}
(5,1,1) = {"
zM
zO
zO
zO
zO
wF
tV
zO
zO
zO
zO
zM
"}
(6,1,1) = {"
zM
zO
eW
zV
zO
jk
vB
zO
WX
cA
zO
zM
"}
(7,1,1) = {"
zM
zO
AS
vB
wh
vB
vB
zO
Of
Of
zO
zM
"}
(8,1,1) = {"
zO
zO
zO
zO
zO
kO
vB
gd
Of
Of
zO
zO
"}
(9,1,1) = {"
Fr
uo
qF
Pi
zO
uA
vB
eo
ws
Of
nC
zO
"}
(10,1,1) = {"
Fr
ka
ka
ka
jn
vB
yF
zO
KX
KX
oh
zO
"}
(11,1,1) = {"
zO
Pe
sK
sK
zO
vB
vB
zO
zO
zO
zO
zO
"}
(12,1,1) = {"
Fr
Jf
Ct
sK
zO
vB
vB
zO
Mp
VD
Xq
zO
"}
(13,1,1) = {"
Fr
Mj
Ro
Ro
zO
vB
sk
zO
Xq
ux
Xq
zO
"}
(14,1,1) = {"
zO
zO
zO
zO
zO
jk
ML
GX
ez
ux
zO
zO
"}
(15,1,1) = {"
zM
zO
ri
cf
sm
Kd
vz
zO
fI
ux
zO
zM
"}
(16,1,1) = {"
zM
zO
ys
zH
zO
Vd
Vd
em
WJ
wN
zO
zM
"}
(17,1,1) = {"
zM
zO
CE
CE
zO
Vd
Vd
zO
CE
CE
zO
zM
"}
(18,1,1) = {"
zM
zO
hz
hz
zO
Pu
at
zO
hz
hz
zO
zM
"}
(19,1,1) = {"
zM
zM
zM
zM
qm
yC
ux
qm
zM
zM
zM
zM
"}
