//MAP CONVERTED BY dmm2tgm.py THIS HEADER COMMENT PREVENTS RECONVERSION, DO NOT REMOVE
"aa" = (
/turf/template_noop,
/area/template_noop)
"ab" = (
/turf/simulated/wall/mineral/titanium,
/area/shuttle/abandoned)
"ae" = (
/turf/simulated/floor/mineral/titanium,
/area/shuttle/abandoned)
"af" = (
/obj/machinery/sleeper,
/obj/machinery/light{
	dir = 1
	},
/obj/effect/decal/remains/human,
/turf/simulated/floor/mineral/titanium,
/area/shuttle/abandoned)
"ak" = (
/obj/structure/shuttle/engine/propulsion{
	dir = 4;
	icon_state = "burst_r"
	},
/turf/simulated/floor/plating/airless,
/area/shuttle/abandoned)
"am" = (
/obj/machinery/computer/med_data,
/turf/simulated/floor/mineral/titanium,
/area/shuttle/abandoned)
"an" = (
/obj/structure/table,
/obj/item/storage/firstaid/regular{
	pixel_x = 6;
	pixel_y = -5
	},
/turf/simulated/floor/mineral/titanium,
/area/shuttle/abandoned)
"aq" = (
/obj/structure/shuttle/engine/heater{
	dir = 4
	},
/obj/structure/window/reinforced{
	dir = 8
	},
/turf/simulated/floor/plating/airless,
/area/shuttle/abandoned)
"ar" = (
/obj/structure/shuttle/engine/propulsion{
	dir = 4
	},
/turf/simulated/floor/plating/airless,
/area/shuttle/abandoned)
"at" = (
/obj/item/scalpel,
/turf/simulated/floor/mineral/titanium,
/area/shuttle/abandoned)
"av" = (
/turf/simulated/floor/plating,
/area/shuttle/abandoned)
"aw" = (
/obj/structure/computerframe,
/turf/simulated/floor/mineral/titanium,
/area/shuttle/abandoned)
"ax" = (
/obj/effect/spawner/window/shuttle,
/turf/simulated/floor/plating,
/area/shuttle/abandoned)
"aA" = (
/obj/machinery/door/airlock/public/glass{
	name = "Hibernation Pods"
	},
/turf/simulated/floor/mineral/titanium,
/area/shuttle/abandoned)
"aB" = (
/obj/machinery/light/small{
	dir = 8
	},
/turf/simulated/floor/plating,
/area/shuttle/abandoned)
"aC" = (
/obj/structure/chair/comfy/shuttle{
	dir = 1
	},
/turf/simulated/floor/mineral/titanium,
/area/shuttle/abandoned)
"aD" = (
/obj/structure/table,
/turf/simulated/floor/mineral/titanium,
/area/shuttle/abandoned)
"aF" = (
/obj/item/multitool,
/turf/simulated/floor/mineral/titanium,
/area/shuttle/abandoned)
"aG" = (
/obj/item/stock_parts/cell{
	charge = 100;
	maxcharge = 15000
	},
/turf/simulated/floor/mineral/titanium,
/area/shuttle/abandoned)
"aH" = (
/obj/machinery/door/airlock/titanium,
/turf/simulated/floor/plating,
/area/shuttle/abandoned)
"aJ" = (
/obj/structure/shuttle/engine/propulsion{
	dir = 4;
	icon_state = "burst_l"
	},
/turf/simulated/floor/plating/airless,
/area/shuttle/abandoned)
"aK" = (
/obj/machinery/door/airlock/titanium,
/obj/docking_port/mobile{
	dir = 8;
	dwidth = 10;
	height = 35;
	id = "whiteship";
	name = "NT Medical Ship";
	width = 21
	},
/obj/docking_port/stationary/whiteship{
	dir = 8;
	id = "whiteship_away";
	name = "Deep Space"
	},
/turf/simulated/floor/mineral/titanium,
/area/shuttle/abandoned)
"aM" = (
/obj/structure/table,
/obj/machinery/light{
	dir = 4
	},
/turf/simulated/floor/mineral/titanium,
/area/shuttle/abandoned)
"aO" = (
/obj/machinery/door/airlock/public/glass,
/turf/simulated/floor/mineral/titanium,
/area/shuttle/abandoned)
"aP" = (
/obj/machinery/light_switch{
	name = "custom placement";
	pixel_x = 27
	},
/turf/simulated/floor/mineral/titanium,
/area/shuttle/abandoned)
"aQ" = (
/obj/machinery/atmospherics/portable/scrubber,
/turf/simulated/floor/mineral/titanium,
/area/shuttle/abandoned)
"aS" = (
/obj/structure/bed,
/obj/item/bedsheet,
/turf/simulated/floor/mineral/titanium,
/area/shuttle/abandoned)
"aT" = (
/obj/machinery/light{
	dir = 8
	},
/turf/simulated/floor/mineral/titanium,
/area/shuttle/abandoned)
"aU" = (
/obj/structure/table,
/obj/item/gun/energy/laser/retro,
/turf/simulated/floor/mineral/titanium,
/area/shuttle/abandoned)
"aV" = (
/obj/machinery/computer/shuttle/white_ship,
/turf/simulated/floor/mineral/titanium,
/area/shuttle/abandoned)
"aX" = (
/obj/machinery/light/small{
	dir = 8
	},
/turf/simulated/floor/mineral/titanium,
/area/shuttle/abandoned)
"aY" = (
/obj/structure/table,
/obj/item/tank/internals/oxygen,
/turf/simulated/floor/mineral/titanium,
/area/shuttle/abandoned)
"ba" = (
/obj/machinery/light{
	dir = 1
	},
/turf/simulated/floor/mineral/titanium,
/area/shuttle/abandoned)
"bb" = (
/obj/structure/table,
/obj/item/analyzer,
/turf/simulated/floor/mineral/titanium,
/area/shuttle/abandoned)
"bc" = (
/obj/effect/decal/remains/human,
/obj/structure/chair/comfy/shuttle{
	dir = 8
	},
/turf/simulated/floor/mineral/titanium,
/area/shuttle/abandoned)
"bd" = (
/obj/machinery/door/airlock/public/glass{
	name = "Living Module"
	},
/turf/simulated/floor/mineral/titanium,
/area/shuttle/abandoned)
"be" = (
/obj/machinery/door/airlock/titanium,
/turf/simulated/floor/mineral/titanium,
/area/shuttle/abandoned)
"bf" = (
/obj/machinery/light/small{
	dir = 1
	},
/turf/simulated/floor/mineral/titanium,
/area/shuttle/abandoned)
"bg" = (
/turf/template_noop,
/area/shuttle/abandoned)
"bh" = (
/obj/effect/decal/remains/human,
/turf/simulated/floor/mineral/titanium,
/area/shuttle/abandoned)
"bi" = (
/obj/machinery/atmospherics/portable/canister/oxygen,
/turf/simulated/floor/mineral/titanium,
/area/shuttle/abandoned)
"bm" = (
/obj/machinery/light_switch{
	name = "custom placement";
	pixel_x = 27
	},
/obj/machinery/light{
	dir = 4
	},
/turf/simulated/floor/mineral/titanium,
/area/shuttle/abandoned)
"bn" = (
/obj/item/gps/ruin{
	gpstag = "NT Medical Ship";
	pixel_x = -32
	},
/turf/simulated/floor/mineral/titanium,
/area/shuttle/abandoned)
"bo" = (
/obj/item/shard,
/obj/structure/chair/comfy/shuttle,
/turf/simulated/floor/mineral/titanium,
/area/shuttle/abandoned)
"bp" = (
/obj/structure/chair/comfy/shuttle,
/turf/simulated/floor/mineral/titanium,
/area/shuttle/abandoned)
"bq" = (
/obj/structure/computerframe,
/obj/item/stack/cable_coil/cut,
/turf/simulated/floor/mineral/titanium,
/area/shuttle/abandoned)
"br" = (
/obj/structure/rack,
/obj/item/tank/internals/emergency_oxygen,
/obj/item/tank/internals/emergency_oxygen,
/obj/item/tank/internals/emergency_oxygen,
/obj/item/tank/internals/emergency_oxygen,
/obj/item/storage/toolbox/mechanical,
/turf/simulated/floor/mineral/titanium,
/area/shuttle/abandoned)
"bs" = (
/obj/structure/rack,
/obj/item/mod/control/pre_equipped/medical,
/obj/item/clothing/mask/breath,
/turf/simulated/floor/mineral/titanium,
/area/shuttle/abandoned)
"bt" = (
/obj/structure/rack,
/obj/item/clothing/suit/space/syndicate/black/med,
/obj/item/clothing/head/helmet/space/syndicate/black/med,
/turf/simulated/floor/mineral/titanium,
/area/shuttle/abandoned)
"bu" = (
/obj/machinery/light/small,
/turf/simulated/floor/mineral/titanium,
/area/shuttle/abandoned)
"bx" = (
/obj/effect/decal/cleanable/blood{
	amount = 0
	},
/turf/simulated/floor/plating,
/area/shuttle/abandoned)
"by" = (
/obj/machinery/door_control{
	id = "whiteshippoddoor";
	name = "Pod Door Control";
	pixel_x = -24;
	pixel_y = 24
	},
/turf/simulated/floor/mineral/titanium,
/area/shuttle/abandoned)
"bz" = (
/obj/machinery/door/airlock/public/glass{
	name = "Pod Bay"
	},
/turf/simulated/floor/mineral/titanium,
/area/shuttle/abandoned)
"bB" = (
/obj/effect/decal/remains/human,
/turf/simulated/floor/plating,
/area/shuttle/abandoned)
"bC" = (
/obj/machinery/door/poddoor/multi_tile/two_tile_ver{
	id_tag = "whiteshippoddoor"
	},
/turf/simulated/floor/mineral/titanium,
/area/shuttle/abandoned)
"bD" = (
/obj/machinery/door_control{
	id = "whiteshippoddoor";
	name = "Pod Door Control";
	pixel_y = -24
	},
/turf/simulated/floor/mineral/titanium,
/area/shuttle/abandoned)
"bE" = (
/obj/structure/table,
/obj/item/screwdriver,
/obj/machinery/light,
/turf/simulated/floor/mineral/titanium,
/area/shuttle/abandoned)
"bF" = (
/obj/structure/table,
/obj/item/radio,
/turf/simulated/floor/mineral/titanium,
/area/shuttle/abandoned)

(1,1,1) = {"
aa
aa
aa
aa
ab
ab
ab
ax
ax
ax
ax
ax
ax
ax
ab
ab
ab
aa
aa
aa
aa
"}
(2,1,1) = {"
aa
aa
aa
ab
ab
ab
ae
ae
ae
aU
bb
aD
ae
ae
bn
ab
ab
aa
aa
aa
aa
"}
(3,1,1) = {"
aa
aa
ab
ab
ab
ae
ae
ae
ae
aV
bc
aD
ae
ae
bo
aw
ab
aa
aa
aa
aa
"}
(4,1,1) = {"
aa
ab
ab
ab
aw
aC
ae
ae
ae
ae
ae
ae
ae
ae
bp
bq
ab
by
bC
ab
aa
"}
(5,1,1) = {"
aa
ab
am
ab
ab
ae
ae
ae
ae
ae
ae
ae
ae
ae
ae
ab
ab
ae
ae
ab
aa
"}
(6,1,1) = {"
ab
ab
ae
ae
ab
aD
aD
aM
ae
ae
ae
ae
ae
bm
ab
ab
ab
ae
bD
ab
ab
"}
(7,1,1) = {"
ab
ae
ae
ae
ab
ab
ab
ab
ab
ax
aO
ax
ab
ab
ab
ab
ae
ae
ae
ab
ab
"}
(8,1,1) = {"
ab
ae
ae
ae
ax
aF
ae
ae
ae
ae
ae
ae
ae
ab
ab
br
ae
ae
ae
ae
ab
"}
(9,1,1) = {"
ab
af
ae
ae
ax
ae
ae
ae
ae
ae
ae
ae
ae
ae
ab
bs
ae
ae
ae
bE
ab
"}
(10,1,1) = {"
ab
ae
ae
at
ax
aG
ae
ab
ab
ab
ab
ab
ab
ae
ab
bt
ae
ae
ae
bF
ab
"}
(11,1,1) = {"
ab
ab
ae
ae
ab
ae
ae
aO
ae
aX
ae
bh
ab
ae
ab
ab
ae
ae
ae
ab
ab
"}
(12,1,1) = {"
ab
ab
an
ae
ab
ae
ae
ab
aS
aY
ae
aS
ab
ae
ab
ab
ab
bz
ab
ab
ab
"}
(13,1,1) = {"
aa
ab
ab
ae
aA
ae
ae
ab
ae
aP
ae
ae
aO
ae
ae
ae
ae
bh
ab
ab
aa
"}
(14,1,1) = {"
aa
ab
ab
ab
ab
ae
ae
ab
ab
ab
ab
ab
ab
ae
ae
ae
ae
ab
ab
ab
aa
"}
(15,1,1) = {"
aa
aa
ab
ab
ab
ae
ae
ae
ae
ae
ae
ae
ae
ae
ae
aG
ab
ab
ab
aa
aa
"}
(16,1,1) = {"
aa
aa
aa
ab
ab
ae
ae
aP
ae
ae
ae
ae
ae
ae
ae
bu
ab
ab
aa
aa
aa
"}
(17,1,1) = {"
aa
aa
aa
ab
ab
aH
ab
ab
ab
ax
bd
ax
ab
ab
ab
aH
ab
ab
aa
aa
aa
"}
(18,1,1) = {"
aa
aa
ab
ab
aB
av
ab
aQ
aT
ae
ae
ae
aT
ae
ab
av
aB
ab
ab
aa
aa
"}
(19,1,1) = {"
aa
ab
ab
av
av
ab
ab
ab
ae
ae
ae
ae
ae
ab
ab
ab
bx
bB
ab
ab
aa
"}
(20,1,1) = {"
ab
ab
aq
aq
aq
ab
ab
ab
ae
ae
ae
ae
ae
ab
ab
ab
aq
aq
aq
ab
ab
"}
(21,1,1) = {"
ab
ak
ar
ar
ar
aJ
bg
ab
ab
ae
ae
ae
ab
ab
bg
ak
ar
ar
ar
aJ
ab
"}
(22,1,1) = {"
aa
aa
aa
aa
aa
aa
aa
ab
ab
ab
ae
ab
ab
ab
aa
aa
aa
aa
aa
aa
aa
"}
(23,1,1) = {"
aa
aa
aa
aa
aa
aa
aa
aa
ab
ab
be
ab
ab
aa
aa
aa
aa
aa
aa
aa
aa
"}
(24,1,1) = {"
aa
aa
aa
aa
aa
aa
aa
aa
aa
ab
bf
ab
aa
aa
aa
aa
aa
aa
aa
aa
aa
"}
(25,1,1) = {"
aa
aa
aa
aa
aa
aa
aa
aa
ab
ab
be
ab
ab
aa
aa
aa
aa
aa
aa
aa
aa
"}
(26,1,1) = {"
aa
aa
aa
aa
aa
aa
aa
aa
ab
ab
ae
ab
ab
aa
aa
aa
aa
aa
aa
aa
aa
"}
(27,1,1) = {"
aa
aa
aa
aa
aa
aa
aa
aa
ab
ae
ae
ae
ab
aa
aa
aa
aa
aa
aa
aa
aa
"}
(28,1,1) = {"
aa
aa
aa
aa
aa
aa
aa
aa
ab
ae
ae
ae
ab
aa
aa
aa
aa
aa
aa
aa
aa
"}
(29,1,1) = {"
aa
aa
aa
aa
aa
aa
aa
aa
ab
ae
ae
ae
ab
aa
aa
aa
aa
aa
aa
aa
aa
"}
(30,1,1) = {"
aa
aa
aa
aa
aa
aa
aa
aa
ab
ba
ae
ae
ab
aa
aa
aa
aa
aa
aa
aa
aa
"}
(31,1,1) = {"
aa
aa
aa
aa
aa
aa
aa
aa
ab
ae
ae
ae
ab
aa
aa
aa
aa
aa
aa
aa
aa
"}
(32,1,1) = {"
aa
aa
aa
aa
aa
aa
aa
aa
ab
ae
ae
ae
ab
aa
aa
aa
aa
aa
aa
aa
aa
"}
(33,1,1) = {"
aa
aa
aa
aa
aa
aa
aa
aa
ab
ae
ae
bi
ab
aa
aa
aa
aa
aa
aa
aa
aa
"}
(34,1,1) = {"
aa
aa
aa
aa
aa
aa
aa
aa
ab
ab
ae
ab
ab
aa
aa
aa
aa
aa
aa
aa
aa
"}
(35,1,1) = {"
aa
aa
aa
aa
aa
aa
aa
aa
ab
ab
aK
ab
ab
aa
aa
aa
aa
aa
aa
aa
aa
"}
