//MAP CONVERTED BY dmm2tgm.py THIS HEADER COMMENT PREVENTS RECONVERSION, DO NOT REMOVE
"a" = (
/turf/simulated/floor/plasteel{
	icon_state = "chapel"
	},
/area/template_noop)

(1,1,1) = {"
a
"}
