//MAP CONVERTED BY dmm2tgm.py THIS HEADER COMMENT PREVENTS RECONVERSION, DO NOT REMOVE
"a" = (
/obj/item/crowbar,
/obj/item/paper,
/turf/simulated/floor/plating,
/area/space)
"f" = (
/obj/item/weldingtool,
/turf/simulated/floor/plating,
/area/space)
"J" = (
/obj/item/crowbar,
/obj/item/wrench,
/turf/simulated/floor/plating,
/area/space)
"N" = (
/obj/item/multitool,
/turf/simulated/floor/plating,
/area/space)

(1,1,1) = {"
J
a
"}
(2,1,1) = {"
f
N
"}
