//MAP CONVERTED BY dmm2tgm.py THIS HEADER COMMENT PREVENTS RECONVERSION, DO NOT REMOVE
"a" = (
/obj/effect/landmark/spawner/tradergearmajor,
/turf/simulated/floor/mineral/abductor,
/area/shuttle/trade/sol)
"b" = (
/obj/effect/spawner/random/traders/large_item,
/turf/simulated/floor/mineral/abductor,
/area/shuttle/trade/sol)
"c" = (
/obj/structure/bed/abductor,
/obj/item/toy/plushie/abductor/agent,
/turf/simulated/floor/mineral/abductor,
/area/shuttle/trade/sol)
"e" = (
/obj/machinery/light/spot{
	dir = 8
	},
/obj/item/flag/species/greys,
/turf/simulated/floor/mineral/abductor,
/area/shuttle/trade/sol)
"f" = (
/obj/structure/closet/abductor,
/obj/effect/spawner/random/traders/service,
/obj/item/stack/tile/disco_light/thirty,
/turf/simulated/floor/mineral/abductor,
/area/shuttle/trade/sol)
"h" = (
/obj/structure/closet/abductor,
/obj/effect/spawner/random/traders/engineering,
/turf/simulated/floor/mineral/abductor,
/area/shuttle/trade/sol)
"i" = (
/obj/effect/spawner/window/reinforced/plasma/grilled,
/obj/machinery/door/poddoor/shutters/preopen{
	dir = 1;
	id_tag = "trader_privacy";
	name = "Privacy Shutters"
	},
/turf/simulated/floor/mineral/abductor,
/area/shuttle/trade/sol)
"j" = (
/obj/machinery/flasher_button{
	id = "trader_flash";
	pixel_y = 23;
	req_access = list(160)
	},
/obj/machinery/door_control/no_emag{
	id = "trader_privacy";
	name = "Privacy Shutters Control";
	pixel_y = 24;
	req_access = list(160);
	pixel_x = -10
	},
/obj/machinery/door_control/no_emag{
	id = "trader_starboard";
	name = "Trade Deposits Door";
	normaldoorcontrol = 1;
	pixel_x = 10;
	req_access = list(160);
	pixel_y = 24
	},
/turf/simulated/floor/mineral/abductor,
/area/shuttle/trade/sol)
"l" = (
/obj/effect/spawner/random/traders/minerals,
/obj/structure/closet/abductor,
/turf/simulated/floor/mineral/abductor,
/area/shuttle/trade/sol)
"m" = (
/obj/machinery/door/airlock/abductor{
	security_level = 6;
	id_tag = "trader_port"
	},
/obj/effect/mapping_helpers/airlock/access/all/centcomm/traders,
/turf/simulated/floor/mineral/abductor,
/area/shuttle/trade/sol)
"n" = (
/obj/structure/closet/abductor,
/obj/effect/spawner/random/traders/science,
/turf/simulated/floor/mineral/abductor,
/area/shuttle/trade/sol)
"o" = (
/obj/machinery/light/spot{
	dir = 8
	},
/obj/structure/sign/poster/official/graydays/directional/north,
/turf/simulated/floor/mineral/abductor,
/area/shuttle/trade/sol)
"p" = (
/obj/structure/chair/comfy/shuttle,
/obj/machinery/flasher{
	id = "trader_flash";
	pixel_x = -28
	},
/turf/simulated/floor/mineral/abductor,
/area/shuttle/trade/sol)
"q" = (
/turf/simulated/floor/mineral/abductor,
/area/shuttle/trade/sol)
"r" = (
/obj/structure/bed/abductor,
/obj/item/toy/plushie/greyplushie,
/turf/simulated/floor/mineral/abductor,
/area/shuttle/trade/sol)
"s" = (
/obj/machinery/light/spot{
	dir = 1
	},
/turf/simulated/floor/mineral/abductor,
/area/shuttle/trade/sol)
"t" = (
/obj/effect/landmark/spawner/tradergearminor,
/turf/simulated/floor/mineral/abductor,
/area/shuttle/trade/sol)
"u" = (
/obj/machinery/light/spot,
/obj/item/flag/species/greys,
/turf/simulated/floor/mineral/abductor,
/area/shuttle/trade/sol)
"v" = (
/obj/machinery/door/airlock/abductor,
/obj/effect/mapping_helpers/airlock/access/all/centcomm/traders,
/turf/simulated/floor/mineral/abductor,
/area/shuttle/trade/sol)
"w" = (
/obj/effect/spawner/random/traders/vehicle,
/turf/simulated/floor/mineral/abductor,
/area/shuttle/trade/sol)
"x" = (
/obj/machinery/door/airlock/abductor,
/obj/structure/fans/tiny,
/turf/simulated/floor/mineral/abductor,
/area/shuttle/trade/sol)
"y" = (
/obj/machinery/door/airlock/abductor{
	security_level = 6;
	id_tag = "trader_starboard"
	},
/obj/effect/mapping_helpers/airlock/access/all/centcomm/traders,
/turf/simulated/floor/mineral/abductor,
/area/shuttle/trade/sol)
"z" = (
/obj/machinery/light/spot{
	dir = 8
	},
/turf/simulated/floor/mineral/abductor,
/area/shuttle/trade/sol)
"A" = (
/obj/machinery/flasher_button{
	id = "trader_flash";
	pixel_y = 23;
	req_access = list(160)
	},
/obj/machinery/door_control/no_emag{
	id = "trader_privacy";
	name = "Privacy Shutters Control";
	pixel_y = 24;
	req_access = list(160);
	pixel_x = 10
	},
/obj/machinery/door_control/no_emag{
	id = "trader_port";
	name = "Trade Deposits Door";
	normaldoorcontrol = 1;
	pixel_x = -10;
	req_access = list(160);
	pixel_y = 24
	},
/turf/simulated/floor/mineral/abductor,
/area/shuttle/trade/sol)
"B" = (
/obj/machinery/light/spot{
	dir = 4
	},
/obj/item/flag/species/greys,
/turf/simulated/floor/mineral/abductor,
/area/shuttle/trade/sol)
"C" = (
/turf/simulated/wall/mineral/abductor,
/area/shuttle/trade/sol)
"D" = (
/obj/structure/chair/comfy/shuttle,
/obj/machinery/flasher{
	id = "trader_flash";
	pixel_x = 28
	},
/turf/simulated/floor/mineral/abductor,
/area/shuttle/trade/sol)
"F" = (
/obj/machinery/door/airlock/abductor,
/obj/structure/fans/tiny,
/obj/docking_port/mobile/trader{
	height = 16;
	width = 16;
	dwidth = 8;
	preferred_direction = 1;
	dir = 2
	},
/turf/simulated/floor/mineral/abductor,
/area/shuttle/trade/sol)
"G" = (
/obj/machinery/computer/shuttle/trade/sol,
/turf/simulated/floor/mineral/abductor,
/area/shuttle/trade/sol)
"H" = (
/obj/structure/table/abductor,
/obj/item/hand_labeler,
/obj/item/hand_labeler,
/obj/item/hand_labeler_refill{
	pixel_x = -7;
	pixel_y = 10
	},
/obj/item/hand_labeler_refill{
	pixel_x = -7;
	pixel_y = 10
	},
/obj/item/hand_labeler_refill{
	pixel_x = -7;
	pixel_y = 10
	},
/obj/item/hand_labeler_refill{
	pixel_x = -7;
	pixel_y = 10
	},
/obj/item/hand_labeler_refill{
	pixel_x = -7;
	pixel_y = 10
	},
/turf/simulated/floor/mineral/abductor,
/area/shuttle/trade/sol)
"I" = (
/obj/structure/closet/abductor,
/obj/effect/spawner/random/traders/security,
/turf/simulated/floor/mineral/abductor,
/area/shuttle/trade/sol)
"J" = (
/obj/structure/chair/comfy/shuttle,
/obj/machinery/light/spot{
	dir = 8
	},
/turf/simulated/floor/mineral/abductor,
/area/shuttle/trade/sol)
"K" = (
/obj/machinery/light/spot{
	dir = 4
	},
/turf/simulated/floor/mineral/abductor,
/area/shuttle/trade/sol)
"L" = (
/obj/machinery/economy/atm/directional/west,
/turf/simulated/floor/mineral/abductor,
/area/shuttle/trade/sol)
"M" = (
/turf/template_noop,
/area/template_noop)
"N" = (
/obj/machinery/economy/atm/directional/east,
/turf/simulated/floor/mineral/abductor,
/area/shuttle/trade/sol)
"O" = (
/obj/effect/spawner/window/reinforced/plasma/grilled,
/turf/simulated/floor/mineral/abductor,
/area/shuttle/trade/sol)
"P" = (
/obj/structure/chair/comfy/shuttle{
	dir = 1
	},
/turf/simulated/floor/mineral/abductor,
/area/shuttle/trade/sol)
"Q" = (
/obj/structure/table/abductor,
/obj/item/stack/wrapping_paper,
/obj/item/stack/package_wrap{
	pixel_y = 8
	},
/turf/simulated/floor/mineral/abductor,
/area/shuttle/trade/sol)
"R" = (
/obj/structure/closet/abductor,
/obj/effect/spawner/random/traders/medical,
/turf/simulated/floor/mineral/abductor,
/area/shuttle/trade/sol)
"S" = (
/obj/structure/chair/comfy/shuttle,
/turf/simulated/floor/mineral/abductor,
/area/shuttle/trade/sol)
"T" = (
/obj/structure/chair/comfy/shuttle,
/obj/machinery/light/spot{
	dir = 4
	},
/turf/simulated/floor/mineral/abductor,
/area/shuttle/trade/sol)
"W" = (
/obj/structure/closet/abductor,
/obj/effect/spawner/random/traders/civilian,
/turf/simulated/floor/mineral/abductor,
/area/shuttle/trade/sol)
"X" = (
/obj/structure/closet/abductor,
/obj/effect/spawner/random/traders/donksoft,
/turf/simulated/floor/mineral/abductor,
/area/shuttle/trade/sol)
"Y" = (
/obj/structure/shelf/science,
/turf/simulated/floor/mineral/abductor,
/area/shuttle/trade/sol)

(1,1,1) = {"
M
M
M
M
M
C
C
C
C
C
C
M
M
M
M
M
"}
(2,1,1) = {"
M
M
M
C
C
C
C
q
z
W
C
C
C
M
M
M
"}
(3,1,1) = {"
M
M
C
C
q
q
O
q
q
q
n
C
C
C
M
M
"}
(4,1,1) = {"
M
C
C
q
K
q
v
q
q
q
q
C
c
C
C
M
"}
(5,1,1) = {"
M
C
C
m
C
C
C
s
q
l
w
C
K
q
C
M
"}
(6,1,1) = {"
C
C
p
q
L
e
C
A
q
Y
u
C
C
v
C
C
"}
(7,1,1) = {"
C
J
q
q
q
S
i
P
q
q
q
v
z
q
q
C
"}
(8,1,1) = {"
F
q
q
q
q
S
i
Q
q
t
X
C
H
P
q
C
"}
(9,1,1) = {"
x
q
q
q
q
S
i
Q
q
a
f
C
G
P
q
C
"}
(10,1,1) = {"
C
T
q
q
q
S
i
P
q
q
q
v
K
q
q
C
"}
(11,1,1) = {"
C
C
D
q
N
B
C
j
q
Y
u
C
C
v
C
C
"}
(12,1,1) = {"
M
C
C
y
C
C
C
s
q
h
b
C
o
q
C
M
"}
(13,1,1) = {"
M
C
C
q
z
q
v
q
q
q
q
C
r
C
C
M
"}
(14,1,1) = {"
M
M
C
C
q
q
O
q
q
q
R
C
C
C
M
M
"}
(15,1,1) = {"
M
M
M
C
C
C
C
q
K
I
C
C
C
M
M
M
"}
(16,1,1) = {"
M
M
M
M
M
C
C
C
C
C
C
M
M
M
M
M
"}
