//MAP CONVERTED BY dmm2tgm.py THIS HEADER COMMENT PREVENTS RECONVERSION, DO NOT REMOVE
"a" = (
/turf/simulated/wall/mineral/plastitanium,
/area/shuttle/supply)
"b" = (
/obj/effect/turf_decal{
	dir = 4
	},
/obj/machinery/light/spot{
	dir = 8
	},
/obj/structure/closet/emcloset,
/obj/effect/decal/cleanable/dirt,
/turf/simulated/floor/mineral/plastitanium,
/area/shuttle/supply)
"c" = (
/obj/structure/plasticflaps/mining,
/obj/machinery/conveyor{
	dir = 4;
	id = "QMLoad2"
	},
/turf/simulated/floor/plating,
/area/shuttle/supply)
"d" = (
/obj/machinery/camera{
	c_tag = "Cargo Shuttle"
	},
/turf/simulated/floor/catwalk,
/area/shuttle/supply)
"e" = (
/obj/effect/turf_decal{
	dir = 8
	},
/turf/simulated/floor/mineral/plastitanium,
/area/shuttle/supply)
"f" = (
/obj/machinery/light/spot{
	dir = 4
	},
/obj/machinery/computer{
	name = "nav"
	},
/obj/machinery/computer{
	name = "nav"
	},
/turf/simulated/floor/mineral/plastitanium,
/area/shuttle/supply)
"g" = (
/obj/effect/anomaly/grav,
/turf/simulated/wall/mineral/plastitanium,
/area/shuttle/supply)
"h" = (
/obj/effect/turf_decal,
/turf/simulated/floor/mineral/plastitanium,
/area/shuttle/supply)
"i" = (
/obj/effect/turf_decal{
	dir = 4
	},
/turf/simulated/floor/mineral/plastitanium,
/area/shuttle/supply)
"j" = (
/obj/effect/turf_decal{
	dir = 8
	},
/obj/machinery/computer/supplycomp,
/turf/simulated/floor/mineral/plastitanium,
/area/shuttle/supply)
"k" = (
/obj/machinery/door/airlock/external{
	id_tag = "supply_home";
	locked = 1;
	name = "Cargo Docking Hatch"
	},
/turf/simulated/floor/mineral/plastitanium,
/area/shuttle/supply)
"l" = (
/obj/machinery/conveyor{
	dir = 8;
	id = "QMLoad"
	},
/obj/structure/plasticflaps/mining,
/turf/simulated/floor/plating,
/area/shuttle/supply)
"o" = (
/turf/simulated/floor/catwalk,
/area/shuttle/supply)
"q" = (
/obj/structure/sign/poster/random,
/turf/simulated/wall/mineral/plastitanium,
/area/shuttle/supply)
"r" = (
/obj/machinery/computer{
	name = "fuel monitor"
	},
/turf/simulated/floor/mineral/plastitanium,
/area/shuttle/supply)
"t" = (
/obj/structure/window/reinforced{
	dir = 1
	},
/obj/structure/shuttle/engine/heater,
/turf/simulated/floor/plating/airless,
/area/shuttle/supply)
"u" = (
/obj/structure/window/reinforced,
/turf/simulated/floor/mineral/plastitanium,
/area/shuttle/supply)
"v" = (
/turf/space,
/area/space)
"w" = (
/obj/structure/shuttle/engine/propulsion{
	icon_state = "burst_l"
	},
/turf/simulated/floor/plating/airless,
/area/shuttle/supply)
"x" = (
/obj/structure/shuttle/engine/propulsion,
/turf/simulated/floor/plating/airless,
/area/shuttle/supply)
"y" = (
/obj/structure/shuttle/engine/propulsion{
	icon_state = "burst_r"
	},
/turf/simulated/floor/plating/airless,
/area/shuttle/supply)
"z" = (
/obj/effect/spawner/window/plastitanium,
/turf/simulated/floor/plating,
/area/shuttle/supply)
"D" = (
/obj/effect/decal/cleanable/dirt,
/turf/simulated/floor/catwalk,
/area/shuttle/supply)
"H" = (
/obj/effect/turf_decal/delivery/red,
/obj/merge_conflict_marker,
/turf/simulated/floor/catwalk,
/area/shuttle/supply)
"I" = (
/obj/machinery/light/spot{
	dir = 8
	},
/obj/machinery/computer{
	name = "Cargo Hold Storage Monitor"
	},
/turf/simulated/floor/mineral/plastitanium,
/area/shuttle/supply)
"J" = (
/obj/effect/turf_decal{
	dir = 8
	},
/obj/effect/decal/cleanable/dirt,
/turf/simulated/floor/mineral/plastitanium,
/area/shuttle/supply)
"N" = (
/obj/effect/decal/cleanable/dirt,
/turf/simulated/floor/mineral/plastitanium,
/area/shuttle/supply)
"O" = (
/obj/structure/chair/comfy/shuttle{
	dir = 1
	},
/obj/effect/decal/cleanable/dirt,
/turf/simulated/floor/mineral/plastitanium,
/area/shuttle/supply)
"P" = (
/obj/structure/window/reinforced,
/obj/machinery/camera{
	c_tag = "Cargo Shuttle Cockpit";
	dir = 8
	},
/turf/simulated/floor/mineral/plastitanium,
/area/shuttle/supply)
"Q" = (
/obj/structure/chair/comfy/shuttle{
	dir = 1
	},
/turf/simulated/floor/mineral/plastitanium,
/area/shuttle/supply)
"R" = (
/obj/effect/turf_decal{
	dir = 8
	},
/obj/machinery/light/spot{
	dir = 4
	},
/turf/simulated/floor/mineral/plastitanium,
/area/shuttle/supply)
"S" = (
/obj/effect/anomaly,
/turf/simulated/floor/mineral/plastitanium,
/area/shuttle/supply)
"U" = (
/turf/simulated/wall/mineral/plastitanium/nodiagonal,
/area/shuttle/supply)
"V" = (
/obj/effect/turf_decal{
	dir = 4
	},
/obj/structure/closet/firecloset,
/turf/simulated/floor/mineral/plastitanium,
/area/shuttle/supply)
"W" = (
/obj/machinery/door/window/classic/normal{
	name = "Cargo Shuttle Cockpit"
	},
/turf/simulated/floor/mineral/plastitanium,
/area/shuttle/supply)

(1,1,1) = {"
a
a
a
a
a
a
q
a
a
a
a
v
"}
(2,1,1) = {"
z
I
O
u
N
i
i
V
b
U
U
w
"}
(3,1,1) = {"
z
r
Q
W
h
o
o
o
o
H
t
x
"}
(4,1,1) = {"
z
f
Q
P
h
o
D
o
o
H
t
x
"}
(5,1,1) = {"
a
a
a
a
a
d
o
o
o
H
t
x
"}
(6,1,1) = {"
a
S
g
S
a
j
J
e
R
U
U
y
"}
(7,1,1) = {"
a
c
a
l
a
a
k
k
a
a
a
v
"}
