//MAP CONVERTED BY dmm2tgm.py THIS HEADER COMMENT PREVENTS RECONVERSION, DO NOT REMOVE
"a" = (
/turf/simulated/wall/mineral/plastitanium,
/area/shuttle/supply)
"e" = (
/obj/effect/turf_decal{
	dir = 8
	},
/turf/simulated/floor/mineral/plastitanium,
/area/shuttle/supply)
"f" = (
/obj/machinery/status_display{
	name = "cargo display";
	pixel_y = 32
	},
/turf/simulated/floor/catwalk,
/area/shuttle/supply)
"g" = (
/obj/machinery/conveyor{
	dir = 4;
	id = "QMLoad2"
	},
/obj/structure/plasticflaps/mining,
/turf/simulated/floor/plating,
/area/shuttle/supply)
"h" = (
/obj/machinery/door/airlock/external{
	id_tag = "s_docking_airlock";
	name = "Shuttle Hatch"
	},
/obj/effect/mapping_helpers/airlock/access/all/supply/general,
/turf/simulated/floor/plating,
/area/shuttle/supply)
"i" = (
/obj/effect/turf_decal{
	dir = 4
	},
/turf/simulated/floor/mineral/plastitanium,
/area/shuttle/supply)
"j" = (
/obj/machinery/door_control{
	id = "QMLoaddoor2";
	layer = 3;
	name = "Loading Doors";
	pixel_x = 24;
	pixel_y = 8
	},
/obj/machinery/door_control{
	id = "QMLoaddoor";
	layer = 3;
	name = "Loading Doors";
	pixel_x = 24;
	pixel_y = -8
	},
/obj/effect/turf_decal{
	dir = 8
	},
/turf/simulated/floor/mineral/plastitanium,
/area/shuttle/supply)
"k" = (
/obj/machinery/door/airlock/external{
	id_tag = "s_docking_airlock";
	name = "Shuttle Hatch"
	},
/obj/effect/mapping_helpers/airlock/access/all/supply/general,
/obj/docking_port/mobile/supply{
	timid = 1
	},
/turf/simulated/floor/plating,
/area/shuttle/supply)
"l" = (
/obj/machinery/conveyor{
	dir = 8;
	id = "QMLoad"
	},
/obj/structure/plasticflaps/mining,
/turf/simulated/floor/plating,
/area/shuttle/supply)
"o" = (
/turf/simulated/floor/catwalk,
/area/shuttle/supply)
"r" = (
/obj/effect/turf_decal{
	dir = 4
	},
/turf/simulated/wall/mineral/plastitanium/nodiagonal,
/area/shuttle/supply)
"t" = (
/obj/structure/window/reinforced{
	dir = 1
	},
/obj/structure/shuttle/engine/heater,
/turf/simulated/floor/plating/airless,
/area/shuttle/supply)
"v" = (
/turf/space,
/area/space)
"w" = (
/obj/structure/shuttle/engine/propulsion{
	icon_state = "burst_l"
	},
/turf/simulated/floor/plating/airless,
/area/shuttle/supply)
"x" = (
/obj/structure/shuttle/engine/propulsion,
/turf/simulated/floor/plating/airless,
/area/shuttle/supply)
"y" = (
/obj/structure/shuttle/engine/propulsion{
	icon_state = "burst_r"
	},
/turf/simulated/floor/plating/airless,
/area/shuttle/supply)
"H" = (
/obj/effect/turf_decal{
	dir = 8
	},
/turf/simulated/wall/mineral/plastitanium/nodiagonal,
/area/shuttle/supply)
"I" = (
/obj/effect/turf_decal{
	dir = 4
	},
/obj/machinery/light/spot{
	dir = 8
	},
/turf/simulated/floor/mineral/plastitanium,
/area/shuttle/supply)
"R" = (
/obj/effect/turf_decal{
	dir = 8
	},
/obj/machinery/light/spot{
	dir = 4
	},
/turf/simulated/floor/mineral/plastitanium,
/area/shuttle/supply)
"U" = (
/turf/simulated/wall/mineral/plastitanium/nodiagonal,
/area/shuttle/supply)

(1,1,1) = {"
a
a
a
a
a
a
a
a
a
a
a
v
"}
(2,1,1) = {"
a
I
i
i
i
i
i
i
I
r
U
w
"}
(3,1,1) = {"
a
o
o
o
o
o
o
o
o
o
t
x
"}
(4,1,1) = {"
a
f
o
o
o
o
o
o
o
o
t
x
"}
(5,1,1) = {"
a
o
o
o
o
o
o
o
o
o
t
x
"}
(6,1,1) = {"
a
R
e
e
e
j
e
e
R
H
U
y
"}
(7,1,1) = {"
a
a
a
g
h
a
k
l
a
a
a
v
"}
