//MAP CONVERTED BY dmm2tgm.py THIS HEADER COMMENT PREVENTS RECONVERSION, DO NOT REMOVE
"a" = (
/turf/simulated/wall/mineral/plastitanium,
/area/shuttle/supply)
"e" = (
/obj/effect/turf_decal{
	dir = 8
	},
/turf/simulated/floor/mineral/plastitanium,
/area/shuttle/supply)
"f" = (
/obj/machinery/status_display{
	name = "cargo display";
	pixel_y = 32
	},
/turf/simulated/floor/catwalk,
/area/shuttle/supply)
"h" = (
/obj/effect/turf_decal{
	dir = 8
	},
/turf/simulated/wall/mineral/plastitanium/nodiagonal,
/area/shuttle/supply)
"i" = (
/obj/effect/turf_decal{
	dir = 4
	},
/turf/simulated/floor/mineral/plastitanium,
/area/shuttle/supply)
"j" = (
/obj/machinery/door_control/no_emag{
	id = "QMLoaddoor2";
	layer = 3;
	name = "Loading Doors";
	pixel_x = 24;
	pixel_y = 8
	},
/obj/machinery/door_control/no_emag{
	id = "QMLoaddoor";
	layer = 3;
	name = "Loading Doors";
	pixel_x = 24;
	pixel_y = -8
	},
/obj/effect/turf_decal{
	dir = 8
	},
/turf/simulated/floor/mineral/plastitanium,
/area/shuttle/supply)
"k" = (
/obj/structure/plasticflaps/mining,
/obj/machinery/conveyor/west{
	id = "QMLoad"
	},
/turf/simulated/floor/plating,
/area/shuttle/supply)
"l" = (
/obj/structure/plasticflaps/mining,
/obj/machinery/conveyor/east{
	id = "QMLoad2"
	},
/turf/simulated/floor/plating,
/area/shuttle/supply)
"o" = (
/turf/simulated/floor/catwalk,
/area/shuttle/supply)
"q" = (
/obj/effect/turf_decal{
	dir = 4
	},
/turf/simulated/wall/mineral/plastitanium/nodiagonal,
/area/shuttle/supply)
"t" = (
/obj/structure/window/reinforced{
	dir = 1
	},
/obj/structure/shuttle/engine/heater,
/turf/simulated/floor/plating/airless,
/area/shuttle/supply)
"v" = (
/turf/space,
/area/space)
"w" = (
/obj/structure/shuttle/engine/propulsion{
	icon_state = "burst_l"
	},
/turf/simulated/floor/plating/airless,
/area/shuttle/supply)
"x" = (
/obj/structure/shuttle/engine/propulsion,
/turf/simulated/floor/plating/airless,
/area/shuttle/supply)
"y" = (
/obj/structure/shuttle/engine/propulsion{
	icon_state = "burst_r"
	},
/turf/simulated/floor/plating/airless,
/area/shuttle/supply)
"z" = (
/obj/effect/spawner/window/plastitanium,
/turf/simulated/floor/plating,
/area/shuttle/supply)
"D" = (
/obj/machinery/door/airlock/external{
	id_tag = "s_docking_airlock";
	name = "Shuttle Hatch"
	},
/obj/effect/mapping_helpers/airlock/access/all/supply/general,
/obj/structure/fans/tiny,
/turf/simulated/floor/plating,
/area/shuttle/supply)
"I" = (
/obj/effect/turf_decal{
	dir = 4
	},
/obj/machinery/light/spot{
	dir = 8
	},
/turf/simulated/floor/mineral/plastitanium,
/area/shuttle/supply)
"R" = (
/obj/effect/turf_decal{
	dir = 8
	},
/obj/machinery/light/spot{
	dir = 4
	},
/turf/simulated/floor/mineral/plastitanium,
/area/shuttle/supply)
"S" = (
/obj/machinery/door/airlock/external{
	id_tag = "s_docking_airlock";
	name = "Shuttle Hatch"
	},
/obj/effect/mapping_helpers/airlock/access/all/supply/general,
/obj/docking_port/mobile/supply,
/obj/docking_port/stationary{
	dir = 8;
	dwidth = 5;
	height = 7;
	id = "supply_away";
	name = "supply centcom";
	width = 12
	},
/obj/structure/fans/tiny,
/turf/simulated/floor/plating,
/area/shuttle/supply)
"U" = (
/turf/simulated/wall/mineral/plastitanium/nodiagonal,
/area/shuttle/supply)

(1,1,1) = {"
a
a
a
a
z
z
z
a
a
a
a
v
"}
(2,1,1) = {"
a
I
i
i
i
i
i
i
I
q
U
w
"}
(3,1,1) = {"
a
o
o
o
o
o
o
o
o
o
t
x
"}
(4,1,1) = {"
a
f
o
o
o
o
o
o
o
o
t
x
"}
(5,1,1) = {"
a
o
o
o
o
o
o
o
o
o
t
x
"}
(6,1,1) = {"
a
R
e
e
e
j
e
e
R
h
U
y
"}
(7,1,1) = {"
a
a
a
l
D
a
S
k
a
a
a
v
"}
