//MAP CONVERTED BY dmm2tgm.py THIS HEADER COMMENT PREVENTS RECONVERSION, DO NOT REMOVE
"aa" = (
/turf/space,
/area/space)
"ac" = (
/obj/structure/grille,
/obj/structure/window/full/shuttle,
/turf/simulated/floor/shuttle/plating,
/area/shuttle/escape)
"ag" = (
/obj/machinery/door/airlock/shuttle{
	id_tag = "s_docking_airlock";
	name = "Emergency Shuttle Airlock";
	req_access = list(2)
	},
/turf/simulated/floor/shuttle,
/area/shuttle/escape)
"ah" = (
/obj/structure/sign/nosmoking_2,
/turf/simulated/wall/shuttle,
/area/shuttle/escape)
"ai" = (
/obj/machinery/door/airlock/shuttle{
	id_tag = "s_docking_airlock";
	name = "Emergency Shuttle Airlock"
	},
/turf/simulated/floor/shuttle,
/area/shuttle/escape)
"ao" = (
/obj/structure/table,
/obj/item/phone{
	pixel_x = -3;
	pixel_y = 3
	},
/obj/item/cigbutt/cigarbutt{
	pixel_x = 5;
	pixel_y = -1
	},
/turf/simulated/floor/shuttle,
/area/shuttle/escape)
"ap" = (
/obj/machinery/computer/crew,
/turf/simulated/floor/shuttle,
/area/shuttle/escape)
"aq" = (
/obj/machinery/computer/security,
/turf/simulated/floor/shuttle,
/area/shuttle/escape)
"ar" = (
/obj/structure/table,
/obj/item/storage/firstaid/regular,
/turf/simulated/floor/shuttle,
/area/shuttle/escape)
"at" = (
/obj/structure/closet/emcloset,
/turf/simulated/floor/shuttle{
	icon_state = "floor3"
	},
/area/shuttle/escape)
"au" = (
/turf/simulated/floor/shuttle,
/area/shuttle/escape)
"av" = (
/obj/structure/chair/comfy/shuttle,
/turf/simulated/floor/shuttle{
	icon_state = "floor3"
	},
/area/shuttle/escape)
"aw" = (
/obj/machinery/light{
	dir = 1;
	on = 1
	},
/obj/structure/chair/comfy/shuttle,
/turf/simulated/floor/shuttle{
	icon_state = "floor3"
	},
/area/shuttle/escape)
"ax" = (
/obj/item/radio/intercom{
	dir = 4;
	name = "Station Intercom (General)";
	pixel_y = 27
	},
/obj/structure/chair/comfy/shuttle,
/turf/simulated/floor/shuttle{
	icon_state = "floor3"
	},
/area/shuttle/escape)
"ay" = (
/obj/structure/closet/crate{
	name = "lifejackets"
	},
/obj/item/clothing/suit/storage/hazardvest,
/obj/item/clothing/suit/storage/hazardvest,
/obj/item/clothing/suit/storage/hazardvest,
/obj/item/clothing/suit/storage/hazardvest,
/obj/item/clothing/suit/storage/hazardvest,
/obj/item/tank/internals/emergency_oxygen/engi,
/obj/item/tank/internals/emergency_oxygen/engi,
/obj/item/tank/internals/emergency_oxygen/engi,
/obj/item/tank/internals/emergency_oxygen/engi,
/obj/item/tank/internals/emergency_oxygen/engi,
/obj/item/clothing/mask/breath{
	pixel_x = -5;
	pixel_y = -2
	},
/obj/item/clothing/mask/breath{
	pixel_x = -5;
	pixel_y = -2
	},
/obj/item/clothing/mask/breath{
	pixel_x = -5;
	pixel_y = -2
	},
/obj/item/clothing/mask/breath{
	pixel_x = -5;
	pixel_y = -2
	},
/obj/item/clothing/mask/breath{
	pixel_x = -5;
	pixel_y = -2
	},
/obj/item/clothing/head/hardhat,
/obj/item/clothing/head/hardhat,
/obj/item/clothing/head/hardhat,
/obj/item/clothing/head/hardhat,
/obj/item/clothing/head/hardhat,
/turf/simulated/floor/shuttle{
	icon_state = "floor3"
	},
/area/shuttle/escape)
"aA" = (
/obj/structure/shuttle/engine/propulsion{
	dir = 8;
	tag = "icon-propulsion (EAST)"
	},
/turf/simulated/floor/shuttle/plating,
/area/shuttle/escape)
"aB" = (
/obj/structure/shuttle/engine/heater{
	dir = 8;
	tag = "icon-heater (WEST)"
	},
/obj/structure/window/reinforced{
	dir = 4
	},
/turf/simulated/floor/shuttle/plating,
/area/shuttle/escape)
"aC" = (
/obj/structure/table,
/obj/item/storage/fancy,
/turf/simulated/floor/shuttle,
/area/shuttle/escape)
"aD" = (
/obj/structure/chair/comfy/shuttle{
	dir = 1
	},
/turf/simulated/floor/shuttle,
/area/shuttle/escape)
"aE" = (
/obj/structure/table,
/obj/item/restraints/handcuffs,
/turf/simulated/floor/shuttle,
/area/shuttle/escape)
"aF" = (
/obj/machinery/status_display,
/turf/simulated/wall/shuttle,
/area/shuttle/escape)
"aG" = (
/obj/structure/dispenser/oxygen{
	layer = 2.7;
	pixel_x = -1;
	pixel_y = 2
	},
/turf/simulated/floor/shuttle{
	icon_state = "floor3"
	},
/area/shuttle/escape)
"aH" = (
/obj/structure/shuttle/engine/propulsion{
	dir = 8;
	icon_state = "propulsion_r";
	tag = "icon-propulsion_r (EAST)"
	},
/turf/simulated/floor/shuttle/plating,
/area/shuttle/escape)
"aI" = (
/obj/structure/shuttle/engine/heater{
	dir = 8;
	tag = "icon-heater (WEST)"
	},
/obj/structure/window/reinforced{
	dir = 4
	},
/obj/machinery/light{
	dir = 4
	},
/turf/simulated/floor/shuttle/plating,
/area/shuttle/escape)
"aJ" = (
/obj/machinery/computer/communications,
/turf/simulated/floor/shuttle,
/area/shuttle/escape)
"aK" = (
/obj/structure/chair/comfy/shuttle,
/turf/simulated/floor/shuttle,
/area/shuttle/escape)
"aL" = (
/obj/structure/chair/comfy/shuttle{
	dir = 1
	},
/turf/simulated/floor/shuttle{
	icon_state = "floor3"
	},
/area/shuttle/escape)
"aM" = (
/obj/machinery/light,
/obj/structure/chair/comfy/shuttle{
	dir = 1
	},
/turf/simulated/floor/shuttle{
	icon_state = "floor3"
	},
/area/shuttle/escape)
"aN" = (
/obj/structure/closet/crate{
	name = "lifejackets"
	},
/obj/item/clothing/suit/storage/hazardvest,
/obj/item/clothing/suit/storage/hazardvest,
/obj/item/clothing/suit/storage/hazardvest,
/obj/item/clothing/suit/storage/hazardvest,
/obj/item/clothing/suit/storage/hazardvest,
/obj/item/tank/internals/emergency_oxygen/engi,
/obj/item/tank/internals/emergency_oxygen/engi,
/obj/item/tank/internals/emergency_oxygen/engi,
/obj/item/tank/internals/emergency_oxygen/engi,
/obj/item/tank/internals/emergency_oxygen/engi,
/obj/item/clothing/mask/breath{
	pixel_x = -5;
	pixel_y = -2
	},
/obj/item/clothing/mask/breath{
	pixel_x = -5;
	pixel_y = -2
	},
/obj/item/clothing/mask/breath{
	pixel_x = -5;
	pixel_y = -2
	},
/obj/item/clothing/mask/breath{
	pixel_x = -5;
	pixel_y = -2
	},
/obj/item/clothing/mask/breath{
	pixel_x = -5;
	pixel_y = -2
	},
/obj/item/clothing/head/hardhat,
/obj/item/clothing/head/hardhat,
/obj/item/clothing/head/hardhat,
/obj/item/clothing/head/hardhat,
/obj/item/clothing/head/hardhat,
/obj/machinery/light{
	dir = 4
	},
/turf/simulated/floor/shuttle{
	icon_state = "floor3"
	},
/area/shuttle/escape)
"aO" = (
/obj/structure/shuttle/engine/propulsion{
	dir = 8;
	icon_state = "burst_l"
	},
/turf/simulated/floor/shuttle/plating,
/area/shuttle/escape)
"aP" = (
/obj/machinery/computer/emergency_shuttle,
/obj/machinery/light{
	dir = 8
	},
/turf/simulated/floor/shuttle,
/area/shuttle/escape)
"aQ" = (
/obj/structure/chair/comfy/shuttle{
	dir = 8
	},
/turf/simulated/floor/shuttle,
/area/shuttle/escape)
"aR" = (
/obj/machinery/door/airlock/command/glass{
	name = "Cockpit";
	req_access = list(19)
	},
/turf/simulated/floor/shuttle,
/area/shuttle/escape)
"aS" = (
/obj/machinery/vending/wallmed{
	name = "Emergency NanoMed";
	use_power = 0
	},
/turf/simulated/wall/shuttle,
/area/shuttle/escape)
"aU" = (
/obj/machinery/computer/atmos_alert,
/turf/simulated/floor/shuttle,
/area/shuttle/escape)
"aW" = (
/obj/machinery/light{
	dir = 1
	},
/obj/structure/chair/comfy/shuttle,
/turf/simulated/floor/shuttle{
	icon_state = "floor3"
	},
/area/shuttle/escape)
"aX" = (
/obj/machinery/hologram/holopad,
/obj/machinery/status_display{
	dir = 4;
	layer = 4;
	pixel_x = 32
	},
/turf/simulated/floor/shuttle,
/area/shuttle/escape)
"aY" = (
/obj/structure/table,
/obj/item/storage/toolbox/emergency,
/turf/simulated/floor/shuttle,
/area/shuttle/escape)
"aZ" = (
/obj/machinery/light{
	dir = 8
	},
/turf/simulated/floor/shuttle,
/area/shuttle/escape)
"ba" = (
/obj/structure/table,
/obj/machinery/recharger{
	active_power_usage = 0;
	idle_power_usage = 0;
	use_power = 0
	},
/turf/simulated/floor/shuttle,
/area/shuttle/escape)
"bb" = (
/obj/structure/table,
/obj/item/radio/intercom{
	name = "Station Intercom (General)";
	pixel_y = -28
	},
/obj/item/paper_bin{
	pixel_x = -3;
	pixel_y = 7
	},
/turf/simulated/floor/shuttle,
/area/shuttle/escape)
"bc" = (
/obj/structure/table,
/obj/item/folder/blue,
/obj/structure/extinguisher_cabinet{
	pixel_y = -30
	},
/turf/simulated/floor/shuttle,
/area/shuttle/escape)
"bd" = (
/obj/item/radio/intercom{
	name = "Station Intercom (General)";
	pixel_y = -28
	},
/obj/machinery/light,
/obj/structure/chair/comfy/shuttle{
	dir = 1
	},
/turf/simulated/floor/shuttle{
	icon_state = "floor3"
	},
/area/shuttle/escape)
"be" = (
/obj/structure/table,
/obj/item/healthanalyzer,
/obj/item/healthanalyzer{
	pixel_x = 3;
	pixel_y = 3
	},
/obj/item/stack/medical/ointment,
/obj/item/stack/medical/bruise_pack,
/obj/machinery/light{
	dir = 4
	},
/turf/simulated/floor/shuttle{
	icon_state = "floor3"
	},
/area/shuttle/escape)
"bg" = (
/obj/structure/extinguisher_cabinet,
/turf/simulated/wall/shuttle,
/area/shuttle/escape)
"bh" = (
/obj/machinery/door/airlock/command{
	name = "Emergency Recovery Airlock";
	req_access = list(19)
	},
/turf/simulated/floor/shuttle,
/area/shuttle/escape)
"bj" = (
/obj/machinery/door/airlock/security/glass{
	name = "Brig";
	req_access = list(2)
	},
/turf/simulated/floor/shuttle{
	icon_state = "floor4"
	},
/area/shuttle/escape)
"bl" = (
/obj/machinery/door/airlock/medical/glass{
	id_tag = null;
	name = "Escape Shuttle Infirmary"
	},
/turf/simulated/floor/shuttle,
/area/shuttle/escape)
"bn" = (
/obj/machinery/door/airlock/shuttle{
	name = "Emergency Shuttle Cargo Bay Airlock"
	},
/turf/simulated/floor/shuttle,
/area/shuttle/escape)
"bo" = (
/obj/structure/chair/comfy/shuttle{
	dir = 4
	},
/turf/simulated/floor/shuttle/plating{
	icon_state = "floorgrime"
	},
/area/shuttle/escape)
"bp" = (
/turf/simulated/floor/shuttle/plating{
	icon_state = "floorgrime"
	},
/area/shuttle/escape)
"bq" = (
/obj/machinery/door/airlock/external{
	name = "Emergency Recovery Airlock"
	},
/turf/simulated/floor/shuttle/plating{
	icon_state = "floorgrime"
	},
/area/shuttle/escape)
"br" = (
/turf/simulated/floor/shuttle{
	icon_state = "floor4"
	},
/area/shuttle/escape)
"bs" = (
/obj/structure/chair/comfy/shuttle{
	dir = 4
	},
/turf/simulated/floor/shuttle{
	icon_state = "floor4"
	},
/area/shuttle/escape)
"bt" = (
/obj/structure/chair/comfy/shuttle,
/turf/simulated/floor/shuttle{
	icon_state = "floor4"
	},
/area/shuttle/escape)
"bu" = (
/obj/structure/table,
/obj/item/defibrillator,
/turf/simulated/floor/shuttle,
/area/shuttle/escape)
"bv" = (
/obj/machinery/shower,
/turf/simulated/floor/shuttle,
/area/shuttle/escape)
"bw" = (
/obj/machinery/sleeper,
/obj/machinery/light{
	dir = 4
	},
/turf/simulated/floor/shuttle,
/area/shuttle/escape)
"bx" = (
/obj/structure/rack,
/obj/item/crowbar,
/obj/item/wrench,
/obj/item/weldingtool,
/obj/item/wirecutters,
/obj/item/stack/cable_coil,
/turf/simulated/floor/shuttle/plating{
	dir = 4;
	icon_state = "warning"
	},
/area/shuttle/escape)
"by" = (
/obj/structure/reagent_dispensers/watertank,
/turf/simulated/floor/shuttle/plating{
	dir = 1;
	icon_state = "delivery"
	},
/area/shuttle/escape)
"bz" = (
/obj/structure/reagent_dispensers/fueltank,
/obj/machinery/light{
	dir = 1;
	on = 1
	},
/turf/simulated/floor/shuttle/plating{
	dir = 1;
	icon_state = "delivery"
	},
/area/shuttle/escape)
"bA" = (
/turf/simulated/floor/shuttle/plating{
	dir = 1;
	icon_state = "delivery"
	},
/area/shuttle/escape)
"bB" = (
/obj/machinery/recharge_station,
/turf/simulated/floor/shuttle/plating{
	dir = 1;
	icon_state = "delivery"
	},
/area/shuttle/escape)
"bE" = (
/obj/structure/reagent_dispensers/peppertank{
	pixel_x = 31
	},
/obj/structure/chair/comfy/shuttle{
	dir = 8
	},
/turf/simulated/floor/shuttle{
	icon_state = "floor4"
	},
/area/shuttle/escape)
"bF" = (
/obj/structure/table,
/obj/item/reagent_containers/glass/bottle/epinephrine{
	pixel_x = 6
	},
/obj/item/reagent_containers/glass/bottle/charcoal{
	pixel_x = -3
	},
/obj/item/reagent_containers/glass/bottle/epinephrine{
	pixel_x = -3;
	pixel_y = 8
	},
/obj/item/reagent_containers/glass/bottle/charcoal{
	pixel_x = 6;
	pixel_y = 8
	},
/obj/item/reagent_containers/syringe/epinephrine{
	pixel_x = 3;
	pixel_y = -2
	},
/obj/item/reagent_containers/syringe/epinephrine{
	pixel_x = 4;
	pixel_y = 1
	},
/obj/item/reagent_containers/syringe/epinephrine{
	pixel_x = -2;
	pixel_y = 5
	},
/obj/item/reagent_containers/syringe/epinephrine{
	pixel_x = 2;
	pixel_y = 8
	},
/turf/simulated/floor/shuttle,
/area/shuttle/escape)
"bG" = (
/obj/machinery/sleeper,
/turf/simulated/floor/shuttle,
/area/shuttle/escape)
"bH" = (
/obj/structure/rack,
/obj/item/storage/toolbox/electrical{
	pixel_x = -3;
	pixel_y = 1
	},
/obj/item/storage/toolbox/mechanical{
	pixel_y = -1
	},
/obj/item/storage/toolbox/emergency{
	pixel_x = 3;
	pixel_y = -5
	},
/turf/simulated/floor/shuttle/plating{
	dir = 4;
	icon_state = "warning"
	},
/area/shuttle/escape)
"bI" = (
/obj/machinery/light{
	dir = 8
	},
/obj/structure/chair/comfy/shuttle{
	dir = 4
	},
/turf/simulated/floor/shuttle/plating{
	icon_state = "floorgrime"
	},
/area/shuttle/escape)
"bJ" = (
/obj/machinery/suit_storage_unit/standard_unit,
/turf/simulated/floor/shuttle/plating{
	icon_state = "floorgrime"
	},
/area/shuttle/escape)
"bK" = (
/obj/machinery/light{
	dir = 8
	},
/obj/structure/chair/comfy/shuttle{
	dir = 4
	},
/turf/simulated/floor/shuttle{
	icon_state = "floor4"
	},
/area/shuttle/escape)
"bL" = (
/obj/structure/chair/comfy/shuttle{
	dir = 8
	},
/turf/simulated/floor/shuttle{
	icon_state = "floor4"
	},
/area/shuttle/escape)
"bM" = (
/obj/machinery/optable,
/obj/machinery/light{
	dir = 8
	},
/turf/simulated/floor/shuttle,
/area/shuttle/escape)
"bN" = (
/turf/simulated/floor/shuttle/plating{
	dir = 4;
	icon_state = "warning"
	},
/area/shuttle/escape)
"bP" = (
/obj/structure/reagent_dispensers/watertank,
/turf/simulated/floor/shuttle/plating{
	icon_state = "floorgrime"
	},
/area/shuttle/escape)
"bQ" = (
/obj/structure/table,
/obj/item/folder/red{
	pixel_x = 3
	},
/obj/item/folder/white{
	pixel_x = -4;
	pixel_y = 2
	},
/obj/item/book/manual/security_space_law{
	pixel_x = -4;
	pixel_y = 4
	},
/obj/item/radio/intercom{
	name = "Station Intercom (General)";
	pixel_y = -28
	},
/turf/simulated/floor/shuttle/objective_check,
/area/shuttle/escape)
"bR" = (
/obj/structure/table,
/obj/machinery/recharger{
	active_power_usage = 0;
	idle_power_usage = 0;
	use_power = 0
	},
/turf/simulated/floor/shuttle{
	icon_state = "floor4"
	},
/area/shuttle/escape)
"bS" = (
/obj/structure/table,
/obj/item/restraints/handcuffs,
/turf/simulated/floor/shuttle{
	icon_state = "floor4"
	},
/area/shuttle/escape)
"bT" = (
/obj/structure/table,
/obj/item/storage/box/handcuffs,
/turf/simulated/floor/shuttle{
	icon_state = "floor4"
	},
/area/shuttle/escape)
"bU" = (
/obj/structure/table,
/obj/item/scalpel{
	pixel_y = 12
	},
/obj/item/circular_saw,
/obj/item/retractor{
	pixel_x = 4
	},
/obj/item/hemostat{
	pixel_x = -4
	},
/obj/item/clothing/gloves/color/latex,
/obj/item/clothing/mask/surgical,
/obj/item/radio/intercom{
	dir = 4;
	name = "Station Intercom (General)";
	pixel_y = -27
	},
/turf/simulated/floor/shuttle,
/area/shuttle/escape)
"bV" = (
/obj/structure/sink,
/turf/simulated/floor/shuttle,
/area/shuttle/escape)
"bW" = (
/obj/structure/table,
/obj/item/storage/firstaid/fire,
/obj/item/storage/firstaid/regular{
	pixel_x = 2;
	pixel_y = 3
	},
/turf/simulated/floor/shuttle,
/area/shuttle/escape)
"bX" = (
/obj/structure/table,
/obj/item/storage/firstaid/toxin,
/obj/item/storage/firstaid/o2{
	pixel_x = 3;
	pixel_y = 3
	},
/turf/simulated/floor/shuttle,
/area/shuttle/escape)
"bY" = (
/obj/structure/sign/redcross,
/turf/simulated/wall/shuttle,
/area/shuttle/escape)
"bZ" = (
/obj/structure/rack{
	dir = 1
	},
/obj/item/tank/internals/oxygen,
/obj/item/clothing/suit/fire/firefighter,
/obj/item/clothing/mask/gas,
/obj/item/clothing/head/hardhat/red,
/turf/simulated/floor/shuttle/plating{
	dir = 4;
	icon_state = "warning"
	},
/area/shuttle/escape)
"ca" = (
/obj/structure/extinguisher_cabinet{
	pixel_y = -30
	},
/obj/machinery/space_heater,
/turf/simulated/floor/shuttle/plating{
	icon_state = "bot"
	},
/area/shuttle/escape)
"cb" = (
/obj/structure/closet/crate{
	name = "emergency supplies crate"
	},
/obj/item/storage/toolbox/emergency,
/obj/item/storage/toolbox/emergency,
/obj/item/flashlight/flare{
	pixel_x = 3;
	pixel_y = 3
	},
/obj/item/flashlight/flare{
	pixel_x = -6;
	pixel_y = -2
	},
/obj/item/crowbar,
/obj/item/wrench,
/obj/item/radio,
/turf/simulated/floor/shuttle/plating{
	icon_state = "bot"
	},
/area/shuttle/escape)
"cc" = (
/obj/structure/closet/crate/medical,
/obj/item/storage/firstaid/regular,
/obj/item/storage/firstaid/o2{
	pixel_x = 3;
	pixel_y = 3
	},
/obj/item/storage/firstaid/toxin{
	pixel_x = -4;
	pixel_y = 3
	},
/obj/item/healthanalyzer{
	pixel_x = 3;
	pixel_y = 3
	},
/obj/item/lazarus_injector,
/mob/living/simple_animal/bot/medbot{
	name = "\improper emergency medibot";
	pixel_x = -3;
	pixel_y = 2
	},
/turf/simulated/floor/shuttle/plating{
	icon_state = "bot"
	},
/area/shuttle/escape)
"cd" = (
/obj/item/radio/intercom{
	name = "Station Intercom (General)";
	pixel_y = -28
	},
/obj/machinery/portable_atmospherics/canister/oxygen,
/obj/machinery/light,
/turf/simulated/floor/shuttle/plating{
	icon_state = "bot"
	},
/area/shuttle/escape)
"ce" = (
/obj/structure/table,
/obj/item/clipboard,
/obj/item/folder/yellow,
/obj/item/pen,
/turf/simulated/floor/shuttle/plating{
	icon_state = "bot"
	},
/area/shuttle/escape)
"ch" = (
/turf/simulated/wall/shuttle,
/area/shuttle/escape)
"ci" = (
/obj/docking_port/mobile/emergency{
	dir = 2;
	dwidth = 5;
	height = 14;
	name = "Meta emergency shuttle";
	timid = 1;
	width = 25
	},
/obj/machinery/door/airlock/shuttle{
	id_tag = "s_docking_airlock";
	name = "Emergency Shuttle Airlock"
	},
/turf/simulated/floor/shuttle,
/area/shuttle/escape)
"SL" = (
/obj/structure/window/full/shuttle,
/obj/structure/grille,
/turf/simulated/floor/plating,
/area/shuttle/escape)

(1,1,1) = {"
aa
aa
aO
aA
aH
ch
aO
aH
ch
aO
aA
aH
aa
aa
"}
(2,1,1) = {"
aa
ch
aB
aI
aB
ch
aB
aI
ch
aB
aI
aB
ch
aa
"}
(3,1,1) = {"
ch
ch
ch
ch
ch
ch
ch
ch
ch
ch
ch
ch
ch
ch
"}
(4,1,1) = {"
SL
ao
aC
aJ
aP
aU
aY
ba
bg
bo
bo
bI
bP
SL
"}
(5,1,1) = {"
SL
ap
au
aK
aQ
aD
au
bb
ch
bp
bp
bp
bp
bq
"}
(6,1,1) = {"
SL
aq
aD
au
au
au
aK
bc
ch
bq
ch
bp
bp
bq
"}
(7,1,1) = {"
SL
ar
aE
au
au
au
au
au
bh
br
ch
bJ
bJ
SL
"}
(8,1,1) = {"
ch
ch
aF
ch
aR
ch
ch
ch
ch
ch
ch
aF
ch
ch
"}
(9,1,1) = {"
ch
at
au
au
au
au
aZ
at
ch
bs
bs
bK
bQ
ch
"}
(10,1,1) = {"
SL
au
au
au
au
au
au
au
bj
br
br
br
bR
SL
"}
(11,1,1) = {"
ch
av
au
aL
SL
av
au
aL
SL
bt
br
br
bS
SL
"}
(12,1,1) = {"
ai
au
au
aM
aS
aW
au
aL
ch
bt
bE
bL
bT
ch
"}
(13,1,1) = {"
ac
aw
au
aL
SL
av
au
bd
ch
ch
ch
ch
ch
ch
"}
(14,1,1) = {"
ai
au
au
aL
bg
av
au
aL
ch
bu
bF
bM
bU
ch
"}
(15,1,1) = {"
ah
av
au
aL
SL
av
au
aL
SL
bv
au
au
bV
SL
"}
(16,1,1) = {"
SL
av
au
au
au
au
au
au
bl
au
au
au
bW
SL
"}
(17,1,1) = {"
SL
aw
au
aL
SL
av
au
aL
SL
bw
bG
au
bX
ch
"}
(18,1,1) = {"
SL
av
au
aL
bg
av
au
aL
bY
ch
SL
bl
bY
ch
"}
(19,1,1) = {"
ch
ax
au
aL
SL
av
au
aM
ch
bx
bH
bN
bZ
ch
"}
(20,1,1) = {"
ci
au
au
aM
aS
aW
au
aL
SL
by
bp
bp
ca
ch
"}
(21,1,1) = {"
SL
av
au
aL
SL
av
au
aL
bg
bz
bp
bp
cb
SL
"}
(22,1,1) = {"
ag
au
au
au
au
au
au
au
bn
bA
bp
bp
cc
SL
"}
(23,1,1) = {"
ch
au
au
au
au
au
au
au
bn
bA
bp
bp
cd
ch
"}
(24,1,1) = {"
ch
ay
aG
aN
au
aX
au
be
ch
bB
bA
bA
ce
ch
"}
(25,1,1) = {"
ch
ch
SL
ch
SL
ch
SL
ch
ch
ch
SL
SL
ch
ch
"}
