//MAP CONVERTED BY dmm2tgm.py THIS HEADER COMMENT PREVENTS RECONVERSION, DO NOT REMOVE
"aa" = (
/obj/machinery/door/airlock/cult/glass/friendly,
/turf/simulated/floor/engine/cult,
/area/shuttle/escape)
"ab" = (
/turf/simulated/wall/cult,
/area/shuttle/escape)
"ac" = (
/obj/effect/decal/remains/robot,
/turf/simulated/floor/engine/cult,
/area/shuttle/escape)
"ad" = (
/obj/machinery/computer/emergency_shuttle,
/turf/simulated/floor/engine/cult,
/area/shuttle/escape)
"ae" = (
/obj/machinery/computer/security,
/turf/simulated/floor/engine/cult,
/area/shuttle/escape)
"af" = (
/obj/structure/chair/comfy/shuttle{
	dir = 1
	},
/turf/simulated/floor/engine/cult,
/area/shuttle/escape)
"ag" = (
/obj/machinery/computer/communications,
/turf/simulated/floor/engine/cult,
/area/shuttle/escape)
"ah" = (
/mob/living/simple_animal/hostile/construct/wraith,
/turf/simulated/floor/engine/cult,
/area/shuttle/escape)
"aj" = (
/turf/simulated/floor/engine/cult,
/area/shuttle/escape)
"ak" = (
/obj/structure/cult/pylon,
/turf/simulated/floor/engine/cult,
/area/shuttle/escape)
"al" = (
/turf/template_noop,
/area/template_noop)
"am" = (
/obj/effect/decal/remains/human{
	desc = "This guy seemed to have died in terrible way! Half his remains are dust.";
	name = "Human remains"
	},
/turf/simulated/floor/engine/cult,
/area/shuttle/escape)
"an" = (
/obj/machinery/computer/robotics{
	dir = 4
	},
/turf/simulated/floor/engine/cult,
/area/shuttle/escape)
"ao" = (
/obj/structure/chair/comfy/shuttle{
	dir = 8
	},
/turf/simulated/floor/engine/cult,
/area/shuttle/escape)
"ap" = (
/obj/item/radio/intercom{
	pixel_y = 28
	},
/turf/simulated/floor/engine/cult,
/area/shuttle/escape)
"ar" = (
/obj/machinery/status_display,
/turf/simulated/wall/cult,
/area/shuttle/escape)
"as" = (
/obj/machinery/computer/crew,
/turf/simulated/floor/engine/cult,
/area/shuttle/escape)
"at" = (
/obj/structure/cult/forge,
/turf/simulated/floor/engine/cult,
/area/shuttle/escape)
"au" = (
/obj/structure/chair/comfy/shuttle,
/turf/simulated/floor/engine/cult,
/area/shuttle/escape)
"av" = (
/obj/item/flag/cult,
/turf/simulated/floor/engine/cult,
/area/shuttle/escape)
"aw" = (
/obj/machinery/computer/card,
/turf/simulated/floor/engine/cult,
/area/shuttle/escape)
"ax" = (
/obj/structure/closet/walllocker/emerglocker/directional/west,
/turf/simulated/floor/engine/cult,
/area/shuttle/escape)
"ay" = (
/obj/machinery/status_display{
	pixel_y = 30
	},
/obj/structure/chair/comfy/shuttle,
/turf/simulated/floor/engine/cult,
/area/shuttle/escape)
"az" = (
/obj/structure/cult/altar,
/turf/simulated/floor/engine/cult,
/area/shuttle/escape)
"aA" = (
/obj/docking_port/mobile/emergency{
	dwidth = 11;
	height = 13;
	name = "Shuttle 667";
	timid = 1;
	width = 24
	},
/obj/machinery/door/airlock/cult/glass/friendly,
/turf/simulated/floor/engine/cult,
/area/shuttle/escape)
"aB" = (
/obj/machinery/computer/med_data,
/turf/simulated/floor/engine/cult,
/area/shuttle/escape)
"aE" = (
/obj/effect/spawner/window/reinforced/grilled{
	color = "red"
	},
/turf/simulated/floor/plating,
/area/shuttle/escape)
"aF" = (
/obj/structure/chair/comfy/shuttle{
	dir = 4
	},
/turf/simulated/floor/engine/cult,
/area/shuttle/escape)
"aG" = (
/obj/structure/closet/walllocker/emerglocker/directional/north,
/obj/structure/table/wood,
/turf/simulated/floor/engine/cult,
/area/shuttle/escape)
"aH" = (
/obj/machinery/door/airlock/cult/glass/friendly,
/obj/structure/fans/tiny,
/turf/simulated/floor/engine/cult,
/area/shuttle/escape)
"aI" = (
/obj/item/candle/eternal,
/obj/effect/decal/cleanable/blood/writing,
/turf/simulated/floor/engine/cult,
/area/shuttle/escape)
"aJ" = (
/obj/machinery/computer/secure_data,
/turf/simulated/floor/engine/cult,
/area/shuttle/escape)
"aK" = (
/obj/effect/decal/remains/xeno,
/turf/simulated/floor/engine/cult,
/area/shuttle/escape)
"aL" = (
/mob/living/simple_animal/hostile/construct/armoured,
/turf/simulated/floor/engine/cult,
/area/shuttle/escape)
"aM" = (
/obj/machinery/status_display{
	pixel_y = 30
	},
/turf/simulated/floor/engine/cult,
/area/shuttle/escape)
"aN" = (
/mob/living/simple_animal/hostile/construct/builder,
/turf/simulated/floor/engine/cult,
/area/shuttle/escape)
"aO" = (
/mob/living/simple_animal/hostile/construct/behemoth,
/turf/simulated/floor/engine/cult,
/area/shuttle/escape)
"aP" = (
/obj/machinery/computer/atmos_alert{
	dir = 8
	},
/turf/simulated/floor/engine/cult,
/area/shuttle/escape)
"aQ" = (
/obj/machinery/computer/station_alert{
	dir = 8
	},
/turf/simulated/floor/engine/cult,
/area/shuttle/escape)
"aS" = (
/obj/structure/closet/walllocker/emerglocker/directional/west,
/obj/structure/chair/comfy/shuttle{
	dir = 4
	},
/turf/simulated/floor/engine/cult,
/area/shuttle/escape)
"aV" = (
/mob/living/simple_animal/hostile/construct/harvester,
/turf/simulated/floor/engine/cult,
/area/shuttle/escape)
"aW" = (
/obj/structure/dresser,
/turf/simulated/floor/engine/cult,
/area/shuttle/escape)
"aX" = (
/obj/structure/table,
/obj/item/storage/firstaid/o2{
	layer = 2.8;
	pixel_x = 4;
	pixel_y = 6
	},
/obj/item/storage/firstaid/regular{
	pixel_x = 2;
	pixel_y = 6
	},
/obj/item/storage/firstaid/regular{
	pixel_x = -2;
	pixel_y = 4
	},
/obj/item/bodybag{
	pixel_x = 5
	},
/turf/simulated/floor/engine/cult,
/area/shuttle/escape)
"aY" = (
/obj/effect/decal/cleanable/blood/footprints,
/turf/simulated/floor/engine/cult,
/area/shuttle/escape)
"aZ" = (
/obj/structure/showcase/horrific_experiment,
/turf/simulated/floor/engine/cult,
/area/shuttle/escape)
"bb" = (
/obj/structure/table/wood,
/turf/simulated/floor/engine/cult,
/area/shuttle/escape)
"bc" = (
/obj/effect/decal/cleanable/blood/gibs,
/turf/simulated/floor/engine/cult,
/area/shuttle/escape)
"bd" = (
/obj/effect/decal/cleanable/blood/splatter,
/obj/effect/decal/cleanable/blood/gibs,
/turf/simulated/floor/engine/cult,
/area/shuttle/escape)
"be" = (
/obj/structure/table/wood,
/obj/item/tome,
/turf/simulated/floor/engine/cult,
/area/shuttle/escape)
"bf" = (
/obj/structure/bed,
/obj/item/bedsheet/cult,
/turf/simulated/floor/engine/cult,
/area/shuttle/escape)
"bg" = (
/obj/machinery/sleeper{
	dir = 1;
	icon_state = "sleeper"
	},
/obj/effect/decal/cleanable/blood/splatter,
/turf/simulated/floor/engine/cult,
/area/shuttle/escape)
"bh" = (
/obj/structure/window/reinforced{
	dir = 1
	},
/obj/structure/shuttle/engine/heater,
/obj/structure/cult/forge,
/turf/simulated/floor/plating/airless,
/area/shuttle/escape)
"bi" = (
/obj/structure/shuttle/engine/heater,
/obj/structure/window/reinforced{
	dir = 1
	},
/obj/structure/cult/forge,
/turf/simulated/floor/plating/airless,
/area/shuttle/escape)
"bj" = (
/obj/structure/shuttle/engine/propulsion,
/turf/simulated/floor/plating/airless,
/area/shuttle/escape)
"dG" = (
/obj/effect/rune/empower,
/turf/simulated/floor/engine/cult,
/area/shuttle/escape)
"eK" = (
/obj/structure/chair/comfy/shuttle{
	dir = 4
	},
/obj/item/radio/intercom{
	pixel_x = -28
	},
/turf/simulated/floor/engine/cult,
/area/shuttle/escape)
"zN" = (
/obj/machinery/computer/aifixer{
	dir = 4
	},
/turf/simulated/floor/engine/cult,
/area/shuttle/escape)
"Ac" = (
/obj/item/melee/cultblade/dagger,
/turf/simulated/floor/engine/cult,
/area/shuttle/escape)
"QF" = (
/obj/structure/closet/walllocker/emerglocker/directional/east,
/turf/simulated/floor/engine/cult,
/area/shuttle/escape)
"XC" = (
/obj/effect/decal/cleanable/blood/innards,
/obj/effect/decal/cleanable/blood/gibs/body,
/obj/effect/rune/narsie{
	used = 1
	},
/turf/simulated/floor/engine/cult,
/area/shuttle/escape)

(1,1,1) = {"
al
al
al
al
al
al
al
al
ab
ab
ab
ab
aa
ab
aA
ab
aE
aE
aE
ab
aa
ab
aa
ab
ab
ab
aE
aE
ab
ab
al
"}
(2,1,1) = {"
al
al
al
al
al
al
al
ab
ab
aS
eK
aF
aj
ab
aj
ax
aj
ak
aj
aj
aj
aj
aj
ab
aj
aj
ak
aj
aj
ab
ab
"}
(3,1,1) = {"
al
al
ab
ab
ab
ab
al
ab
ay
aj
am
aj
aj
aE
aj
aj
aj
aj
aj
aj
aj
aj
aj
ab
aj
aj
aj
aj
aj
bh
bj
"}
(4,1,1) = {"
al
ab
ar
an
zN
ab
al
ab
au
am
aj
am
af
aE
aj
aj
aj
aj
aj
aj
aj
aj
aj
aa
aj
aj
aj
aj
be
bh
bj
"}
(5,1,1) = {"
ab
ab
aG
ao
ao
ab
ab
ab
au
aj
aj
aj
ak
ab
ap
aj
am
aj
aj
aj
aj
aj
aj
ab
aW
aj
aj
aj
bf
bh
bj
"}
(6,1,1) = {"
aE
aJ
af
aj
aj
ak
ab
ab
ab
aE
aa
aE
ab
ab
aM
aj
aj
aj
am
aj
aK
aj
aj
ab
ab
ab
ab
ab
ab
ab
ab
"}
(7,1,1) = {"
aE
ae
af
aj
aj
aj
ab
av
aj
aj
aj
aj
ab
av
aj
aj
aL
aI
aj
aI
aN
aj
aj
aF
aF
aj
at
at
ak
ab
al
"}
(8,1,1) = {"
aE
aw
af
aj
aj
aj
ab
aj
aj
aj
aj
aj
ab
aj
aj
aj
aI
aj
aj
aj
aI
aj
aj
aj
aj
aj
aj
aj
az
ab
al
"}
(9,1,1) = {"
aE
ad
af
aj
aj
aj
aa
aj
aj
aj
aj
aj
aa
aj
aj
ah
aj
aj
XC
aj
aj
am
aj
aj
Ac
dG
aj
aj
az
ab
al
"}
(10,1,1) = {"
aE
ag
af
aj
aj
aj
ab
aj
aj
aj
aj
aj
ab
aj
aj
az
aI
aj
aj
aj
aI
aj
aj
aj
aj
aj
aj
aj
az
ab
al
"}
(11,1,1) = {"
aE
as
af
aj
am
aj
ab
av
aj
aj
aj
aj
ab
av
aj
aj
aO
aI
aj
aI
aV
aj
aj
ao
ao
aj
at
at
ak
ab
al
"}
(12,1,1) = {"
aE
aB
af
aj
aj
ak
ab
ab
ab
aE
aa
aE
ab
ab
aM
aj
aj
aj
am
aj
aj
aj
aj
ab
ab
ab
ab
ab
ab
ab
ab
"}
(13,1,1) = {"
ab
ab
aG
aF
aF
ab
ab
ab
bb
aj
aj
aj
ak
ab
aj
aj
ac
aj
aj
aj
aj
aj
aj
aE
aX
aj
aj
bc
bg
bi
bj
"}
(14,1,1) = {"
al
ab
ar
aP
aQ
ab
al
ab
au
aj
aj
aj
af
aE
aj
aj
aj
aj
aj
am
aj
aj
aj
aa
aY
aj
aj
bc
bc
bi
bj
"}
(15,1,1) = {"
al
al
ab
ab
ab
ab
al
ab
au
aj
aj
aj
af
aE
aj
aj
aj
aj
aj
aj
aj
aj
aj
aE
aY
aj
aj
bd
bd
bi
bj
"}
(16,1,1) = {"
al
al
al
al
al
al
al
ab
ab
aj
aj
aj
bb
ab
aj
QF
aj
ak
aj
aj
aj
aj
aj
ab
aZ
aj
ak
aZ
aZ
ab
ab
"}
(17,1,1) = {"
al
al
al
al
al
al
al
al
ab
aH
ab
aH
ab
ab
aE
ab
aE
aE
aE
ab
aE
ab
aE
ab
ab
ab
aE
aE
ab
ab
al
"}
