//MAP CONVERTED BY dmm2tgm.py THIS HEADER COMMENT PREVENTS RECONVERSION, DO NOT REMOVE
"aa" = (
/turf/space,
/area/space)
"ab" = (
/turf/simulated/wall/mineral/wood,
/area/shuttle/escape)
"ac" = (
/obj/structure/window/reinforced/clockwork/fulltile,
/obj/structure/grille,
/turf/simulated/floor/plating,
/area/shuttle/escape)
"ae" = (
/obj/structure/table/wood,
/obj/item/paper_bin,
/obj/item/pen,
/obj/machinery/light/small{
	dir = 1
	},
/obj/effect/mapping_helpers/valid_shuttle_turf,
/turf/simulated/floor/grass,
/area/shuttle/escape)
"af" = (
/obj/structure/table/wood,
/obj/item/folder/red,
/obj/item/restraints/handcuffs,
/obj/item/flash,
/obj/effect/mapping_helpers/valid_shuttle_turf,
/turf/simulated/floor/grass,
/area/shuttle/escape)
"ag" = (
/obj/machinery/computer/robotics,
/obj/effect/mapping_helpers/valid_shuttle_turf,
/turf/simulated/floor/grass,
/area/shuttle/escape)
"ah" = (
/obj/machinery/computer/crew,
/obj/effect/mapping_helpers/valid_shuttle_turf,
/turf/simulated/floor/grass,
/area/shuttle/escape)
"ai" = (
/obj/machinery/computer/emergency_shuttle,
/obj/effect/mapping_helpers/valid_shuttle_turf,
/turf/simulated/floor/grass,
/area/shuttle/escape)
"aj" = (
/obj/machinery/computer/communications,
/obj/effect/mapping_helpers/valid_shuttle_turf,
/turf/simulated/floor/grass,
/area/shuttle/escape)
"ak" = (
/obj/structure/table/wood,
/obj/item/storage/fancy/donut_box,
/obj/effect/mapping_helpers/valid_shuttle_turf,
/turf/simulated/floor/grass,
/area/shuttle/escape)
"al" = (
/obj/structure/table/wood,
/obj/machinery/cell_charger,
/obj/item/stock_parts/cell/high,
/obj/machinery/light/small{
	dir = 1
	},
/obj/effect/mapping_helpers/valid_shuttle_turf,
/turf/simulated/floor/grass,
/area/shuttle/escape)
"ap" = (
/obj/structure/table/wood,
/obj/item/storage/toolbox/mechanical,
/obj/effect/mapping_helpers/valid_shuttle_turf,
/turf/simulated/floor/grass,
/area/shuttle/escape)
"ar" = (
/obj/machinery/computer/security{
	dir = 4;
	network = list("SS13","Research Outpost","Mining Outpost","Telecomms")
	},
/obj/structure/sign/poster/official/nanotrasen_logo{
	pixel_x = -32
	},
/obj/effect/mapping_helpers/valid_shuttle_turf,
/turf/simulated/floor/grass,
/area/shuttle/escape)
"at" = (
/obj/item/radio/intercom{
	dir = 4;
	name = "Station Intercom (General)";
	pixel_x = 29;
	pixel_y = -60
	},
/obj/structure/flora/rock/pile/largejungle,
/obj/effect/mapping_helpers/valid_shuttle_turf,
/turf/simulated/floor/grass,
/area/shuttle/escape)
"ax" = (
/obj/machinery/computer/station_alert{
	dir = 8
	},
/obj/structure/sign/poster/official/nanotrasen_logo{
	pixel_x = 32
	},
/obj/effect/mapping_helpers/valid_shuttle_turf,
/turf/simulated/floor/grass,
/area/shuttle/escape)
"ay" = (
/obj/machinery/computer/secure_data{
	dir = 4
	},
/obj/effect/mapping_helpers/valid_shuttle_turf,
/turf/simulated/floor/grass,
/area/shuttle/escape)
"az" = (
/obj/structure/chair/sofa/bamboo/right{
	dir = 4
	},
/obj/effect/mapping_helpers/valid_shuttle_turf,
/turf/simulated/floor/mineral/plastitanium/red/brig{
	icon_state = "wood"
	},
/area/shuttle/escape)
"aA" = (
/obj/structure/flora/grass/jungle,
/obj/machinery/light/small,
/obj/effect/mapping_helpers/valid_shuttle_turf,
/turf/simulated/floor/grass,
/area/shuttle/escape)
"aB" = (
/obj/structure/chair/sofa/bamboo/right{
	dir = 4
	},
/obj/structure/flora/grass/jungle,
/obj/effect/mapping_helpers/valid_shuttle_turf,
/turf/simulated/floor/grass,
/area/shuttle/escape)
"aC" = (
/obj/machinery/computer/atmos_alert{
	dir = 8
	},
/obj/effect/mapping_helpers/valid_shuttle_turf,
/turf/simulated/floor/grass,
/area/shuttle/escape)
"aD" = (
/obj/machinery/status_display,
/obj/effect/mapping_helpers/valid_shuttle_turf,
/turf/simulated/wall/mineral/wood,
/area/shuttle/escape)
"aF" = (
/obj/machinery/door/airlock/wood/glass{
	name = "Escape Shuttle Cockpit"
	},
/obj/effect/mapping_helpers/airlock/access/all/command/general,
/obj/effect/mapping_helpers/valid_shuttle_turf,
/turf/simulated/floor/grass,
/area/shuttle/escape)
"aG" = (
/obj/structure/table/wood,
/obj/item/storage/firstaid/regular,
/obj/effect/mapping_helpers/valid_shuttle_turf,
/turf/simulated/floor/mineral/plastitanium/red/brig{
	icon_state = "wood"
	},
/area/shuttle/escape)
"aH" = (
/obj/effect/mapping_helpers/valid_shuttle_turf,
/turf/simulated/floor/mineral/plastitanium/red/brig{
	icon_state = "wood"
	},
/area/shuttle/escape)
"aI" = (
/obj/machinery/light{
	dir = 1;
	on = 1
	},
/obj/structure/chair/sofa/bamboo,
/obj/effect/mapping_helpers/valid_shuttle_turf,
/turf/simulated/floor/mineral/plastitanium/red/brig{
	icon_state = "wood"
	},
/area/shuttle/escape)
"aJ" = (
/obj/structure/table/wood,
/obj/item/storage/fancy/donut_box,
/obj/effect/mapping_helpers/valid_shuttle_turf,
/turf/simulated/floor/mineral/plastitanium/red/brig{
	icon_state = "wood"
	},
/area/shuttle/escape)
"aL" = (
/obj/structure/bonfire/lit/dense,
/obj/effect/mapping_helpers/valid_shuttle_turf,
/turf/simulated/floor/grass,
/area/shuttle/escape)
"aN" = (
/obj/structure/chair/sofa/bamboo/left{
	dir = 1
	},
/obj/effect/mapping_helpers/valid_shuttle_turf,
/turf/simulated/floor/mineral/plastitanium/red/brig{
	icon_state = "wood"
	},
/area/shuttle/escape)
"aO" = (
/obj/structure/chair/sofa/bamboo/right,
/obj/effect/mapping_helpers/valid_shuttle_turf,
/turf/simulated/floor/mineral/plastitanium/red/brig{
	icon_state = "wood"
	},
/area/shuttle/escape)
"aR" = (
/obj/structure/closet/fireaxecabinet{
	pixel_x = 32
	},
/obj/machinery/light/small{
	dir = 1
	},
/obj/structure/chair/stool/bamboo,
/obj/effect/mapping_helpers/valid_shuttle_turf,
/turf/simulated/floor/grass,
/area/shuttle/escape)
"aS" = (
/obj/item/storage/firstaid/o2,
/obj/structure/table/wood,
/obj/machinery/light/small{
	dir = 1
	},
/obj/effect/mapping_helpers/valid_shuttle_turf,
/turf/simulated/floor/grass,
/area/shuttle/escape)
"aT" = (
/obj/structure/flora/tree/jungle/small,
/obj/machinery/light/small,
/obj/effect/mapping_helpers/valid_shuttle_turf,
/turf/simulated/floor/grass,
/area/shuttle/escape)
"aU" = (
/obj/structure/chair/sofa/bamboo/right,
/obj/effect/mapping_helpers/valid_shuttle_turf,
/turf/simulated/floor/grass,
/area/shuttle/escape)
"aV" = (
/obj/structure/closet/crate/internals,
/obj/item/clothing/mask/breath,
/obj/item/clothing/mask/breath,
/obj/item/clothing/mask/breath,
/obj/item/clothing/mask/breath,
/obj/item/tank/internals/emergency_oxygen/engi,
/obj/item/tank/internals/emergency_oxygen/engi,
/obj/item/tank/internals/emergency_oxygen/engi,
/obj/item/tank/internals/emergency_oxygen/engi,
/obj/effect/mapping_helpers/valid_shuttle_turf,
/turf/simulated/floor/grass,
/area/shuttle/escape)
"aW" = (
/obj/item/radio/intercom{
	dir = 8;
	pixel_x = -28
	},
/obj/structure/chair/sofa/bamboo/left{
	dir = 4
	},
/obj/effect/mapping_helpers/valid_shuttle_turf,
/turf/simulated/floor/mineral/plastitanium/red/brig{
	icon_state = "wood"
	},
/area/shuttle/escape)
"aX" = (
/obj/structure/chair/stool/bamboo,
/obj/effect/mapping_helpers/valid_shuttle_turf,
/turf/simulated/floor/mineral/plastitanium/red/brig{
	icon_state = "wood"
	},
/area/shuttle/escape)
"aY" = (
/obj/structure/table/wood,
/obj/machinery/recharger,
/obj/effect/mapping_helpers/valid_shuttle_turf,
/turf/simulated/floor/grass,
/area/shuttle/escape)
"aZ" = (
/obj/structure/closet/firecloset,
/obj/effect/mapping_helpers/valid_shuttle_turf,
/turf/simulated/floor/grass,
/area/shuttle/escape)
"bg" = (
/mob/living/carbon/human/monkey,
/obj/effect/mapping_helpers/valid_shuttle_turf,
/turf/simulated/floor/grass,
/area/shuttle/escape)
"bi" = (
/obj/machinery/door/airlock/wood{
	id_tag = "s_docking_airlock";
	name = "Shuttle Hatch"
	},
/obj/structure/fans/tiny,
/turf/simulated/floor/grass,
/area/shuttle/escape)
"bj" = (
/obj/machinery/door/airlock/wood/glass{
	name = "Escape Shuttle Cell"
	},
/obj/effect/mapping_helpers/airlock/access/all/security/doors,
/obj/effect/mapping_helpers/valid_shuttle_turf,
/turf/simulated/floor/mineral/plastitanium/red/brig{
	icon_state = "wood"
	},
/area/shuttle/escape)
"bn" = (
/obj/structure/flora/junglebush,
/mob/living/simple_animal/hostile/retaliate/poison/snake,
/obj/effect/mapping_helpers/valid_shuttle_turf,
/turf/simulated/floor/grass,
/area/shuttle/escape)
"bo" = (
/obj/machinery/door/airlock/wood{
	id_tag = "s_docking_airlock";
	name = "Shuttle Hatch"
	},
/turf/simulated/floor/mineral/plastitanium/red/brig{
	icon_state = "wood"
	},
/area/shuttle/escape)
"bp" = (
/obj/structure/table/wood,
/obj/machinery/recharger,
/obj/effect/mapping_helpers/valid_shuttle_turf,
/turf/simulated/floor/mineral/plastitanium/red/brig{
	icon_state = "wood"
	},
/area/shuttle/escape)
"bu" = (
/obj/structure/shuttle/engine/heater,
/obj/structure/window/reinforced/clockwork{
	dir = 1
	},
/turf/simulated/floor/plating/airless{
	icon = 'icons/turf/floors.dmi';
	icon_state = "wood"
	},
/area/shuttle/escape)
"bw" = (
/obj/structure/shuttle/engine/propulsion,
/turf/simulated/floor/plating/airless{
	icon = 'icons/turf/floors.dmi';
	icon_state = "wood"
	},
/area/shuttle/escape)
"bx" = (
/obj/structure/extinguisher_cabinet{
	pixel_x = 28
	},
/obj/effect/mapping_helpers/valid_shuttle_turf,
/turf/simulated/floor/grass,
/area/shuttle/escape)
"by" = (
/obj/structure/table/wood,
/obj/item/storage/firstaid,
/obj/effect/mapping_helpers/valid_shuttle_turf,
/turf/simulated/floor/grass,
/area/shuttle/escape)
"bz" = (
/obj/structure/chair/sofa/bamboo/left{
	dir = 1
	},
/obj/structure/flora/junglebush,
/mob/living/simple_animal/hostile/retaliate/goat,
/obj/effect/mapping_helpers/valid_shuttle_turf,
/turf/simulated/floor/grass,
/area/shuttle/escape)
"bA" = (
/obj/machinery/status_display{
	pixel_y = -32
	},
/obj/structure/chair/sofa/bamboo{
	dir = 1
	},
/obj/machinery/light/small,
/obj/effect/mapping_helpers/valid_shuttle_turf,
/turf/simulated/floor/grass,
/area/shuttle/escape)
"bB" = (
/obj/structure/chair/sofa/bamboo/left{
	dir = 1
	},
/obj/effect/mapping_helpers/valid_shuttle_turf,
/turf/simulated/floor/grass,
/area/shuttle/escape)
"bD" = (
/obj/machinery/door/airlock/wood{
	id_tag = "s_docking_airlock";
	name = "Shuttle Hatch"
	},
/obj/docking_port/stationary{
	dir = 4;
	dwidth = 11;
	height = 18;
	id = "emergency_away";
	name = "emergency centcom";
	width = 29
	},
/obj/docking_port/mobile/emergency{
	dwidth = 11;
	height = 18;
	timid = 1;
	width = 29
	},
/turf/simulated/floor/grass,
/area/shuttle/escape)
"bF" = (
/obj/machinery/light/small{
	dir = 1
	},
/obj/structure/flora/rock/jungle,
/obj/effect/mapping_helpers/valid_shuttle_turf,
/turf/simulated/floor/grass,
/area/shuttle/escape)
"bG" = (
/obj/machinery/mech_bay_recharge_port,
/obj/effect/mapping_helpers/valid_shuttle_turf,
/turf/simulated/floor/grass,
/area/shuttle/escape)
"bH" = (
/obj/machinery/computer/mech_bay_power_console,
/obj/effect/mapping_helpers/valid_shuttle_turf,
/turf/simulated/floor/grass,
/area/shuttle/escape)
"bI" = (
/obj/structure/table,
/obj/item/weldingtool/largetank{
	pixel_x = 4;
	pixel_y = -4
	},
/obj/item/clothing/glasses/welding{
	pixel_y = 10
	},
/obj/machinery/light/small{
	dir = 4
	},
/obj/effect/mapping_helpers/valid_shuttle_turf,
/turf/simulated/floor/grass,
/area/shuttle/escape)
"bJ" = (
/obj/machinery/light/small{
	dir = 8
	},
/obj/effect/mapping_helpers/valid_shuttle_turf,
/turf/simulated/floor/grass,
/area/shuttle/escape)
"bK" = (
/obj/machinery/light/small{
	dir = 4
	},
/obj/effect/mapping_helpers/valid_shuttle_turf,
/turf/simulated/floor/grass,
/area/shuttle/escape)
"bL" = (
/obj/structure/reagent_dispensers/fueltank/chem{
	pixel_x = -32
	},
/obj/structure/flora/junglebush,
/obj/effect/mapping_helpers/valid_shuttle_turf,
/turf/simulated/floor/grass,
/area/shuttle/escape)
"bM" = (
/obj/structure/flora/rock/jungle,
/obj/effect/mapping_helpers/valid_shuttle_turf,
/turf/simulated/floor/grass,
/area/shuttle/escape)
"bN" = (
/obj/structure/flora/rock/pile/largejungle,
/obj/effect/mapping_helpers/valid_shuttle_turf,
/turf/simulated/floor/grass,
/area/shuttle/escape)
"bO" = (
/obj/structure/flora/junglebush,
/mob/living/carbon/human/monkey,
/obj/effect/mapping_helpers/valid_shuttle_turf,
/turf/simulated/floor/grass,
/area/shuttle/escape)
"bQ" = (
/obj/structure/chair/sofa/bamboo/left{
	dir = 8
	},
/obj/effect/mapping_helpers/valid_shuttle_turf,
/turf/simulated/floor/grass,
/area/shuttle/escape)
"bS" = (
/obj/structure/mineral_door/wood,
/obj/effect/mapping_helpers/valid_shuttle_turf,
/turf/simulated/floor/grass,
/area/shuttle/escape)
"bV" = (
/obj/structure/reagent_dispensers/watertank,
/obj/effect/mapping_helpers/valid_shuttle_turf,
/turf/simulated/floor/grass,
/area/shuttle/escape)
"bX" = (
/obj/structure/flora/tree/jungle/small,
/obj/effect/mapping_helpers/valid_shuttle_turf,
/turf/simulated/floor/grass,
/area/shuttle/escape)
"bZ" = (
/obj/structure/table/wood,
/obj/machinery/cell_charger,
/obj/item/stock_parts/cell/high,
/obj/machinery/light/small{
	dir = 8
	},
/obj/effect/mapping_helpers/valid_shuttle_turf,
/turf/simulated/floor/grass,
/area/shuttle/escape)
"ca" = (
/obj/structure/closet/crate,
/obj/item/storage/toolbox/emergency,
/obj/item/storage/toolbox/emergency,
/obj/item/flashlight/flare,
/obj/item/flashlight/flare,
/obj/item/crowbar,
/obj/item/wrench,
/obj/item/radio,
/obj/effect/mapping_helpers/valid_shuttle_turf,
/turf/simulated/floor/grass,
/area/shuttle/escape)
"cc" = (
/obj/structure/flora/tree/jungle,
/obj/effect/mapping_helpers/valid_shuttle_turf,
/turf/simulated/floor/grass,
/area/shuttle/escape)
"cd" = (
/obj/item/radio/intercom{
	dir = 8;
	pixel_x = -28
	},
/obj/machinery/recharge_station,
/obj/effect/mapping_helpers/valid_shuttle_turf,
/turf/simulated/floor/grass,
/area/shuttle/escape)
"ce" = (
/obj/structure/closet/crate/engineering,
/obj/item/storage/toolbox/electrical{
	pixel_x = -4;
	pixel_y = 4
	},
/obj/item/storage/toolbox/emergency,
/obj/item/storage/toolbox/mechanical{
	pixel_x = 4;
	pixel_y = -4
	},
/obj/effect/mapping_helpers/valid_shuttle_turf,
/turf/simulated/floor/grass,
/area/shuttle/escape)
"cf" = (
/obj/structure/extinguisher_cabinet{
	pixel_x = -28
	},
/obj/machinery/recharge_station,
/obj/effect/mapping_helpers/valid_shuttle_turf,
/turf/simulated/floor/grass,
/area/shuttle/escape)
"ci" = (
/obj/structure/closet/crate/medical,
/obj/item/storage/firstaid/regular,
/obj/item/storage/firstaid/o2{
	pixel_x = 2;
	pixel_y = -2
	},
/obj/item/storage/firstaid/toxin{
	pixel_x = -2;
	pixel_y = 4
	},
/obj/machinery/light/small,
/obj/effect/mapping_helpers/valid_shuttle_turf,
/turf/simulated/floor/grass,
/area/shuttle/escape)
"cj" = (
/obj/machinery/light/small{
	dir = 8
	},
/obj/structure/flora/junglebush,
/obj/effect/mapping_helpers/valid_shuttle_turf,
/turf/simulated/floor/grass,
/area/shuttle/escape)
"ck" = (
/obj/structure/chair/sofa/bamboo/left{
	dir = 8
	},
/obj/machinery/light/small{
	dir = 4
	},
/obj/effect/mapping_helpers/valid_shuttle_turf,
/turf/simulated/floor/grass,
/area/shuttle/escape)
"cl" = (
/obj/structure/barricade/wooden/crude,
/obj/effect/mapping_helpers/valid_shuttle_turf,
/turf/simulated/floor/grass,
/area/shuttle/escape)
"cm" = (
/obj/structure/sign/greencross,
/obj/effect/mapping_helpers/valid_shuttle_turf,
/turf/simulated/wall/mineral/wood,
/area/shuttle/escape)
"co" = (
/obj/machinery/sleeper{
	dir = 4
	},
/obj/effect/mapping_helpers/valid_shuttle_turf,
/turf/simulated/floor/grass,
/area/shuttle/escape)
"cq" = (
/obj/machinery/sleeper,
/obj/effect/mapping_helpers/valid_shuttle_turf,
/turf/simulated/floor/grass,
/area/shuttle/escape)
"cr" = (
/obj/structure/chair/sofa/bamboo{
	dir = 4
	},
/obj/effect/mapping_helpers/valid_shuttle_turf,
/turf/simulated/floor/grass,
/area/shuttle/escape)
"ct" = (
/obj/structure/extinguisher_cabinet{
	pixel_x = 28
	},
/obj/machinery/light/small{
	dir = 4
	},
/obj/structure/flora/junglebush,
/mob/living/simple_animal/hostile/retaliate/poison/snake,
/obj/effect/mapping_helpers/valid_shuttle_turf,
/turf/simulated/floor/grass,
/area/shuttle/escape)
"cu" = (
/obj/structure/flora/junglebush,
/obj/effect/mapping_helpers/valid_shuttle_turf,
/turf/simulated/floor/grass,
/area/shuttle/escape)
"cv" = (
/obj/effect/mapping_helpers/valid_shuttle_turf,
/turf/simulated/floor/grass,
/area/shuttle/escape)
"cw" = (
/obj/structure/bed/roller,
/obj/machinery/iv_drip,
/obj/effect/mapping_helpers/valid_shuttle_turf,
/turf/simulated/floor/grass,
/area/shuttle/escape)
"cx" = (
/obj/structure/table/wood,
/obj/item/reagent_containers/iv_bag/blood/random,
/obj/item/reagent_containers/iv_bag/blood/random,
/obj/item/reagent_containers/iv_bag/blood/random,
/obj/effect/mapping_helpers/valid_shuttle_turf,
/turf/simulated/floor/grass,
/area/shuttle/escape)
"cy" = (
/obj/structure/flora/grass/jungle,
/obj/effect/mapping_helpers/valid_shuttle_turf,
/turf/simulated/floor/grass,
/area/shuttle/escape)
"cz" = (
/obj/structure/table/wood,
/obj/item/storage/firstaid/o2{
	pixel_x = -3;
	pixel_y = -3
	},
/obj/item/storage/firstaid/regular,
/obj/item/storage/firstaid/regular{
	pixel_x = 3;
	pixel_y = 3
	},
/obj/effect/mapping_helpers/valid_shuttle_turf,
/turf/simulated/floor/grass,
/area/shuttle/escape)
"cA" = (
/obj/machinery/light/small{
	dir = 8
	},
/obj/structure/chair/sofa/bamboo/right{
	dir = 4
	},
/obj/effect/mapping_helpers/valid_shuttle_turf,
/turf/simulated/floor/grass,
/area/shuttle/escape)
"cB" = (
/obj/structure/table/wood,
/obj/machinery/light/small{
	dir = 8
	},
/obj/item/reagent_containers/drinks/mug/med,
/mob/living/carbon/human/monkey,
/obj/effect/mapping_helpers/valid_shuttle_turf,
/turf/simulated/floor/grass,
/area/shuttle/escape)
"cC" = (
/obj/item/flag/med,
/obj/effect/mapping_helpers/valid_shuttle_turf,
/turf/simulated/floor/grass,
/area/shuttle/escape)
"cD" = (
/obj/structure/table/wood,
/obj/item/storage/backpack/medic,
/obj/item/storage/belt/medical,
/obj/effect/mapping_helpers/valid_shuttle_turf,
/turf/simulated/floor/grass,
/area/shuttle/escape)
"cE" = (
/obj/structure/bed/roller,
/obj/effect/mapping_helpers/valid_shuttle_turf,
/turf/simulated/floor/grass,
/area/shuttle/escape)
"cF" = (
/obj/item/radio/intercom{
	dir = 4;
	name = "Station Intercom (General)";
	pixel_x = 29;
	pixel_y = -30
	},
/obj/structure/bed/roller,
/obj/effect/mapping_helpers/valid_shuttle_turf,
/turf/simulated/floor/grass,
/area/shuttle/escape)
"cG" = (
/obj/structure/table/wood,
/obj/item/clothing/gloves/color/latex/nitrile,
/obj/item/clothing/mask/breath,
/obj/machinery/light/small,
/obj/effect/mapping_helpers/valid_shuttle_turf,
/turf/simulated/floor/grass,
/area/shuttle/escape)
"cH" = (
/obj/structure/closet/crate/internals,
/obj/item/clothing/mask/breath,
/obj/item/clothing/mask/breath,
/obj/item/clothing/mask/breath,
/obj/item/clothing/mask/breath,
/obj/item/tank/internals/emergency_oxygen/engi,
/obj/item/tank/internals/emergency_oxygen/engi,
/obj/item/tank/internals/emergency_oxygen/engi,
/obj/item/tank/internals/emergency_oxygen/engi,
/obj/machinery/light/small{
	dir = 1
	},
/obj/structure/flora/junglebush,
/obj/effect/mapping_helpers/valid_shuttle_turf,
/turf/simulated/floor/grass,
/area/shuttle/escape)
"eP" = (
/obj/structure/chair/sofa/bamboo,
/obj/effect/mapping_helpers/valid_shuttle_turf,
/turf/simulated/floor/grass,
/area/shuttle/escape)
"fl" = (
/obj/structure/chair/sofa/bamboo/right{
	dir = 8
	},
/mob/living/carbon/human/monkey,
/obj/effect/mapping_helpers/valid_shuttle_turf,
/turf/simulated/floor/grass,
/area/shuttle/escape)
"fM" = (
/obj/structure/chair/sofa/bamboo/right{
	dir = 8
	},
/obj/structure/flora/rock/jungle,
/obj/effect/mapping_helpers/valid_shuttle_turf,
/turf/simulated/floor/grass,
/area/shuttle/escape)
"ga" = (
/obj/structure/flora/junglebush/large,
/mob/living/carbon/human/monkey,
/obj/effect/mapping_helpers/valid_shuttle_turf,
/turf/simulated/floor/grass,
/area/shuttle/escape)
"ia" = (
/obj/structure/flora/grass/jungle,
/mob/living/carbon/human/monkey,
/obj/effect/mapping_helpers/valid_shuttle_turf,
/turf/simulated/floor/grass,
/area/shuttle/escape)
"mC" = (
/obj/structure/chair/sofa/bamboo{
	dir = 1
	},
/obj/effect/mapping_helpers/valid_shuttle_turf,
/turf/simulated/floor/grass,
/area/shuttle/escape)
"mM" = (
/obj/structure/chair/sofa/bamboo/right{
	dir = 8
	},
/obj/effect/mapping_helpers/valid_shuttle_turf,
/turf/simulated/floor/grass,
/area/shuttle/escape)
"mP" = (
/obj/structure/chair/sofa/bamboo/left{
	dir = 4
	},
/obj/effect/mapping_helpers/valid_shuttle_turf,
/turf/simulated/floor/grass,
/area/shuttle/escape)
"oA" = (
/obj/structure/barricade/wooden,
/obj/effect/mapping_helpers/valid_shuttle_turf,
/turf/simulated/floor/mineral/plastitanium/red/brig{
	icon_state = "wood"
	},
/area/shuttle/escape)
"pe" = (
/obj/structure/chair/wood{
	dir = 8
	},
/obj/machinery/light/small{
	dir = 4
	},
/mob/living/simple_animal/hostile/retaliate/goat,
/obj/effect/mapping_helpers/valid_shuttle_turf,
/turf/simulated/floor/grass,
/area/shuttle/escape)
"qH" = (
/obj/structure/chair/sofa/bamboo/left,
/obj/effect/mapping_helpers/valid_shuttle_turf,
/turf/simulated/floor/grass,
/area/shuttle/escape)
"sL" = (
/obj/structure/chair/sofa/bamboo/right{
	dir = 4
	},
/obj/effect/mapping_helpers/valid_shuttle_turf,
/turf/simulated/floor/grass,
/area/shuttle/escape)
"tc" = (
/obj/structure/bonfire/lit/dense,
/obj/effect/mapping_helpers/valid_shuttle_turf,
/turf/simulated/floor/mineral/plastitanium/red/brig{
	icon_state = "wood"
	},
/area/shuttle/escape)
"un" = (
/obj/structure/table/wood,
/obj/effect/mapping_helpers/valid_shuttle_turf,
/turf/simulated/floor/grass,
/area/shuttle/escape)
"vz" = (
/obj/structure/flora/junglebush,
/obj/structure/chair/stool/bamboo,
/obj/effect/mapping_helpers/valid_shuttle_turf,
/turf/simulated/floor/grass,
/area/shuttle/escape)
"xd" = (
/obj/structure/flora/junglebush,
/mob/living/simple_animal/hostile/retaliate/poison/snake,
/obj/machinery/light/small,
/obj/effect/mapping_helpers/valid_shuttle_turf,
/turf/simulated/floor/grass,
/area/shuttle/escape)
"Av" = (
/mob/living/simple_animal/bunny,
/obj/effect/mapping_helpers/valid_shuttle_turf,
/turf/simulated/floor/grass,
/area/shuttle/escape)
"BA" = (
/obj/structure/flora/junglebush,
/mob/living/carbon/human/monkey,
/obj/structure/flora/rock/jungle,
/obj/effect/mapping_helpers/valid_shuttle_turf,
/turf/simulated/floor/grass,
/area/shuttle/escape)
"GI" = (
/mob/living/carbon/human/monkey,
/obj/structure/flora/rock/jungle,
/obj/effect/mapping_helpers/valid_shuttle_turf,
/turf/simulated/floor/grass,
/area/shuttle/escape)
"Hi" = (
/obj/structure/flora/rock/jungle,
/obj/structure/mineral_door/wood,
/obj/effect/mapping_helpers/valid_shuttle_turf,
/turf/simulated/floor/grass,
/area/shuttle/escape)
"HY" = (
/obj/structure/flora/rock/pile/largejungle,
/obj/structure/flora/junglebush,
/obj/effect/mapping_helpers/valid_shuttle_turf,
/turf/simulated/floor/grass,
/area/shuttle/escape)
"IH" = (
/obj/structure/flora/rock/jungle,
/mob/living/carbon/human/monkey,
/obj/effect/mapping_helpers/valid_shuttle_turf,
/turf/simulated/floor/grass,
/area/shuttle/escape)
"IK" = (
/obj/structure/flora/grass/jungle,
/obj/structure/chair/stool/bamboo,
/obj/effect/mapping_helpers/valid_shuttle_turf,
/turf/simulated/floor/grass,
/area/shuttle/escape)
"Ku" = (
/mob/living/carbon/human/monkey,
/obj/effect/mapping_helpers/valid_shuttle_turf,
/turf/simulated/floor/mineral/plastitanium/red/brig{
	icon_state = "wood"
	},
/area/shuttle/escape)
"KD" = (
/obj/structure/table/wood,
/obj/item/flashlight/lamp/green,
/obj/effect/mapping_helpers/valid_shuttle_turf,
/turf/simulated/floor/grass,
/area/shuttle/escape)
"Ly" = (
/obj/structure/chair/sofa/bamboo/right{
	dir = 1
	},
/obj/effect/mapping_helpers/valid_shuttle_turf,
/turf/simulated/floor/grass,
/area/shuttle/escape)
"LH" = (
/obj/structure/chair/sofa/bamboo{
	dir = 8
	},
/mob/living/simple_animal/bunny,
/obj/effect/mapping_helpers/valid_shuttle_turf,
/turf/simulated/floor/grass,
/area/shuttle/escape)
"LW" = (
/obj/structure/barricade/wooden,
/obj/effect/mapping_helpers/valid_shuttle_turf,
/turf/simulated/floor/grass,
/area/shuttle/escape)
"Mb" = (
/obj/machinery/door/airlock/wood{
	id_tag = "s_docking_airlock";
	name = "Shuttle Hatch"
	},
/turf/simulated/floor/grass,
/area/shuttle/escape)
"NA" = (
/obj/structure/flora/junglebush/large,
/obj/effect/mapping_helpers/valid_shuttle_turf,
/turf/simulated/floor/grass,
/area/shuttle/escape)
"Ok" = (
/obj/structure/chair/sofa/bamboo/left,
/obj/effect/mapping_helpers/valid_shuttle_turf,
/turf/simulated/floor/mineral/plastitanium/red/brig{
	icon_state = "wood"
	},
/area/shuttle/escape)
"OB" = (
/obj/structure/chair/sofa/bamboo{
	dir = 8
	},
/obj/effect/mapping_helpers/valid_shuttle_turf,
/turf/simulated/floor/grass,
/area/shuttle/escape)
"Rr" = (
/obj/structure/flora/junglebush,
/obj/machinery/light/small{
	dir = 8
	},
/obj/effect/mapping_helpers/valid_shuttle_turf,
/turf/simulated/floor/grass,
/area/shuttle/escape)
"Sy" = (
/obj/structure/flora/tree/jungle/small,
/mob/living/carbon/human/monkey,
/obj/effect/mapping_helpers/valid_shuttle_turf,
/turf/simulated/floor/grass,
/area/shuttle/escape)
"SO" = (
/obj/structure/flora/grass/jungle,
/mob/living/simple_animal/hostile/retaliate/poison/snake,
/obj/effect/mapping_helpers/valid_shuttle_turf,
/turf/simulated/floor/grass,
/area/shuttle/escape)
"TY" = (
/obj/structure/chair/sofa/bamboo/right{
	dir = 1
	},
/obj/effect/mapping_helpers/valid_shuttle_turf,
/turf/simulated/floor/mineral/plastitanium/red/brig{
	icon_state = "wood"
	},
/area/shuttle/escape)
"Yg" = (
/obj/effect/mapping_helpers/valid_shuttle_turf,
/turf/simulated/wall/mineral/wood,
/area/shuttle/escape)
"YY" = (
/obj/structure/flora/junglebush/large,
/obj/structure/flora/junglebush,
/obj/effect/mapping_helpers/valid_shuttle_turf,
/turf/simulated/floor/grass,
/area/shuttle/escape)

(1,1,1) = {"
aa
aa
aa
aa
aa
ab
ab
ab
ab
bo
ab
bD
ab
ac
ac
ac
ab
Mb
ab
Mb
ab
ab
ac
ac
ab
ab
ab
ab
aa
"}
(2,1,1) = {"
aa
aa
aa
aa
aa
ab
aG
aW
az
aH
Yg
bM
bJ
mP
cr
sL
cy
cy
cj
cu
bM
mP
cr
cr
cA
aV
ab
bu
bw
"}
(3,1,1) = {"
aa
aa
aa
aa
aa
ac
aO
aH
aH
aH
bj
cv
cu
cu
cy
ia
cy
SO
cu
BA
cv
cv
cc
cu
ga
aZ
ac
bu
bw
"}
(4,1,1) = {"
aa
aa
aa
aa
ab
ab
aI
tc
Ku
aN
oA
bX
bM
mM
OB
OB
OB
bQ
bM
fM
OB
OB
OB
bQ
bM
bB
ac
bu
bw
"}
(5,1,1) = {"
ab
ab
ac
ab
ab
ab
Ok
aH
aH
TY
oA
bN
cv
cu
cu
cv
cc
aL
cy
cv
bX
Av
cv
bX
cu
Ly
ab
ab
ab
"}
(6,1,1) = {"
ab
ae
aY
ar
ay
Yg
aJ
aX
aH
bp
Yg
cy
IH
bM
cv
mP
cr
sL
cy
mP
cr
cr
cr
sL
bM
xd
ab
bu
bw
"}
(7,1,1) = {"
ac
af
bO
mM
bQ
Yg
Yg
oA
bj
Yg
Yg
bF
cu
bM
IK
un
un
un
NA
KD
un
un
un
un
vz
cv
ac
bu
bw
"}
(8,1,1) = {"
ac
ag
bB
bM
aA
aD
aL
aY
cv
cu
LW
bM
cu
bM
cv
mM
LH
bQ
bM
fl
OB
OB
OB
bQ
NA
aL
ab
ab
ab
"}
(9,1,1) = {"
ac
ah
mC
SO
cu
aF
cv
bM
ia
cy
bS
cy
cu
cv
bX
bM
cu
bM
cu
cu
cv
cv
cc
bO
bM
bB
ac
bu
bw
"}
(10,1,1) = {"
ac
ai
mC
IH
cv
aF
SO
cu
bM
cv
bS
bM
cv
cv
bg
cu
aL
cu
bM
mP
cr
cr
cr
sL
bM
mC
ac
bu
bw
"}
(11,1,1) = {"
ac
aj
Ly
at
aT
aD
aR
cv
cu
bx
LW
cv
bN
cu
cu
SO
bM
cy
bO
cu
cu
cu
bN
bM
cy
Ly
ab
ab
ab
"}
(12,1,1) = {"
ac
ak
cu
mP
aB
Yg
Yg
bS
bS
Yg
Yg
aV
bK
cu
cv
mM
OB
OB
ck
aZ
Yg
bS
Hi
Yg
pe
aV
ac
bu
bw
"}
(13,1,1) = {"
ab
al
ap
ax
aC
Yg
aS
cu
cy
by
Yg
Yg
Yg
bS
bS
Yg
Yg
Yg
Yg
cm
Yg
cu
cy
Yg
aD
Yg
ab
bu
bw
"}
(14,1,1) = {"
ab
ab
ac
ab
ab
ab
aU
GI
cv
bz
Yg
bG
bL
cy
cu
bZ
cd
cf
Yg
co
Rr
cy
cu
cy
cB
cD
ab
ab
ab
"}
(15,1,1) = {"
aa
aa
aa
aa
ab
ab
eP
HY
bM
bA
Yg
bn
bM
cy
YY
bX
bg
cv
cl
cu
cy
bM
cy
bM
bM
cE
ac
bu
bw
"}
(16,1,1) = {"
aa
aa
aa
aa
aa
ac
qH
bM
Sy
Ly
Yg
bH
bN
cu
aL
bM
bN
cu
LW
bM
ia
cu
YY
bM
aL
cF
ac
bu
bw
"}
(17,1,1) = {"
aa
aa
aa
aa
aa
ab
cH
cv
cu
aV
Yg
bI
bO
bV
aV
ca
ce
ci
cm
cq
ct
cw
cx
cz
cC
cG
ab
bu
bw
"}
(18,1,1) = {"
aa
aa
aa
aa
aa
ab
ac
bi
bi
ac
ab
ab
ac
ac
ac
ac
ac
ab
ab
ab
ab
ac
ac
ac
ac
ab
ab
ab
aa
"}
