//MAP CONVERTED BY dmm2tgm.py THIS HEADER COMMENT PREVENTS RECONVERSION, DO NOT REMOVE
"aa" = (
/turf/space,
/area/space)
"ab" = (
/turf/simulated/wall/mineral/titanium,
/area/shuttle/escape)
"ac" = (
/obj/effect/spawner/window/shuttle,
/turf/simulated/floor/plating,
/area/shuttle/escape)
"ae" = (
/obj/structure/table/reinforced,
/obj/item/paper_bin,
/obj/item/pen,
/obj/effect/mapping_helpers/valid_shuttle_turf,
/turf/simulated/floor/plasteel{
	dir = 4;
	icon_state = "vault"
	},
/area/shuttle/escape)
"af" = (
/obj/structure/table/reinforced,
/obj/item/folder/red,
/obj/item/restraints/handcuffs,
/obj/item/flash,
/obj/effect/mapping_helpers/valid_shuttle_turf,
/turf/simulated/floor/plasteel{
	icon_state = "dark"
	},
/area/shuttle/escape)
"ag" = (
/obj/machinery/computer/robotics,
/obj/effect/mapping_helpers/valid_shuttle_turf,
/turf/simulated/floor/plasteel{
	dir = 9;
	icon_state = "darkblue"
	},
/area/shuttle/escape)
"ah" = (
/obj/machinery/computer/crew,
/obj/effect/mapping_helpers/valid_shuttle_turf,
/turf/simulated/floor/plasteel{
	dir = 1;
	icon_state = "darkblue"
	},
/area/shuttle/escape)
"ai" = (
/obj/machinery/computer/emergency_shuttle,
/obj/effect/mapping_helpers/valid_shuttle_turf,
/turf/simulated/floor/plasteel{
	dir = 1;
	icon_state = "darkblue"
	},
/area/shuttle/escape)
"aj" = (
/obj/machinery/computer/communications,
/obj/effect/mapping_helpers/valid_shuttle_turf,
/turf/simulated/floor/plasteel{
	dir = 5;
	icon_state = "darkblue"
	},
/area/shuttle/escape)
"ak" = (
/obj/structure/table/reinforced,
/obj/item/storage/fancy/donut_box,
/obj/effect/mapping_helpers/valid_shuttle_turf,
/turf/simulated/floor/plasteel{
	icon_state = "dark"
	},
/area/shuttle/escape)
"al" = (
/obj/structure/table/reinforced,
/obj/machinery/cell_charger,
/obj/item/stock_parts/cell/high,
/obj/effect/mapping_helpers/valid_shuttle_turf,
/turf/simulated/floor/plasteel{
	dir = 4;
	icon_state = "vault"
	},
/area/shuttle/escape)
"am" = (
/obj/structure/table/reinforced,
/obj/machinery/recharger,
/obj/effect/mapping_helpers/valid_shuttle_turf,
/turf/simulated/floor/plasteel{
	dir = 4;
	icon_state = "vault"
	},
/area/shuttle/escape)
"an" = (
/obj/effect/mapping_helpers/valid_shuttle_turf,
/turf/simulated/floor/plasteel{
	icon_state = "dark"
	},
/area/shuttle/escape)
"ao" = (
/obj/structure/chair/comfy/shuttle{
	dir = 1
	},
/obj/effect/mapping_helpers/valid_shuttle_turf,
/turf/simulated/floor/plasteel{
	icon_state = "dark"
	},
/area/shuttle/escape)
"ap" = (
/obj/structure/table/reinforced,
/obj/item/storage/toolbox/mechanical,
/obj/effect/mapping_helpers/valid_shuttle_turf,
/turf/simulated/floor/plasteel{
	dir = 4;
	icon_state = "vault"
	},
/area/shuttle/escape)
"ar" = (
/obj/machinery/computer/security{
	network = list("SS13","Research Outpost","Mining Outpost","Telecomms");
	dir = 4
	},
/obj/structure/sign/poster/official/nanotrasen_logo{
	pixel_x = -32
	},
/obj/effect/mapping_helpers/valid_shuttle_turf,
/turf/simulated/floor/plasteel{
	dir = 9;
	icon_state = "darkred"
	},
/area/shuttle/escape)
"as" = (
/obj/structure/chair/comfy/shuttle{
	dir = 8
	},
/obj/effect/mapping_helpers/valid_shuttle_turf,
/turf/simulated/floor/plasteel{
	icon_state = "dark"
	},
/area/shuttle/escape)
"at" = (
/obj/item/radio/intercom{
	dir = 4;
	name = "Station Intercom (General)";
	pixel_x = 29;
	pixel_y = -60
	},
/obj/effect/mapping_helpers/valid_shuttle_turf,
/turf/simulated/floor/plasteel{
	icon_state = "dark"
	},
/area/shuttle/escape)
"au" = (
/obj/structure/chair/comfy/shuttle{
	dir = 4
	},
/obj/effect/mapping_helpers/valid_shuttle_turf,
/turf/simulated/floor/plasteel{
	icon_state = "dark"
	},
/area/shuttle/escape)
"ax" = (
/obj/machinery/computer/station_alert{
	dir = 8
	},
/obj/structure/sign/poster/official/nanotrasen_logo{
	pixel_x = 32
	},
/obj/effect/mapping_helpers/valid_shuttle_turf,
/turf/simulated/floor/plasteel{
	dir = 5;
	icon_state = "darkyellow"
	},
/area/shuttle/escape)
"ay" = (
/obj/machinery/computer/secure_data{
	dir = 4
	},
/obj/effect/mapping_helpers/valid_shuttle_turf,
/turf/simulated/floor/plasteel{
	dir = 10;
	icon_state = "darkred"
	},
/area/shuttle/escape)
"az" = (
/obj/structure/chair/comfy/shuttle{
	dir = 4
	},
/obj/effect/mapping_helpers/valid_shuttle_turf,
/turf/simulated/floor/mineral/plastitanium/red/brig,
/area/shuttle/escape)
"aA" = (
/obj/machinery/light,
/obj/structure/chair/comfy/shuttle{
	dir = 8
	},
/obj/effect/mapping_helpers/valid_shuttle_turf,
/turf/simulated/floor/plasteel{
	icon_state = "dark"
	},
/area/shuttle/escape)
"aB" = (
/obj/machinery/light,
/obj/structure/chair/comfy/shuttle{
	dir = 4
	},
/obj/effect/mapping_helpers/valid_shuttle_turf,
/turf/simulated/floor/plasteel{
	icon_state = "dark"
	},
/area/shuttle/escape)
"aC" = (
/obj/machinery/computer/atmos_alert{
	dir = 8
	},
/obj/effect/mapping_helpers/valid_shuttle_turf,
/turf/simulated/floor/plasteel{
	dir = 6;
	icon_state = "darkyellow"
	},
/area/shuttle/escape)
"aD" = (
/obj/machinery/status_display,
/obj/effect/mapping_helpers/valid_shuttle_turf,
/turf/simulated/wall/mineral/titanium,
/area/shuttle/escape)
"aF" = (
/obj/machinery/door/airlock/command/glass{
	name = "Escape Shuttle Cockpit"
	},
/obj/effect/mapping_helpers/airlock/access/all/command/general,
/obj/effect/mapping_helpers/valid_shuttle_turf,
/turf/simulated/floor/plasteel,
/area/shuttle/escape)
"aG" = (
/obj/structure/table/reinforced,
/obj/effect/mapping_helpers/valid_shuttle_turf,
/turf/simulated/floor/mineral/plastitanium/red/brig,
/area/shuttle/escape)
"aH" = (
/obj/effect/mapping_helpers/valid_shuttle_turf,
/turf/simulated/floor/mineral/plastitanium/red/brig,
/area/shuttle/escape)
"aI" = (
/obj/machinery/light{
	dir = 1;
	on = 1
	},
/obj/structure/chair/comfy/shuttle,
/obj/effect/mapping_helpers/valid_shuttle_turf,
/turf/simulated/floor/mineral/plastitanium/red/brig,
/area/shuttle/escape)
"aJ" = (
/obj/structure/table/reinforced,
/obj/item/storage/fancy/donut_box,
/obj/effect/mapping_helpers/valid_shuttle_turf,
/turf/simulated/floor/mineral/plastitanium/red/brig,
/area/shuttle/escape)
"aL" = (
/obj/structure/table/reinforced,
/obj/item/storage/firstaid/regular,
/obj/machinery/light{
	dir = 1;
	on = 1
	},
/obj/effect/mapping_helpers/valid_shuttle_turf,
/turf/simulated/floor/plasteel{
	dir = 1;
	icon_state = "redcorner"
	},
/area/shuttle/escape)
"aM" = (
/obj/effect/mapping_helpers/valid_shuttle_turf,
/turf/simulated/floor/plasteel{
	dir = 1;
	icon_state = "blue"
	},
/area/shuttle/escape)
"aN" = (
/obj/structure/chair/comfy/shuttle{
	dir = 1
	},
/obj/effect/mapping_helpers/valid_shuttle_turf,
/turf/simulated/floor/mineral/plastitanium/red/brig,
/area/shuttle/escape)
"aO" = (
/obj/structure/chair/comfy/shuttle,
/obj/effect/mapping_helpers/valid_shuttle_turf,
/turf/simulated/floor/mineral/plastitanium/red/brig,
/area/shuttle/escape)
"aR" = (
/obj/structure/closet/fireaxecabinet{
	pixel_x = 32
	},
/obj/machinery/light{
	dir = 1;
	on = 1
	},
/obj/structure/chair/comfy/shuttle,
/obj/effect/mapping_helpers/valid_shuttle_turf,
/turf/simulated/floor/plasteel{
	dir = 4;
	icon_state = "neutralcorner"
	},
/area/shuttle/escape)
"aS" = (
/obj/item/storage/firstaid/o2,
/obj/structure/table,
/obj/effect/mapping_helpers/valid_shuttle_turf,
/turf/simulated/floor/plasteel,
/area/shuttle/escape)
"aT" = (
/obj/machinery/light{
	dir = 1;
	on = 1
	},
/obj/structure/chair/comfy/shuttle,
/obj/effect/mapping_helpers/valid_shuttle_turf,
/turf/simulated/floor/plasteel{
	dir = 1;
	icon_state = "bot"
	},
/area/shuttle/escape)
"aU" = (
/obj/structure/chair/comfy/shuttle,
/obj/effect/mapping_helpers/valid_shuttle_turf,
/turf/simulated/floor/plasteel{
	dir = 1;
	icon_state = "bot"
	},
/area/shuttle/escape)
"aV" = (
/obj/structure/closet/crate/internals,
/obj/item/clothing/mask/breath,
/obj/item/clothing/mask/breath,
/obj/item/clothing/mask/breath,
/obj/item/clothing/mask/breath,
/obj/item/tank/internals/emergency_oxygen/engi,
/obj/item/tank/internals/emergency_oxygen/engi,
/obj/item/tank/internals/emergency_oxygen/engi,
/obj/item/tank/internals/emergency_oxygen/engi,
/obj/effect/mapping_helpers/valid_shuttle_turf,
/turf/simulated/floor/plasteel{
	dir = 1;
	icon_state = "bot"
	},
/area/shuttle/escape)
"aW" = (
/obj/item/radio/intercom{
	dir = 8;
	pixel_x = -28
	},
/obj/structure/chair/comfy/shuttle{
	dir = 4
	},
/obj/effect/mapping_helpers/valid_shuttle_turf,
/turf/simulated/floor/mineral/plastitanium/red/brig,
/area/shuttle/escape)
"aX" = (
/obj/structure/chair/comfy/shuttle{
	dir = 8
	},
/obj/effect/mapping_helpers/valid_shuttle_turf,
/turf/simulated/floor/mineral/plastitanium/red/brig,
/area/shuttle/escape)
"aY" = (
/obj/structure/table/reinforced,
/obj/machinery/recharger,
/obj/effect/mapping_helpers/valid_shuttle_turf,
/turf/simulated/floor/plasteel{
	dir = 1;
	icon_state = "redcorner"
	},
/area/shuttle/escape)
"ba" = (
/obj/effect/mapping_helpers/valid_shuttle_turf,
/turf/simulated/floor/plasteel{
	dir = 8;
	icon_state = "neutralfull"
	},
/area/shuttle/escape)
"bd" = (
/obj/effect/mapping_helpers/valid_shuttle_turf,
/turf/simulated/floor/plasteel{
	dir = 4;
	icon_state = "neutralcorner"
	},
/area/shuttle/escape)
"be" = (
/obj/machinery/door/airlock/titanium/glass{
	name = "Emergency Airlock Access"
	},
/obj/effect/mapping_helpers/airlock/access/all/security/doors,
/obj/effect/mapping_helpers/valid_shuttle_turf,
/turf/simulated/floor/plasteel,
/area/shuttle/escape)
"bf" = (
/obj/effect/mapping_helpers/valid_shuttle_turf,
/turf/simulated/floor/plasteel{
	icon_state = "neutralcorner"
	},
/area/shuttle/escape)
"bg" = (
/obj/effect/mapping_helpers/valid_shuttle_turf,
/turf/simulated/floor/plasteel{
	icon_state = "neutral"
	},
/area/shuttle/escape)
"bh" = (
/obj/effect/mapping_helpers/valid_shuttle_turf,
/turf/simulated/floor/plasteel{
	dir = 8;
	icon_state = "neutralcorner"
	},
/area/shuttle/escape)
"bi" = (
/obj/machinery/door/airlock/external{
	id_tag = "s_docking_airlock"
	},
/obj/structure/fans/tiny,
/turf/simulated/floor/plating,
/area/shuttle/escape)
"bj" = (
/obj/machinery/door/airlock/security/glass{
	name = "Escape Shuttle Cell"
	},
/obj/effect/mapping_helpers/airlock/access/all/security/doors,
/obj/effect/mapping_helpers/valid_shuttle_turf,
/turf/simulated/floor/mineral/plastitanium/red/brig,
/area/shuttle/escape)
"bk" = (
/obj/effect/mapping_helpers/valid_shuttle_turf,
/turf/simulated/floor/plasteel{
	dir = 8;
	icon_state = "redcorner"
	},
/area/shuttle/escape)
"bl" = (
/obj/effect/mapping_helpers/valid_shuttle_turf,
/turf/simulated/floor/plasteel{
	dir = 1;
	icon_state = "neutral"
	},
/area/shuttle/escape)
"bm" = (
/obj/effect/mapping_helpers/valid_shuttle_turf,
/turf/simulated/floor/plasteel{
	dir = 1;
	icon_state = "neutralcorner"
	},
/area/shuttle/escape)
"bn" = (
/obj/effect/mapping_helpers/valid_shuttle_turf,
/turf/simulated/floor/mech_bay_recharge_floor,
/area/shuttle/escape)
"bo" = (
/obj/machinery/door/airlock/titanium{
	aiControlDisabled = 1;
	hackProof = 1;
	id_tag = "s_docking_airlock";
	name = "Shuttle Hatch"
	},
/turf/simulated/floor/plating,
/area/shuttle/escape)
"bp" = (
/obj/structure/table/reinforced,
/obj/machinery/recharger,
/obj/effect/mapping_helpers/valid_shuttle_turf,
/turf/simulated/floor/mineral/plastitanium/red/brig,
/area/shuttle/escape)
"br" = (
/obj/item/kirbyplants,
/obj/effect/mapping_helpers/valid_shuttle_turf,
/turf/simulated/floor/plasteel{
	dir = 8;
	icon_state = "redcorner"
	},
/area/shuttle/escape)
"bu" = (
/obj/structure/shuttle/engine/heater,
/obj/structure/window/reinforced{
	dir = 1
	},
/turf/simulated/floor/plating/airless,
/area/shuttle/escape)
"bw" = (
/obj/structure/shuttle/engine/propulsion,
/turf/simulated/floor/plating/airless,
/area/shuttle/escape)
"bx" = (
/obj/item/kirbyplants,
/obj/structure/extinguisher_cabinet{
	pixel_x = 28
	},
/obj/effect/mapping_helpers/valid_shuttle_turf,
/turf/simulated/floor/plasteel{
	icon_state = "neutralcorner"
	},
/area/shuttle/escape)
"by" = (
/obj/structure/table,
/obj/item/storage/firstaid,
/obj/effect/turf_decal/delivery/hollow,
/obj/effect/mapping_helpers/valid_shuttle_turf,
/turf/simulated/floor/plasteel,
/area/shuttle/escape)
"bz" = (
/obj/machinery/light,
/obj/structure/chair/comfy/shuttle{
	dir = 1
	},
/obj/effect/mapping_helpers/valid_shuttle_turf,
/turf/simulated/floor/plasteel{
	dir = 1;
	icon_state = "bot"
	},
/area/shuttle/escape)
"bA" = (
/obj/machinery/status_display{
	pixel_y = -32
	},
/obj/structure/chair/comfy/shuttle{
	dir = 1
	},
/obj/effect/mapping_helpers/valid_shuttle_turf,
/turf/simulated/floor/plasteel{
	dir = 1;
	icon_state = "bot"
	},
/area/shuttle/escape)
"bB" = (
/obj/structure/chair/comfy/shuttle{
	dir = 1
	},
/obj/effect/mapping_helpers/valid_shuttle_turf,
/turf/simulated/floor/plasteel{
	dir = 1;
	icon_state = "bot"
	},
/area/shuttle/escape)
"bC" = (
/obj/machinery/door/airlock/command/glass{
	name = "Escape Shuttle Cockpit"
	},
/obj/effect/mapping_helpers/airlock/access/all/security/doors,
/obj/effect/mapping_helpers/valid_shuttle_turf,
/turf/simulated/floor/plasteel{
	dir = 8;
	icon_state = "neutralfull"
	},
/area/shuttle/escape)
"bD" = (
/obj/machinery/door/airlock/titanium{
	aiControlDisabled = 1;
	hackProof = 1;
	id_tag = "s_docking_airlock";
	name = "Shuttle Hatch"
	},
/obj/docking_port/mobile/emergency{
	dwidth = 11;
	height = 18;
	timid = 1;
	width = 29
	},
/turf/simulated/floor/plating,
/area/shuttle/escape)
"bE" = (
/obj/effect/mapping_helpers/valid_shuttle_turf,
/turf/simulated/floor/plasteel,
/area/shuttle/escape)
"bF" = (
/obj/machinery/light{
	dir = 1;
	on = 1
	},
/obj/effect/mapping_helpers/valid_shuttle_turf,
/turf/simulated/floor/plasteel{
	icon_state = "neutral"
	},
/area/shuttle/escape)
"bG" = (
/obj/machinery/mech_bay_recharge_port,
/obj/effect/mapping_helpers/valid_shuttle_turf,
/turf/simulated/floor/plasteel{
	dir = 1;
	icon_state = "bot"
	},
/area/shuttle/escape)
"bH" = (
/obj/machinery/computer/mech_bay_power_console,
/obj/effect/mapping_helpers/valid_shuttle_turf,
/turf/simulated/floor/plasteel,
/area/shuttle/escape)
"bI" = (
/obj/structure/table,
/obj/item/weldingtool/largetank{
	pixel_x = 4;
	pixel_y = -4
	},
/obj/item/clothing/glasses/welding{
	pixel_y = 10
	},
/obj/machinery/light/small{
	dir = 4;
	pixel_y = 8
	},
/obj/effect/mapping_helpers/valid_shuttle_turf,
/turf/simulated/floor/plasteel{
	dir = 1;
	icon_state = "bot"
	},
/area/shuttle/escape)
"bJ" = (
/obj/item/kirbyplants,
/obj/machinery/light{
	dir = 8
	},
/obj/effect/mapping_helpers/valid_shuttle_turf,
/turf/simulated/floor/plasteel,
/area/shuttle/escape)
"bK" = (
/obj/item/kirbyplants,
/obj/machinery/light{
	dir = 4
	},
/obj/effect/mapping_helpers/valid_shuttle_turf,
/turf/simulated/floor/plasteel,
/area/shuttle/escape)
"bL" = (
/obj/structure/reagent_dispensers/fueltank/chem{
	pixel_x = -32
	},
/obj/effect/mapping_helpers/valid_shuttle_turf,
/turf/simulated/floor/plasteel{
	dir = 1;
	icon_state = "bot"
	},
/area/shuttle/escape)
"bM" = (
/obj/effect/mapping_helpers/valid_shuttle_turf,
/turf/simulated/floor/plasteel{
	icon_state = "browncorner"
	},
/area/shuttle/escape)
"bN" = (
/obj/effect/mapping_helpers/valid_shuttle_turf,
/turf/simulated/floor/plasteel{
	dir = 8;
	icon_state = "browncorner"
	},
/area/shuttle/escape)
"bO" = (
/obj/effect/mapping_helpers/valid_shuttle_turf,
/turf/simulated/floor/plasteel{
	dir = 1;
	icon_state = "bot"
	},
/area/shuttle/escape)
"bP" = (
/obj/structure/chair/comfy/shuttle{
	dir = 4
	},
/obj/effect/mapping_helpers/valid_shuttle_turf,
/turf/simulated/floor/plasteel{
	dir = 1;
	icon_state = "bot"
	},
/area/shuttle/escape)
"bQ" = (
/obj/structure/chair/comfy/shuttle{
	dir = 8
	},
/obj/effect/mapping_helpers/valid_shuttle_turf,
/turf/simulated/floor/plasteel{
	dir = 1;
	icon_state = "bot"
	},
/area/shuttle/escape)
"bR" = (
/obj/structure/flora/ausbushes/grassybush,
/obj/structure/flora/ausbushes/lavendergrass,
/obj/structure/flora/ausbushes/ppflowers,
/obj/structure/flora/ausbushes/sunnybush,
/obj/structure/window/full/shuttle,
/obj/effect/mapping_helpers/valid_shuttle_turf,
/turf/simulated/floor/grass,
/area/shuttle/escape)
"bS" = (
/obj/machinery/door/airlock/titanium/glass{
	name = "Shuttle Cargo Hatch"
	},
/obj/effect/mapping_helpers/valid_shuttle_turf,
/turf/simulated/floor/plasteel,
/area/shuttle/escape)
"bT" = (
/obj/effect/mapping_helpers/valid_shuttle_turf,
/turf/simulated/floor/plasteel{
	dir = 4;
	icon_state = "brown"
	},
/area/shuttle/escape)
"bU" = (
/obj/effect/mapping_helpers/valid_shuttle_turf,
/turf/simulated/floor/plasteel{
	dir = 8;
	icon_state = "brown"
	},
/area/shuttle/escape)
"bV" = (
/obj/structure/reagent_dispensers/watertank,
/obj/effect/mapping_helpers/valid_shuttle_turf,
/turf/simulated/floor/plasteel{
	dir = 1;
	icon_state = "bot"
	},
/area/shuttle/escape)
"bX" = (
/obj/machinery/ai_status_display,
/obj/effect/mapping_helpers/valid_shuttle_turf,
/turf/simulated/wall/mineral/titanium,
/area/shuttle/escape)
"bY" = (
/obj/structure/flora/ausbushes/grassybush,
/obj/structure/flora/ausbushes/lavendergrass,
/obj/structure/flora/ausbushes/ywflowers,
/obj/structure/flora/ausbushes/fernybush,
/obj/structure/window/full/shuttle,
/obj/effect/mapping_helpers/valid_shuttle_turf,
/turf/simulated/floor/grass,
/area/shuttle/escape)
"bZ" = (
/obj/structure/table,
/obj/machinery/cell_charger,
/obj/item/stock_parts/cell/high,
/obj/machinery/light/small{
	dir = 8
	},
/obj/effect/mapping_helpers/valid_shuttle_turf,
/turf/simulated/floor/plasteel{
	dir = 1;
	icon_state = "bot"
	},
/area/shuttle/escape)
"ca" = (
/obj/structure/closet/crate,
/obj/item/storage/toolbox/emergency,
/obj/item/storage/toolbox/emergency,
/obj/item/flashlight/flare,
/obj/item/flashlight/flare,
/obj/item/crowbar,
/obj/item/wrench,
/obj/item/radio,
/obj/effect/mapping_helpers/valid_shuttle_turf,
/turf/simulated/floor/plasteel{
	dir = 1;
	icon_state = "bot"
	},
/area/shuttle/escape)
"cb" = (
/obj/item/kirbyplants,
/obj/effect/mapping_helpers/valid_shuttle_turf,
/turf/simulated/floor/plasteel,
/area/shuttle/escape)
"cc" = (
/obj/structure/extinguisher_cabinet,
/obj/effect/mapping_helpers/valid_shuttle_turf,
/turf/simulated/wall/mineral/titanium,
/area/shuttle/escape)
"cd" = (
/obj/item/radio/intercom{
	dir = 8;
	pixel_x = -28
	},
/obj/machinery/recharge_station,
/obj/effect/mapping_helpers/valid_shuttle_turf,
/turf/simulated/floor/plasteel{
	dir = 1;
	icon_state = "bot"
	},
/area/shuttle/escape)
"ce" = (
/obj/structure/closet/crate/engineering,
/obj/item/storage/toolbox/electrical{
	pixel_x = -4;
	pixel_y = 4
	},
/obj/item/storage/toolbox/emergency,
/obj/item/storage/toolbox/mechanical{
	pixel_x = 4;
	pixel_y = -4
	},
/obj/effect/mapping_helpers/valid_shuttle_turf,
/turf/simulated/floor/plasteel{
	dir = 1;
	icon_state = "bot"
	},
/area/shuttle/escape)
"cf" = (
/obj/structure/extinguisher_cabinet{
	pixel_x = -28
	},
/obj/machinery/recharge_station,
/obj/effect/mapping_helpers/valid_shuttle_turf,
/turf/simulated/floor/plasteel{
	dir = 1;
	icon_state = "bot"
	},
/area/shuttle/escape)
"cg" = (
/obj/effect/mapping_helpers/valid_shuttle_turf,
/turf/simulated/floor/plasteel{
	dir = 4;
	icon_state = "browncorner"
	},
/area/shuttle/escape)
"ch" = (
/obj/effect/mapping_helpers/valid_shuttle_turf,
/turf/simulated/floor/plasteel{
	dir = 1;
	icon_state = "browncorner"
	},
/area/shuttle/escape)
"ci" = (
/obj/structure/closet/crate/medical,
/obj/item/storage/firstaid/regular,
/obj/item/storage/firstaid/o2{
	pixel_x = 2;
	pixel_y = -2
	},
/obj/item/storage/firstaid/toxin{
	pixel_x = -2;
	pixel_y = 4
	},
/obj/machinery/light/small,
/obj/effect/mapping_helpers/valid_shuttle_turf,
/turf/simulated/floor/plasteel{
	dir = 1;
	icon_state = "bot"
	},
/area/shuttle/escape)
"cj" = (
/obj/machinery/light{
	dir = 8
	},
/obj/effect/mapping_helpers/valid_shuttle_turf,
/turf/simulated/floor/plasteel,
/area/shuttle/escape)
"ck" = (
/obj/structure/chair/comfy/shuttle{
	dir = 8
	},
/obj/machinery/light{
	dir = 4
	},
/obj/effect/mapping_helpers/valid_shuttle_turf,
/turf/simulated/floor/plasteel{
	dir = 1;
	icon_state = "bot"
	},
/area/shuttle/escape)
"cl" = (
/obj/machinery/door/airlock/medical/glass{
	name = "Escape Shuttle Infirmary"
	},
/obj/effect/turf_decal/stripes/line{
	dir = 2
	},
/obj/effect/mapping_helpers/valid_shuttle_turf,
/turf/simulated/floor/plasteel,
/area/shuttle/escape)
"cm" = (
/obj/structure/sign/greencross,
/obj/effect/mapping_helpers/valid_shuttle_turf,
/turf/simulated/wall/mineral/titanium,
/area/shuttle/escape)
"co" = (
/obj/machinery/sleeper{
	dir = 4
	},
/obj/effect/mapping_helpers/valid_shuttle_turf,
/turf/simulated/floor/plasteel{
	icon_state = "cmo"
	},
/area/shuttle/escape)
"cp" = (
/obj/effect/mapping_helpers/valid_shuttle_turf,
/turf/simulated/floor/plasteel{
	icon_state = "cmo"
	},
/area/shuttle/escape)
"cq" = (
/obj/machinery/sleeper,
/obj/effect/mapping_helpers/valid_shuttle_turf,
/turf/simulated/floor/plasteel{
	icon_state = "cmo"
	},
/area/shuttle/escape)
"cr" = (
/obj/structure/chair/comfy/shuttle{
	dir = 4
	},
/obj/effect/mapping_helpers/valid_shuttle_turf,
/turf/simulated/floor/plasteel,
/area/shuttle/escape)
"cs" = (
/obj/effect/mapping_helpers/valid_shuttle_turf,
/turf/simulated/floor/plasteel{
	dir = 1;
	icon_state = "whiteblue"
	},
/area/shuttle/escape)
"ct" = (
/obj/structure/extinguisher_cabinet{
	pixel_x = 28
	},
/obj/machinery/light/small{
	dir = 4;
	pixel_y = 8
	},
/obj/effect/mapping_helpers/valid_shuttle_turf,
/turf/simulated/floor/plasteel{
	dir = 6;
	icon_state = "whiteblue"
	},
/area/shuttle/escape)
"cu" = (
/obj/machinery/door/airlock/medical/glass{
	name = "Escape Shuttle Infirmary"
	},
/obj/effect/mapping_helpers/valid_shuttle_turf,
/turf/simulated/floor/plasteel{
	dir = 8;
	icon_state = "neutralfull"
	},
/area/shuttle/escape)
"cv" = (
/obj/effect/mapping_helpers/valid_shuttle_turf,
/turf/simulated/floor/plasteel{
	icon_state = "white"
	},
/area/shuttle/escape)
"cw" = (
/obj/structure/bed/roller,
/obj/machinery/iv_drip,
/obj/effect/mapping_helpers/valid_shuttle_turf,
/turf/simulated/floor/plasteel{
	dir = 4;
	icon_state = "whiteblue"
	},
/area/shuttle/escape)
"cx" = (
/obj/structure/table/reinforced,
/obj/item/reagent_containers/iv_bag/blood/random,
/obj/item/reagent_containers/iv_bag/blood/random,
/obj/item/reagent_containers/iv_bag/blood/random,
/obj/effect/mapping_helpers/valid_shuttle_turf,
/turf/simulated/floor/plasteel{
	dir = 4;
	icon_state = "whiteblue"
	},
/area/shuttle/escape)
"cy" = (
/obj/effect/mapping_helpers/valid_shuttle_turf,
/turf/simulated/floor/plasteel{
	icon_state = "whiteblue"
	},
/area/shuttle/escape)
"cz" = (
/obj/structure/table/reinforced,
/obj/item/storage/firstaid/o2{
	pixel_x = -3;
	pixel_y = -3
	},
/obj/item/storage/firstaid/regular,
/obj/item/storage/firstaid/regular{
	pixel_x = 3;
	pixel_y = 3
	},
/obj/effect/mapping_helpers/valid_shuttle_turf,
/turf/simulated/floor/plasteel{
	dir = 5;
	icon_state = "whiteblue"
	},
/area/shuttle/escape)
"cA" = (
/obj/machinery/light{
	dir = 8
	},
/obj/structure/chair/comfy/shuttle{
	dir = 4
	},
/obj/effect/mapping_helpers/valid_shuttle_turf,
/turf/simulated/floor/plasteel{
	dir = 1;
	icon_state = "bot"
	},
/area/shuttle/escape)
"cB" = (
/obj/structure/table/reinforced,
/obj/machinery/light{
	dir = 8
	},
/obj/item/reagent_containers/drinks/mug/med,
/obj/effect/mapping_helpers/valid_shuttle_turf,
/turf/simulated/floor/plasteel{
	icon_state = "cmo"
	},
/area/shuttle/escape)
"cC" = (
/obj/item/flag/med,
/obj/effect/mapping_helpers/valid_shuttle_turf,
/turf/simulated/floor/plasteel{
	icon_state = "cmo"
	},
/area/shuttle/escape)
"cD" = (
/obj/structure/table/reinforced,
/obj/item/storage/backpack/medic,
/obj/item/storage/belt/medical,
/obj/effect/mapping_helpers/valid_shuttle_turf,
/turf/simulated/floor/plasteel{
	icon_state = "cmo"
	},
/area/shuttle/escape)
"cE" = (
/obj/structure/bed/roller,
/obj/effect/mapping_helpers/valid_shuttle_turf,
/turf/simulated/floor/plasteel{
	icon_state = "cmo"
	},
/area/shuttle/escape)
"cF" = (
/obj/item/radio/intercom{
	dir = 4;
	name = "Station Intercom (General)";
	pixel_x = 29;
	pixel_y = -30
	},
/obj/structure/bed/roller,
/obj/effect/mapping_helpers/valid_shuttle_turf,
/turf/simulated/floor/plasteel{
	icon_state = "cmo"
	},
/area/shuttle/escape)
"cG" = (
/obj/structure/table/reinforced,
/obj/item/clothing/gloves/color/latex/nitrile,
/obj/item/clothing/mask/breath,
/obj/effect/mapping_helpers/valid_shuttle_turf,
/turf/simulated/floor/plasteel{
	icon_state = "cmo"
	},
/area/shuttle/escape)
"cH" = (
/turf/simulated/wall/mineral/plastitanium,
/area/shuttle/escape)
"fX" = (
/obj/effect/mapping_helpers/valid_shuttle_turf,
/turf/simulated/wall/mineral/titanium,
/area/shuttle/escape)
"Ef" = (
/obj/effect/spawner/window/shuttle,
/obj/effect/mapping_helpers/valid_shuttle_turf,
/turf/simulated/floor/plating,
/area/shuttle/escape)

(1,1,1) = {"
aa
aa
aa
aa
aa
ab
ab
ab
ab
bo
ab
bD
ab
ac
ac
ac
ab
bo
ab
bo
ab
ab
ac
ac
ab
ab
ab
ab
aa
"}
(2,1,1) = {"
aa
aa
aa
aa
aa
ab
aG
aW
az
aH
fX
bE
bJ
bP
bP
bP
cb
bE
cj
bE
cb
bP
bP
bP
cA
aV
ab
bu
bw
"}
(3,1,1) = {"
aa
aa
aa
aa
aa
ac
aO
aH
aH
aH
Ef
bg
ba
ba
ba
ba
ba
ba
ba
ba
ba
ba
ba
ba
ba
bB
ac
bu
bw
"}
(4,1,1) = {"
aa
aa
aa
aa
ab
ab
aI
aH
aH
aN
Ef
bg
ba
bQ
bQ
bQ
bQ
bQ
ba
bQ
bQ
bQ
bQ
bQ
ba
bB
ac
bu
bw
"}
(5,1,1) = {"
ab
ab
ac
ab
ab
ab
aO
aH
aH
aN
Ef
bg
ba
bR
aD
bY
cc
bR
ba
bY
cc
bR
bX
bY
ba
bB
ab
cH
cH
"}
(6,1,1) = {"
ab
ae
am
ar
ay
fX
aJ
aX
aH
bp
fX
bg
ba
bP
bP
bP
bP
bP
ba
bP
cr
bP
bP
bP
ba
bB
ab
bu
bw
"}
(7,1,1) = {"
ac
af
an
as
aA
fX
fX
Ef
bj
fX
fX
bF
ba
ba
ba
ba
ba
ba
ba
ba
ba
ba
ba
ba
ba
bB
ac
bu
bw
"}
(8,1,1) = {"
ac
ag
ao
an
an
aD
aL
aY
bk
br
Ef
bg
ba
bQ
bQ
bQ
bQ
bQ
ba
bQ
bQ
bQ
bQ
bQ
ba
bB
ab
cH
cH
"}
(9,1,1) = {"
ac
ah
ao
an
an
aF
aM
ba
ba
bg
bC
bg
ba
bR
bX
bY
cc
bR
ba
bY
cc
bR
aD
bY
ba
bB
ac
bu
bw
"}
(10,1,1) = {"
ac
ai
ao
an
an
aF
aM
ba
ba
bg
bC
bg
ba
bP
bP
bP
bP
bP
ba
bP
bP
bP
bP
bP
ba
bB
ac
bu
bw
"}
(11,1,1) = {"
ac
aj
ao
at
an
aD
aR
bd
bf
bx
Ef
bg
ba
ba
ba
ba
ba
ba
ba
ba
ba
ba
ba
ba
ba
bB
ab
cH
cH
"}
(12,1,1) = {"
ac
ak
an
au
aB
fX
fX
be
be
fX
fX
aV
bK
bE
bE
bQ
bQ
bQ
ck
bQ
bQ
ba
ba
bQ
ck
aV
ac
bu
bw
"}
(13,1,1) = {"
ab
al
ap
ax
aC
fX
aS
bf
bd
by
fX
fX
fX
bS
bS
fX
fX
fX
fX
cm
Ef
cu
cu
Ef
aD
fX
ab
bu
bw
"}
(14,1,1) = {"
ab
ab
ac
ab
ab
ab
aT
bg
bl
bz
fX
bG
bL
bE
bE
bZ
cd
cf
fX
co
cs
cv
cv
cy
cB
cD
ab
cH
cH
"}
(15,1,1) = {"
aa
aa
aa
aa
ab
ab
aU
bg
bl
bA
fX
bn
bM
bT
bT
bT
bT
cg
cl
cp
cs
cv
cv
cy
cp
cE
ac
bu
bw
"}
(16,1,1) = {"
aa
aa
aa
aa
aa
ac
aU
bg
bl
bB
fX
bH
bN
bU
bU
bU
bU
ch
cl
cp
cs
cv
cv
cy
cp
cF
ac
bu
bw
"}
(17,1,1) = {"
aa
aa
aa
aa
aa
ab
aV
bh
bm
aV
fX
bI
bO
bV
aV
ca
ce
ci
cm
cq
ct
cw
cx
cz
cC
cG
ab
bu
bw
"}
(18,1,1) = {"
aa
aa
aa
aa
aa
ab
ac
bi
bi
ac
ab
ab
ac
ac
ac
ac
ac
ab
ab
ab
ab
ac
ac
ac
ac
ab
ab
ab
aa
"}
