//MAP CONVERTED BY dmm2tgm.py THIS HEADER COMMENT PREVENTS RECONVERSION, DO NOT REMOVE
"aa" = (
/turf/space,
/area/space)
"ab" = (
/turf/space,
/turf/simulated/shuttle/wall{
	tag = "icon-swall_f6";
	icon_state = "swall_f6";
	dir = 2
	},
/area/shuttle/escape)
"ac" = (
/obj/structure/grille,
/obj/structure/shuttle/window,
/turf/simulated/shuttle/plating,
/area/shuttle/escape)
"ad" = (
/turf/simulated/shuttle/wall{
	icon_state = "swallc2";
	dir = 2
	},
/area/shuttle/escape)
"ae" = (
/turf/simulated/shuttle/wall{
	icon_state = "swall8";
	dir = 2
	},
/area/shuttle/escape)
"af" = (
/turf/simulated/shuttle/wall{
	icon_state = "swall0";
	dir = 2
	},
/area/shuttle/escape)
"ag" = (
/obj/machinery/door/airlock/shuttle{
	id_tag = "s_docking_airlock";
	name = "Emergency Shuttle Airlock";
	req_access_txt = "2"
	},
/turf/simulated/shuttle/floor,
/area/shuttle/escape)
"ah" = (
/obj/structure/sign/nosmoking_2,
/turf/simulated/shuttle/wall{
	icon_state = "swall0";
	dir = 2
	},
/area/shuttle/escape)
"ai" = (
/obj/machinery/door/airlock/shuttle{
	id_tag = "s_docking_airlock";
	name = "Emergency Shuttle Airlock";
	req_access_txt = "0"
	},
/turf/simulated/shuttle/floor,
/area/shuttle/escape)
"aj" = (
/turf/simulated/shuttle/wall{
	icon_state = "swall4";
	dir = 2
	},
/area/shuttle/escape)
"ak" = (
/turf/simulated/shuttle/wall{
	tag = "icon-swall12";
	icon_state = "swall12";
	dir = 2
	},
/area/shuttle/escape)
"al" = (
/turf/space,
/turf/simulated/shuttle/wall{
	tag = "icon-swall_f10";
	icon_state = "swall_f10";
	dir = 2
	},
/area/shuttle/escape)
"am" = (
/turf/space,
/turf/simulated/shuttle/wall{
	tag = "icon-swall_f6";
	icon_state = "swall_f6";
	dir = 2
	},
/turf/simulated/shuttle/wall{
	dir = 8;
	icon_state = "diagonalWall3"
	},
/area/shuttle/escape)
"an" = (
/turf/simulated/shuttle/wall{
	tag = "icon-swall11";
	icon_state = "swall11";
	dir = 2
	},
/area/shuttle/escape)
"ao" = (
/obj/structure/table,
/obj/item/phone{
	pixel_x = -3;
	pixel_y = 3
	},
/obj/item/cigbutt/cigarbutt{
	pixel_x = 5;
	pixel_y = -1
	},
/turf/simulated/shuttle/floor,
/area/shuttle/escape)
"ap" = (
/obj/machinery/computer/crew,
/turf/simulated/shuttle/floor,
/area/shuttle/escape)
"aq" = (
/obj/machinery/computer/security,
/turf/simulated/shuttle/floor,
/area/shuttle/escape)
"ar" = (
/obj/structure/table,
/obj/item/storage/firstaid/regular,
/turf/simulated/shuttle/floor,
/area/shuttle/escape)
"as" = (
/turf/simulated/shuttle/wall{
	tag = "icon-swall3";
	icon_state = "swall3";
	dir = 2
	},
/area/shuttle/escape)
"at" = (
/obj/structure/closet/emcloset,
/turf/simulated/shuttle/floor{
	icon_state = "floor3"
	},
/area/shuttle/escape)
"au" = (
/turf/simulated/shuttle/floor,
/area/shuttle/escape)
"av" = (
/obj/structure/chair,
/turf/simulated/shuttle/floor{
	icon_state = "floor3"
	},
/area/shuttle/escape)
"aw" = (
/obj/structure/chair,
/obj/machinery/light{
	dir = 1;
	on = 1
	},
/turf/simulated/shuttle/floor{
	icon_state = "floor3"
	},
/area/shuttle/escape)
"ax" = (
/obj/structure/chair,
/obj/item/radio/intercom{
	dir = 4;
	name = "Station Intercom (General)";
	pixel_x = 0;
	pixel_y = 27
	},
/turf/simulated/shuttle/floor{
	icon_state = "floor3"
	},
/area/shuttle/escape)
"ay" = (
/obj/structure/closet/crate{
	name = "lifejackets"
	},
/obj/item/clothing/suit/storage/hazardvest,
/obj/item/clothing/suit/storage/hazardvest,
/obj/item/clothing/suit/storage/hazardvest,
/obj/item/clothing/suit/storage/hazardvest,
/obj/item/clothing/suit/storage/hazardvest,
/obj/item/tank/emergency_oxygen/engi,
/obj/item/tank/emergency_oxygen/engi,
/obj/item/tank/emergency_oxygen/engi,
/obj/item/tank/emergency_oxygen/engi,
/obj/item/tank/emergency_oxygen/engi,
/obj/item/clothing/mask/breath{
	pixel_x = -5;
	pixel_y = -2
	},
/obj/item/clothing/mask/breath{
	pixel_x = -5;
	pixel_y = -2
	},
/obj/item/clothing/mask/breath{
	pixel_x = -5;
	pixel_y = -2
	},
/obj/item/clothing/mask/breath{
	pixel_x = -5;
	pixel_y = -2
	},
/obj/item/clothing/mask/breath{
	pixel_x = -5;
	pixel_y = -2
	},
/obj/item/clothing/head/hardhat,
/obj/item/clothing/head/hardhat,
/obj/item/clothing/head/hardhat,
/obj/item/clothing/head/hardhat,
/obj/item/clothing/head/hardhat,
/turf/simulated/shuttle/floor{
	icon_state = "floor3"
	},
/area/shuttle/escape)
"az" = (
/turf/simulated/shuttle/wall{
	icon_state = "swall1";
	dir = 2
	},
/area/shuttle/escape)
"aA" = (
/obj/structure/shuttle/engine/propulsion{
	dir = 8;
	icon_state = "propulsion";
	tag = "icon-propulsion (EAST)"
	},
/turf/simulated/shuttle/plating,
/area/shuttle/escape)
"aB" = (
/obj/structure/shuttle/engine/heater{
	tag = "icon-heater (WEST)";
	icon_state = "heater";
	dir = 8
	},
/obj/structure/window/reinforced{
	dir = 4
	},
/turf/simulated/shuttle/plating,
/area/shuttle/escape)
"aC" = (
/obj/structure/table,
/obj/item/storage/fancy,
/turf/simulated/shuttle/floor,
/area/shuttle/escape)
"aD" = (
/obj/structure/chair/office/dark{
	dir = 1
	},
/turf/simulated/shuttle/floor,
/area/shuttle/escape)
"aE" = (
/obj/structure/table,
/obj/item/restraints/handcuffs,
/turf/simulated/shuttle/floor,
/area/shuttle/escape)
"aF" = (
/obj/machinery/status_display,
/turf/simulated/shuttle/wall{
	tag = "icon-swall3";
	icon_state = "swall3";
	dir = 2
	},
/area/shuttle/escape)
"aG" = (
/obj/structure/dispenser/oxygen{
	layer = 2.7;
	pixel_x = -1;
	pixel_y = 2
	},
/turf/simulated/shuttle/floor{
	icon_state = "floor3"
	},
/area/shuttle/escape)
"aH" = (
/obj/structure/shuttle/engine/propulsion{
	dir = 8;
	icon_state = "propulsion_r";
	tag = "icon-propulsion_r (EAST)"
	},
/turf/simulated/shuttle/plating,
/area/shuttle/escape)
"aI" = (
/obj/structure/shuttle/engine/heater{
	tag = "icon-heater (WEST)";
	icon_state = "heater";
	dir = 8
	},
/obj/structure/window/reinforced{
	dir = 4
	},
/obj/machinery/light{
	icon_state = "tube1";
	dir = 4
	},
/turf/simulated/shuttle/plating,
/area/shuttle/escape)
"aJ" = (
/obj/machinery/computer/communications,
/turf/simulated/shuttle/floor,
/area/shuttle/escape)
"aK" = (
/obj/structure/chair/office/dark,
/turf/simulated/shuttle/floor,
/area/shuttle/escape)
"aL" = (
/obj/structure/chair{
	dir = 1
	},
/turf/simulated/shuttle/floor{
	icon_state = "floor3"
	},
/area/shuttle/escape)
"aM" = (
/obj/structure/chair{
	dir = 1
	},
/obj/machinery/light,
/turf/simulated/shuttle/floor{
	icon_state = "floor3"
	},
/area/shuttle/escape)
"aN" = (
/obj/structure/closet/crate{
	name = "lifejackets"
	},
/obj/item/clothing/suit/storage/hazardvest,
/obj/item/clothing/suit/storage/hazardvest,
/obj/item/clothing/suit/storage/hazardvest,
/obj/item/clothing/suit/storage/hazardvest,
/obj/item/clothing/suit/storage/hazardvest,
/obj/item/tank/emergency_oxygen/engi,
/obj/item/tank/emergency_oxygen/engi,
/obj/item/tank/emergency_oxygen/engi,
/obj/item/tank/emergency_oxygen/engi,
/obj/item/tank/emergency_oxygen/engi,
/obj/item/clothing/mask/breath{
	pixel_x = -5;
	pixel_y = -2
	},
/obj/item/clothing/mask/breath{
	pixel_x = -5;
	pixel_y = -2
	},
/obj/item/clothing/mask/breath{
	pixel_x = -5;
	pixel_y = -2
	},
/obj/item/clothing/mask/breath{
	pixel_x = -5;
	pixel_y = -2
	},
/obj/item/clothing/mask/breath{
	pixel_x = -5;
	pixel_y = -2
	},
/obj/item/clothing/head/hardhat,
/obj/item/clothing/head/hardhat,
/obj/item/clothing/head/hardhat,
/obj/item/clothing/head/hardhat,
/obj/item/clothing/head/hardhat,
/obj/machinery/light{
	icon_state = "tube1";
	dir = 4
	},
/turf/simulated/shuttle/floor{
	icon_state = "floor3"
	},
/area/shuttle/escape)
"aO" = (
/obj/structure/shuttle/engine/propulsion{
	dir = 8;
	icon_state = "burst_l"
	},
/turf/simulated/shuttle/plating,
/area/shuttle/escape)
"aP" = (
/obj/machinery/computer/emergency_shuttle,
/obj/machinery/light{
	dir = 8
	},
/turf/simulated/shuttle/floor,
/area/shuttle/escape)
"aQ" = (
/obj/structure/chair/office/dark{
	dir = 8
	},
/turf/simulated/shuttle/floor,
/area/shuttle/escape)
"aR" = (
/obj/machinery/door/airlock/command/glass{
	name = "Cockpit";
	req_access_txt = "19"
	},
/turf/simulated/shuttle/floor,
/area/shuttle/escape)
"aS" = (
/obj/machinery/vending/wallmed1{
	name = "Emergency NanoMed";
	pixel_x = 0;
	pixel_y = 0;
	req_access_txt = "0";
	use_power = 0
	},
/turf/simulated/shuttle/wall{
	icon_state = "swall0";
	dir = 2
	},
/area/shuttle/escape)
"aT" = (
/obj/structure/extinguisher_cabinet,
/turf/simulated/shuttle/wall{
	icon_state = "swall0";
	dir = 2
	},
/area/shuttle/escape)
"aU" = (
/obj/machinery/computer/atmos_alert,
/turf/simulated/shuttle/floor,
/area/shuttle/escape)
"aV" = (
/turf/simulated/shuttle/wall{
	icon_state = "swall2";
	dir = 2
	},
/area/shuttle/escape)
"aW" = (
/obj/structure/chair,
/obj/machinery/light{
	dir = 1
	},
/turf/simulated/shuttle/floor{
	icon_state = "floor3"
	},
/area/shuttle/escape)
"aX" = (
/obj/machinery/hologram/holopad,
/obj/machinery/status_display{
	dir = 4;
	layer = 4;
	pixel_x = 32;
	pixel_y = 0
	},
/turf/simulated/shuttle/floor,
/area/shuttle/escape)
"aY" = (
/obj/structure/table,
/obj/item/storage/toolbox/emergency,
/turf/simulated/shuttle/floor,
/area/shuttle/escape)
"aZ" = (
/obj/machinery/light{
	dir = 8
	},
/turf/simulated/shuttle/floor,
/area/shuttle/escape)
"ba" = (
/obj/structure/table,
/obj/machinery/recharger{
	active_power_usage = 0;
	idle_power_usage = 0;
	use_power = 0
	},
/turf/simulated/shuttle/floor,
/area/shuttle/escape)
"bb" = (
/obj/structure/table,
/obj/item/radio/intercom{
	broadcasting = 0;
	listening = 1;
	name = "Station Intercom (General)";
	pixel_y = -28
	},
/obj/item/paper_bin{
	pixel_x = -3;
	pixel_y = 7
	},
/turf/simulated/shuttle/floor,
/area/shuttle/escape)
"bc" = (
/obj/structure/table,
/obj/item/folder/blue,
/obj/structure/extinguisher_cabinet{
	pixel_x = 0;
	pixel_y = -30
	},
/turf/simulated/shuttle/floor,
/area/shuttle/escape)
"bd" = (
/obj/structure/chair{
	dir = 1
	},
/obj/item/radio/intercom{
	broadcasting = 0;
	listening = 1;
	name = "Station Intercom (General)";
	pixel_y = -28
	},
/obj/machinery/light,
/turf/simulated/shuttle/floor{
	icon_state = "floor3"
	},
/area/shuttle/escape)
"be" = (
/obj/structure/table,
/obj/item/healthanalyzer,
/obj/item/healthanalyzer{
	pixel_x = 3;
	pixel_y = 3
	},
/obj/item/stack/medical/ointment,
/obj/item/stack/medical/bruise_pack,
/obj/machinery/light{
	icon_state = "tube1";
	dir = 4
	},
/turf/simulated/shuttle/floor{
	icon_state = "floor3"
	},
/area/shuttle/escape)
"bf" = (
/turf/simulated/shuttle/wall{
	tag = "icon-swall15";
	icon_state = "swall15";
	dir = 2
	},
/area/shuttle/escape)
"bg" = (
/obj/structure/extinguisher_cabinet,
/turf/simulated/shuttle/wall{
	tag = "icon-swall12";
	icon_state = "swall12";
	dir = 2
	},
/area/shuttle/escape)
"bh" = (
/obj/machinery/door/airlock/command{
	name = "Emergency Recovery Airlock";
	req_access = null;
	req_access_txt = "19"
	},
/turf/simulated/shuttle/floor,
/area/shuttle/escape)
"bi" = (
/turf/simulated/shuttle/wall{
	tag = "icon-swall7";
	icon_state = "swall7";
	dir = 2
	},
/area/shuttle/escape)
"bj" = (
/obj/machinery/door/airlock/security/glass{
	name = "Brig";
	req_access_txt = "2"
	},
/turf/simulated/shuttle/floor{
	icon_state = "floor4"
	},
/area/shuttle/escape)
"bk" = (
/turf/simulated/shuttle/wall{
	tag = "icon-swall14";
	icon_state = "swall14";
	dir = 2
	},
/area/shuttle/escape)
"bl" = (
/obj/machinery/door/airlock/medical/glass{
	id_tag = null;
	name = "Escape Shuttle Infirmary";
	req_access_txt = "0"
	},
/turf/simulated/shuttle/floor,
/area/shuttle/escape)
"bm" = (
/obj/structure/sign/redcross,
/turf/simulated/shuttle/wall{
	dir = 1;
	icon_state = "swallc2"
	},
/area/shuttle/escape)
"bn" = (
/obj/machinery/door/airlock/shuttle{
	name = "Emergency Shuttle Cargo Bay Airlock"
	},
/turf/simulated/shuttle/floor,
/area/shuttle/escape)
"bo" = (
/obj/structure/chair{
	dir = 4
	},
/turf/simulated/shuttle/plating{
	icon_state = "floorgrime"
	},
/area/shuttle/escape)
"bp" = (
/turf/simulated/shuttle/plating{
	icon_state = "floorgrime"
	},
/area/shuttle/escape)
"bq" = (
/obj/machinery/door/airlock/external{
	name = "Emergency Recovery Airlock"
	},
/turf/simulated/shuttle/plating{
	icon_state = "floorgrime"
	},
/area/shuttle/escape)
"br" = (
/turf/simulated/shuttle/floor{
	icon_state = "floor4"
	},
/area/shuttle/escape)
"bs" = (
/obj/structure/chair{
	dir = 4
	},
/turf/simulated/shuttle/floor{
	icon_state = "floor4"
	},
/area/shuttle/escape)
"bt" = (
/obj/structure/chair,
/turf/simulated/shuttle/floor{
	icon_state = "floor4"
	},
/area/shuttle/escape)
"bu" = (
/obj/structure/table,
/obj/item/defibrillator,
/turf/simulated/shuttle/floor,
/area/shuttle/escape)
"bv" = (
/obj/machinery/shower,
/turf/simulated/shuttle/floor,
/area/shuttle/escape)
"bw" = (
/obj/machinery/sleeper,
/obj/machinery/light{
	icon_state = "tube1";
	dir = 4
	},
/turf/simulated/shuttle/floor,
/area/shuttle/escape)
"bx" = (
/obj/structure/rack,
/obj/item/crowbar,
/obj/item/wrench,
/obj/item/weldingtool,
/obj/item/wirecutters,
/obj/item/stack/cable_coil,
/turf/simulated/shuttle/plating{
	dir = 4;
	icon_state = "warning"
	},
/area/shuttle/escape)
"by" = (
/obj/structure/reagent_dispensers/watertank,
/turf/simulated/shuttle/plating{
	dir = 1;
	icon_state = "delivery"
	},
/area/shuttle/escape)
"bz" = (
/obj/structure/reagent_dispensers/fueltank,
/obj/machinery/light{
	dir = 1;
	on = 1
	},
/turf/simulated/shuttle/plating{
	dir = 1;
	icon_state = "delivery"
	},
/area/shuttle/escape)
"bA" = (
/turf/simulated/shuttle/plating{
	dir = 1;
	icon_state = "delivery"
	},
/area/shuttle/escape)
"bB" = (
/obj/machinery/recharge_station,
/turf/simulated/shuttle/plating{
	dir = 1;
	icon_state = "delivery"
	},
/area/shuttle/escape)
"bC" = (
/turf/simulated/shuttle/wall{
	icon_state = "swall12";
	dir = 2
	},
/area/shuttle/escape)
"bD" = (
/turf/simulated/shuttle/wall{
	icon_state = "swall11";
	dir = 2
	},
/area/shuttle/escape)
"bE" = (
/obj/structure/chair{
	dir = 8
	},
/obj/structure/reagent_dispensers/peppertank{
	pixel_x = 31
	},
/turf/simulated/shuttle/floor{
	icon_state = "floor4"
	},
/area/shuttle/escape)
"bF" = (
/obj/structure/table,
/obj/item/reagent_containers/glass/bottle/epinephrine{
	pixel_x = 6;
	pixel_y = 0
	},
/obj/item/reagent_containers/glass/bottle/charcoal{
	pixel_x = -3
	},
/obj/item/reagent_containers/glass/bottle/epinephrine{
	pixel_x = -3;
	pixel_y = 8
	},
/obj/item/reagent_containers/glass/bottle/charcoal{
	pixel_x = 6;
	pixel_y = 8
	},
/obj/item/reagent_containers/syringe/epinephrine{
	pixel_x = 3;
	pixel_y = -2
	},
/obj/item/reagent_containers/syringe/epinephrine{
	pixel_x = 4;
	pixel_y = 1
	},
/obj/item/reagent_containers/syringe/epinephrine{
	pixel_x = -2;
	pixel_y = 5
	},
/obj/item/reagent_containers/syringe/epinephrine{
	pixel_x = 2;
	pixel_y = 8
	},
/turf/simulated/shuttle/floor,
/area/shuttle/escape)
"bG" = (
/obj/machinery/sleeper,
/turf/simulated/shuttle/floor,
/area/shuttle/escape)
"bH" = (
/obj/structure/rack,
/obj/item/storage/toolbox/electrical{
	pixel_x = -3;
	pixel_y = 1
	},
/obj/item/storage/toolbox/mechanical{
	pixel_x = 0;
	pixel_y = -1
	},
/obj/item/storage/toolbox/emergency{
	pixel_x = 3;
	pixel_y = -5
	},
/turf/simulated/shuttle/plating{
	dir = 4;
	icon_state = "warning"
	},
/area/shuttle/escape)
"bI" = (
/obj/structure/chair{
	dir = 4
	},
/obj/machinery/light{
	dir = 8
	},
/turf/simulated/shuttle/plating{
	icon_state = "floorgrime"
	},
/area/shuttle/escape)
"bJ" = (
/obj/machinery/suit_storage_unit/standard_unit,
/turf/simulated/shuttle/plating{
	icon_state = "floorgrime"
	},
/area/shuttle/escape)
"bK" = (
/obj/structure/chair{
	dir = 4
	},
/obj/machinery/light{
	dir = 8
	},
/turf/simulated/shuttle/floor{
	icon_state = "floor4"
	},
/area/shuttle/escape)
"bL" = (
/obj/structure/chair{
	dir = 8
	},
/turf/simulated/shuttle/floor{
	icon_state = "floor4"
	},
/area/shuttle/escape)
"bM" = (
/obj/machinery/optable,
/obj/machinery/light{
	dir = 8
	},
/turf/simulated/shuttle/floor,
/area/shuttle/escape)
"bN" = (
/turf/simulated/shuttle/plating{
	dir = 4;
	icon_state = "warning"
	},
/area/shuttle/escape)
"bO" = (
/turf/space,
/turf/simulated/shuttle/wall{
	tag = "icon-swall_f5";
	icon_state = "swall_f5";
	dir = 2
	},
/turf/simulated/shuttle/wall{
	tag = "icon-diagonalWall3";
	icon_state = "diagonalWall3";
	dir = 2
	},
/area/shuttle/escape)
"bP" = (
/obj/structure/reagent_dispensers/watertank,
/turf/simulated/shuttle/plating{
	icon_state = "floorgrime"
	},
/area/shuttle/escape)
"bQ" = (
/obj/structure/table,
/obj/item/folder/red{
	pixel_x = 3
	},
/obj/item/folder/white{
	pixel_x = -4;
	pixel_y = 2
	},
/obj/item/book/manual/security_space_law{
	pixel_x = -4;
	pixel_y = 4
	},
/obj/item/radio/intercom{
	broadcasting = 0;
	listening = 1;
	name = "Station Intercom (General)";
	pixel_y = -28
	},
/turf/simulated/shuttle/floor4,
/area/shuttle/escape)
"bR" = (
/obj/structure/table,
/obj/machinery/recharger{
	active_power_usage = 0;
	idle_power_usage = 0;
	use_power = 0
	},
/turf/simulated/shuttle/floor{
	icon_state = "floor4"
	},
/area/shuttle/escape)
"bS" = (
/obj/structure/table,
/obj/item/restraints/handcuffs,
/turf/simulated/shuttle/floor{
	icon_state = "floor4"
	},
/area/shuttle/escape)
"bT" = (
/obj/structure/table,
/obj/item/storage/box/handcuffs,
/turf/simulated/shuttle/floor{
	icon_state = "floor4"
	},
/area/shuttle/escape)
"bU" = (
/obj/structure/table,
/obj/item/scalpel{
	pixel_y = 12
	},
/obj/item/circular_saw,
/obj/item/retractor{
	pixel_x = 4
	},
/obj/item/hemostat{
	pixel_x = -4
	},
/obj/item/clothing/gloves/color/latex,
/obj/item/clothing/mask/surgical,
/obj/item/radio/intercom{
	dir = 4;
	name = "Station Intercom (General)";
	pixel_x = 0;
	pixel_y = -27
	},
/turf/simulated/shuttle/floor,
/area/shuttle/escape)
"bV" = (
/obj/structure/sink,
/turf/simulated/shuttle/floor,
/area/shuttle/escape)
"bW" = (
/obj/structure/table,
/obj/item/storage/firstaid/fire,
/obj/item/storage/firstaid/regular{
	pixel_x = 2;
	pixel_y = 3
	},
/turf/simulated/shuttle/floor,
/area/shuttle/escape)
"bX" = (
/obj/structure/table,
/obj/item/storage/firstaid/toxin,
/obj/item/storage/firstaid/o2{
	pixel_x = 3;
	pixel_y = 3
	},
/turf/simulated/shuttle/floor,
/area/shuttle/escape)
"bY" = (
/obj/structure/sign/redcross,
/turf/simulated/shuttle/wall{
	dir = 8;
	icon_state = "swall2";
	tag = "icon-swall2"
	},
/area/shuttle/escape)
"bZ" = (
/obj/structure/rack{
	dir = 1
	},
/obj/item/tank/oxygen,
/obj/item/clothing/suit/fire/firefighter,
/obj/item/clothing/mask/gas,
/obj/item/clothing/head/hardhat/red,
/turf/simulated/shuttle/plating{
	dir = 4;
	icon_state = "warning"
	},
/area/shuttle/escape)
"ca" = (
/obj/structure/extinguisher_cabinet{
	pixel_x = 0;
	pixel_y = -30
	},
/obj/machinery/space_heater,
/turf/simulated/shuttle/plating{
	icon_state = "bot"
	},
/area/shuttle/escape)
"cb" = (
/obj/structure/closet/crate{
	name = "emergency supplies crate"
	},
/obj/item/storage/toolbox/emergency,
/obj/item/storage/toolbox/emergency,
/obj/item/flashlight/flare{
	pixel_x = 3;
	pixel_y = 3
	},
/obj/item/flashlight/flare{
	pixel_x = -6;
	pixel_y = -2
	},
/obj/item/crowbar,
/obj/item/wrench,
/obj/item/radio,
/turf/simulated/shuttle/plating{
	icon_state = "bot"
	},
/area/shuttle/escape)
"cc" = (
/obj/structure/closet/crate/medical{
	name = "medical crate"
	},
/obj/item/storage/firstaid/regular,
/obj/item/storage/firstaid/o2{
	pixel_x = 3;
	pixel_y = 3
	},
/obj/item/storage/firstaid/toxin{
	pixel_x = -4;
	pixel_y = 3
	},
/obj/item/healthanalyzer{
	pixel_x = 3;
	pixel_y = 3
	},
/obj/item/lazarus_injector,
/mob/living/simple_animal/bot/medbot{
	name = "\improper emergency medibot";
	pixel_x = -3;
	pixel_y = 2
	},
/turf/simulated/shuttle/plating{
	icon_state = "bot"
	},
/area/shuttle/escape)
"cd" = (
/obj/item/radio/intercom{
	broadcasting = 0;
	listening = 1;
	name = "Station Intercom (General)";
	pixel_y = -28
	},
/obj/machinery/portable_atmospherics/canister/oxygen,
/obj/machinery/light,
/turf/simulated/shuttle/plating{
	icon_state = "bot"
	},
/area/shuttle/escape)
"ce" = (
/obj/structure/table,
/obj/item/clipboard,
/obj/item/folder/yellow,
/obj/item/pen,
/turf/simulated/shuttle/plating{
	icon_state = "bot"
	},
/area/shuttle/escape)
"cf" = (
/turf/space,
/turf/simulated/shuttle/wall{
	tag = "icon-swall_f5";
	icon_state = "swall_f5";
	dir = 2
	},
/area/shuttle/escape)
"cg" = (
/turf/simulated/shuttle/wall{
	tag = "icon-swall13";
	icon_state = "swall13";
	dir = 2
	},
/area/shuttle/escape)
"ch" = (
/turf/space,
/turf/simulated/shuttle/wall{
	tag = "icon-swall_f9";
	icon_state = "swall_f9";
	dir = 2
	},
/area/shuttle/escape)
"ci" = (
/obj/docking_port/mobile/emergency{
	dir = 2;
	dwidth = 5;
	height = 14;
	name = "Meta emergency shuttle";
	timid = 1;
	width = 25
	},
/obj/machinery/door/airlock/shuttle{
	id_tag = "s_docking_airlock";
	name = "Emergency Shuttle Airlock";
	req_access_txt = "0"
	},
/turf/simulated/shuttle/floor,
/area/shuttle/escape)

(1,1,1) = {"
aa
aa
aO
aA
aH
aj
aO
aH
aj
aO
aA
aH
aa
aa
"}
(2,1,1) = {"
aa
am
aB
aI
aB
ak
aB
aI
ak
aB
aI
aB
bO
aa
"}
(3,1,1) = {"
ab
an
as
as
as
an
as
as
bf
as
as
as
an
cf
"}
(4,1,1) = {"
ac
ao
aC
aJ
aP
aU
aY
ba
bg
bo
bo
bI
bP
ac
"}
(5,1,1) = {"
ac
ap
au
aK
aQ
aD
au
bb
ak
bp
bp
bp
bp
bq
"}
(6,1,1) = {"
ac
aq
aD
au
au
au
aK
bc
ae
bq
aj
bp
bp
bq
"}
(7,1,1) = {"
ac
ar
aE
au
au
au
au
au
bh
br
bC
bJ
bJ
ac
"}
(8,1,1) = {"
ad
as
aF
az
aR
aV
as
as
bi
as
bD
aF
as
cg
"}
(9,1,1) = {"
ae
at
au
au
au
au
aZ
at
ak
bs
bs
bK
bQ
ak
"}
(10,1,1) = {"
ac
au
au
au
au
au
au
au
bj
br
br
br
bR
ac
"}
(11,1,1) = {"
af
av
au
aL
ac
av
au
aL
ac
bt
br
br
bS
ac
"}
(12,1,1) = {"
ai
au
au
aM
aS
aW
au
aL
aj
bt
bE
bL
bT
aj
"}
(13,1,1) = {"
ac
aw
au
aL
ac
av
au
bd
bk
as
as
as
as
cg
"}
(14,1,1) = {"
ai
au
au
aL
aT
av
au
aL
ae
bu
bF
bM
bU
ae
"}
(15,1,1) = {"
ah
av
au
aL
ac
av
au
aL
ac
bv
au
au
bV
ac
"}
(16,1,1) = {"
ac
av
au
au
au
au
au
au
bl
au
au
au
bW
ac
"}
(17,1,1) = {"
ac
aw
au
aL
ac
av
au
aL
ac
bw
bG
au
bX
aj
"}
(18,1,1) = {"
ac
av
au
aL
aT
av
au
aL
bm
az
ac
bl
bY
cg
"}
(19,1,1) = {"
af
ax
au
aL
ac
av
au
aM
ae
bx
bH
bN
bZ
ak
"}
(20,1,1) = {"
ci
au
au
aM
aS
aW
au
aL
ac
by
bp
bp
ca
ae
"}
(21,1,1) = {"
ac
av
au
aL
ac
av
au
aL
aT
bz
bp
bp
cb
ac
"}
(22,1,1) = {"
ag
au
au
au
au
au
au
au
bn
bA
bp
bp
cc
ac
"}
(23,1,1) = {"
aj
au
au
au
au
au
au
au
bn
bA
bp
bp
cd
aj
"}
(24,1,1) = {"
ak
ay
aG
aN
au
aX
au
be
aj
bB
bA
bA
ce
ak
"}
(25,1,1) = {"
al
az
ac
af
ac
af
ac
aV
an
az
ac
ac
aV
ch
"}
