"aa" = (/turf/space,/turf/simulated/shuttle/wall{tag = "icon-swall_f6"; icon_state = "swall_f6"; dir = 2},/area/shuttle/escape)
"ab" = (/turf/simulated/shuttle/wall{tag = "icon-swall12"; icon_state = "swall12"; dir = 2},/area/shuttle/escape)
"ac" = (/obj/structure/grille,/obj/structure/shuttle/window,/turf/simulated/shuttle/plating,/area/shuttle/escape)
"ad" = (/obj/machinery/door/airlock/shuttle{id_tag = "s_docking_airlock"; name = "Emergency Shuttle Airlock"},/turf/simulated/shuttle/floor,/area/shuttle/escape)
"ae" = (/turf/simulated/shuttle/wall{tag = "icon-swall14"; icon_state = "swall14"; dir = 2},/area/shuttle/escape)
"af" = (/obj/machinery/door/airlock/shuttle{id_tag = "s_docking_airlock"; name = "Emergency Shuttle Cargo Bay Airlock"},/turf/simulated/shuttle/plating{dir = 1; icon_state = "delivery"},/area/shuttle/escape)
"ag" = (/turf/space,/turf/simulated/shuttle/wall{tag = "icon-swall_f10"; icon_state = "swall_f10"; dir = 2},/area/shuttle/escape)
"ah" = (/turf/simulated/shuttle/wall{tag = "icon-swall3"; icon_state = "swall3"; dir = 2},/area/shuttle/escape)
"ai" = (/obj/structure/table,/obj/item/clothing/mask/breath{pixel_x = 5; pixel_y = -2},/obj/item/clothing/mask/breath{pixel_x = -5; pixel_y = -2},/obj/item/clothing/mask/breath{pixel_x = -5; pixel_y = 6},/obj/item/clothing/mask/breath{pixel_x = 5; pixel_y = 6},/obj/item/clothing/mask/breath,/obj/machinery/light/spot{tag = "icon-tube1 (WEST)"; icon_state = "tube1"; dir = 8},/turf/simulated/shuttle/floor{icon_state = "floor3"},/area/shuttle/escape)
"aj" = (/obj/structure/dispenser/oxygen{layer = 2.7; pixel_x = -1; pixel_y = 2},/turf/simulated/shuttle/floor{icon_state = "floor3"},/area/shuttle/escape)
"ak" = (/obj/structure/table,/obj/item/device/healthanalyzer,/obj/item/device/healthanalyzer{pixel_x = 3; pixel_y = 3},/obj/item/stack/medical/ointment,/obj/item/stack/medical/bruise_pack,/turf/simulated/shuttle/floor{icon_state = "floor3"},/area/shuttle/escape)
"al" = (/obj/machinery/shower{dir = 4; icon_state = "shower"; name = "emergency shower"; tag = "icon-shower (EAST)"},/turf/simulated/shuttle/floor,/area/shuttle/escape)
"am" = (/obj/machinery/status_display{pixel_y = 32},/obj/machinery/hologram/holopad,/turf/simulated/shuttle/floor,/area/shuttle/escape)
"an" = (/obj/machinery/shower{dir = 8; icon_state = "shower"; name = "emergency shower"; tag = "icon-shower (WEST)"},/turf/simulated/shuttle/floor,/area/shuttle/escape)
"ao" = (/obj/structure/table,/obj/item/weapon/storage/firstaid/toxin,/obj/item/weapon/storage/firstaid/o2{pixel_x = 3; pixel_y = 3},/turf/simulated/shuttle/floor{icon_state = "floor3"},/area/shuttle/escape)
"ap" = (/obj/structure/sign/nosmoking_2,/turf/simulated/shuttle/wall{tag = "icon-swall3"; icon_state = "swall3"; dir = 2},/area/shuttle/escape)
"aq" = (/obj/machinery/recharge_station,/turf/simulated/shuttle/plating{icon_state = "bot"},/area/shuttle/escape)
"ar" = (/obj/machinery/shower{dir = 4; icon_state = "shower"; name = "emergency shower"; tag = "icon-shower (EAST)"},/turf/simulated/shuttle/plating{dir = 1; icon_state = "delivery"},/area/shuttle/escape)
"as" = (/obj/machinery/shower{dir = 8; icon_state = "shower"; name = "emergency shower"; tag = "icon-shower (EAST)"},/turf/simulated/shuttle/plating{dir = 1; icon_state = "delivery"},/area/shuttle/escape)
"at" = (/obj/structure/table,/obj/item/weapon/clipboard,/obj/item/weapon/folder/yellow,/obj/item/weapon/pen,/turf/simulated/shuttle/plating{icon_state = "bot"},/area/shuttle/escape)
"au" = (/turf/simulated/shuttle/floor,/area/shuttle/escape)
"av" = (/obj/machinery/door/airlock/shuttle{name = "Emergency Shuttle Cargo Bay Airlock"},/turf/simulated/shuttle/plating{dir = 1; icon_state = "delivery"},/area/shuttle/escape)
"aw" = (/turf/simulated/shuttle/plating{dir = 1; icon_state = "delivery"},/area/shuttle/escape)
"ax" = (/turf/simulated/shuttle/plating{icon_state = "floorgrime"},/area/shuttle/escape)
"ay" = (/obj/item/device/radio/intercom{dir = 4; name = "Station Intercom (General)"; pixel_x = 31},/obj/machinery/portable_atmospherics/canister/oxygen,/turf/simulated/shuttle/plating{icon_state = "bot"},/area/shuttle/escape)
"az" = (/obj/structure/stool/bed/chair{dir = 4},/obj/item/device/radio/intercom{dir = 8; name = "Station Intercom (General)"; pixel_x = -28},/turf/simulated/shuttle/floor{icon_state = "floor3"},/area/shuttle/escape)
"aA" = (/obj/structure/stool/bed/chair{dir = 8},/turf/simulated/shuttle/floor{icon_state = "floor3"},/area/shuttle/escape)
"aB" = (/obj/structure/stool/bed/chair{dir = 4},/turf/simulated/shuttle/floor{icon_state = "floor3"},/area/shuttle/escape)
"aC" = (/obj/item/weapon/cigbutt,/turf/simulated/shuttle/plating{icon_state = "floorgrime"},/area/shuttle/escape)
"aD" = (/obj/structure/closet/crate/medical{name = "medical crate"},/obj/item/weapon/storage/firstaid/regular,/obj/item/weapon/storage/firstaid/o2{pixel_x = 3; pixel_y = 3},/obj/item/weapon/storage/firstaid/toxin{pixel_x = -4; pixel_y = 3},/obj/item/device/healthanalyzer{pixel_x = 3; pixel_y = 3},/obj/item/weapon/lazarus_injector,/mob/living/simple_animal/bot/medbot{name = "\improper emergency medibot"; pixel_x = -3; pixel_y = 2},/turf/simulated/shuttle/plating{icon_state = "bot"},/area/shuttle/escape)
"aE" = (/obj/structure/reagent_dispensers/fueltank,/obj/structure/extinguisher_cabinet{pixel_x = -27; pixel_y = 0},/obj/machinery/light/spot{tag = "icon-tube1 (WEST)"; icon_state = "tube1"; dir = 8},/turf/simulated/shuttle/plating{icon_state = "bot"},/area/shuttle/escape)
"aF" = (/obj/structure/closet/crate{name = "emergency supplies crate"},/obj/item/weapon/storage/toolbox/emergency,/obj/item/weapon/storage/toolbox/emergency,/obj/item/device/flashlight/flare{pixel_x = 3; pixel_y = 3},/obj/item/device/flashlight/flare{pixel_x = -6; pixel_y = -2},/obj/item/weapon/crowbar,/obj/item/weapon/wrench,/obj/item/device/radio,/turf/simulated/shuttle/plating{icon_state = "bot"},/area/shuttle/escape)
"aG" = (/obj/machinery/door/airlock/shuttle{id_tag = "s_docking_airlock"; name = "Emergency Shuttle Airlock"},/obj/docking_port/mobile/emergency{dir = 4; dwidth = 5; height = 14; timid = 1; width = 22},/turf/simulated/shuttle/floor,/area/shuttle/escape)
"aH" = (/obj/structure/stool/bed/chair{dir = 8},/obj/machinery/light/spot{tag = "icon-tube1 (EAST)"; icon_state = "tube1"; dir = 4},/turf/simulated/shuttle/floor{icon_state = "floor3"},/area/shuttle/escape)
"aI" = (/obj/machinery/vending/wallmed1{name = "Emergency NanoMed"; pixel_x = 0; pixel_y = 0; req_access_txt = "0"; use_power = 0},/turf/simulated/shuttle/wall{tag = "icon-swall3"; icon_state = "swall3"; dir = 2},/area/shuttle/escape)
"aJ" = (/obj/structure/stool/bed/chair{dir = 4},/obj/machinery/light/spot{tag = "icon-tube1 (WEST)"; icon_state = "tube1"; dir = 8},/turf/simulated/shuttle/floor{icon_state = "floor3"},/area/shuttle/escape)
"aK" = (/obj/structure/reagent_dispensers/watertank,/turf/simulated/shuttle/plating{icon_state = "bot"},/area/shuttle/escape)
"aL" = (/obj/machinery/space_heater,/obj/structure/extinguisher_cabinet{pixel_x = 27; pixel_y = 0},/turf/simulated/shuttle/plating{icon_state = "bot"},/area/shuttle/escape)
"aM" = (/obj/structure/stool/bed/chair{dir = 4},/obj/structure/extinguisher_cabinet{pixel_x = -27; pixel_y = 0},/obj/machinery/light/spot{tag = "icon-tube1 (WEST)"; icon_state = "tube1"; dir = 8},/turf/simulated/shuttle/floor{icon_state = "floor3"},/area/shuttle/escape)
"aN" = (/obj/structure/stool/bed/chair{dir = 8},/obj/structure/extinguisher_cabinet{pixel_x = 27; pixel_y = 0},/turf/simulated/shuttle/floor{icon_state = "floor3"},/area/shuttle/escape)
"aO" = (/obj/structure/rack,/obj/item/weapon/crowbar,/obj/item/weapon/wrench,/obj/item/weapon/weldingtool,/obj/item/weapon/wirecutters,/obj/item/stack/cable_coil,/turf/simulated/shuttle/plating{dir = 1; icon_state = "warning"},/area/shuttle/escape)
"aP" = (/obj/structure/rack,/obj/item/weapon/storage/toolbox/electrical{pixel_x = -3; pixel_y = 1},/obj/item/weapon/storage/toolbox/mechanical{pixel_x = 0; pixel_y = -1},/obj/item/weapon/storage/toolbox/emergency{pixel_x = 3; pixel_y = -5},/turf/simulated/shuttle/plating{dir = 1; icon_state = "warning"},/area/shuttle/escape)
"aQ" = (/turf/simulated/shuttle/plating{dir = 1; icon_state = "warning"},/area/shuttle/escape)
"aR" = (/obj/structure/rack{dir = 1},/obj/item/weapon/tank/oxygen,/obj/item/clothing/suit/fire/firefighter,/obj/item/clothing/mask/gas,/obj/item/clothing/head/hardhat/red,/turf/simulated/shuttle/plating{dir = 1; icon_state = "warning"},/area/shuttle/escape)
"aS" = (/obj/structure/stool/bed/chair{dir = 8},/obj/structure/sign/redcross{pixel_x = 32},/obj/machinery/light/spot{tag = "icon-tube1 (EAST)"; icon_state = "tube1"; dir = 4},/turf/simulated/shuttle/floor{icon_state = "floor3"},/area/shuttle/escape)
"aT" = (/turf/simulated/shuttle/wall{tag = "icon-swall7"; icon_state = "swall7"; dir = 2},/area/shuttle/escape)
"aU" = (/turf/simulated/shuttle/wall{icon_state = "swall8"; dir = 2},/area/shuttle/escape)
"aV" = (/obj/machinery/door/airlock/glass_medical{id_tag = null; name = "Escape Shuttle Infirmary"; req_access_txt = "0"},/turf/simulated/shuttle/floor,/area/shuttle/escape)
"aW" = (/obj/structure/sign/redcross,/turf/simulated/shuttle/wall{icon_state = "swall4"; dir = 2},/area/shuttle/escape)
"aX" = (/turf/simulated/shuttle/wall{tag = "icon-swall11"; icon_state = "swall11"; dir = 2},/area/shuttle/escape)
"aY" = (/obj/machinery/status_display,/turf/simulated/shuttle/wall{tag = "icon-swall3"; icon_state = "swall3"; dir = 2},/area/shuttle/escape)
"aZ" = (/obj/machinery/sleeper,/turf/simulated/shuttle/floor,/area/shuttle/escape)
"ba" = (/obj/machinery/optable,/turf/simulated/shuttle/floor,/area/shuttle/escape)
"bb" = (/obj/structure/sink{dir = 4; icon_state = "sink"; pixel_x = 11; pixel_y = 0},/turf/simulated/shuttle/floor,/area/shuttle/escape)
"bc" = (/obj/structure/table,/obj/item/weapon/storage/firstaid/fire,/obj/item/weapon/storage/firstaid/regular{pixel_x = 2; pixel_y = 3},/obj/machinery/vending/wallmed1{name = "Emergency NanoMed"; pixel_x = 0; pixel_y = -28; req_access_txt = "0"; use_power = 0},/turf/simulated/shuttle/floor,/area/shuttle/escape)
"bd" = (/obj/structure/table,/obj/item/weapon/storage/firstaid/toxin,/obj/item/weapon/storage/firstaid/o2{pixel_x = 3; pixel_y = 3},/obj/machinery/vending/wallmed1{name = "Emergency NanoMed"; pixel_x = 0; pixel_y = -28; req_access_txt = "0"; use_power = 0},/obj/machinery/light/spot,/turf/simulated/shuttle/floor,/area/shuttle/escape)
"be" = (/obj/structure/table,/obj/item/weapon/reagent_containers/glass/bottle/epinephrine{pixel_x = 6; pixel_y = 0},/obj/item/weapon/reagent_containers/glass/bottle/charcoal{pixel_x = -3},/obj/item/weapon/reagent_containers/glass/bottle/epinephrine{pixel_x = -3; pixel_y = 8},/obj/item/weapon/reagent_containers/glass/bottle/charcoal{pixel_x = 6; pixel_y = 8},/obj/item/weapon/reagent_containers/syringe/epinephrine{pixel_x = 3; pixel_y = -2},/obj/item/weapon/reagent_containers/syringe/epinephrine{pixel_x = 4; pixel_y = 1},/obj/item/weapon/reagent_containers/syringe/epinephrine{pixel_x = -2; pixel_y = 5},/obj/item/weapon/reagent_containers/syringe/epinephrine{pixel_x = 2; pixel_y = 8},/turf/simulated/shuttle/floor,/area/shuttle/escape)
"bf" = (/obj/structure/table,/obj/item/weapon/scalpel{pixel_y = 12},/obj/item/weapon/circular_saw,/obj/item/weapon/retractor{pixel_x = 4},/obj/item/weapon/hemostat{pixel_x = -4},/obj/item/clothing/gloves/color/latex,/obj/item/clothing/mask/surgical,/obj/item/device/radio/intercom{dir = 4; name = "Station Intercom (General)"; pixel_x = 0; pixel_y = -27},/turf/simulated/shuttle/floor,/area/shuttle/escape)
"bg" = (/obj/structure/stool/bed/chair{dir = 8},/obj/item/device/radio/intercom{dir = 4; name = "Station Intercom (General)"; pixel_x = 31},/obj/machinery/light/spot{tag = "icon-tube1 (EAST)"; icon_state = "tube1"; dir = 4},/turf/simulated/shuttle/floor{icon_state = "floor3"},/area/shuttle/escape)
"bh" = (/obj/machinery/status_display,/turf/simulated/shuttle/wall{tag = "icon-swall12"; icon_state = "swall12"; dir = 2},/area/shuttle/escape)
"bi" = (/obj/structure/stool/bed/chair,/turf/simulated/shuttle/floor4,/area/shuttle/escape)
"bj" = (/obj/structure/stool/bed/chair,/obj/machinery/light/spot{tag = "icon-tube1 (NORTH)"; icon_state = "tube1"; dir = 1},/turf/simulated/shuttle/floor4,/area/shuttle/escape)
"bk" = (/obj/structure/table,/obj/structure/reagent_dispensers/peppertank{pixel_x = 31},/obj/item/weapon/storage/box/handcuffs{pixel_x = 2; pixel_y = 2},/turf/simulated/shuttle/floor4,/area/shuttle/escape)
"bl" = (/obj/machinery/door/airlock/shuttle{id_tag = "s_docking_airlock"; name = "Emergency Shuttle Airlock"; req_access_txt = "2"},/turf/simulated/shuttle/floor,/area/shuttle/escape)
"bm" = (/obj/machinery/door/airlock/glass_security{name = "Brig"; req_access_txt = "2"},/turf/simulated/shuttle/floor4,/area/shuttle/escape)
"bn" = (/turf/simulated/shuttle/floor4,/area/shuttle/escape)
"bo" = (/obj/structure/table,/obj/machinery/recharger{active_power_usage = 0; idle_power_usage = 0; use_power = 0},/turf/simulated/shuttle/floor4,/area/shuttle/escape)
"bp" = (/obj/structure/closet/emcloset,/obj/structure/extinguisher_cabinet{pixel_x = -27; pixel_y = 0},/obj/machinery/light/spot{tag = "icon-tube1 (WEST)"; icon_state = "tube1"; dir = 8},/turf/simulated/shuttle/floor{icon_state = "floor3"},/area/shuttle/escape)
"bq" = (/obj/machinery/flasher{id = "emshuttlebridgeflash"; pixel_y = -24},/turf/simulated/shuttle/floor,/area/shuttle/escape)
"br" = (/obj/structure/closet/emcloset,/turf/simulated/shuttle/floor{icon_state = "floor3"},/area/shuttle/escape)
"bs" = (/obj/structure/stool/bed/chair{dir = 1},/obj/machinery/flasher_button{id = "emshuttleflash"; name = "brig flasher button"; pixel_y = -23; req_access_txt = "0"; req_one_access_txt = "1;63;19"},/turf/simulated/shuttle/floor4,/area/shuttle/escape)
"bt" = (/obj/structure/stool/bed/chair{dir = 1},/obj/machinery/flasher{id = "emshuttleflash"; pixel_y = -24},/obj/machinery/light/spot,/turf/simulated/shuttle/floor4,/area/shuttle/escape)
"bu" = (/obj/structure/stool/bed/chair{dir = 1},/turf/simulated/shuttle/floor4,/area/shuttle/escape)
"bv" = (/obj/structure/table,/obj/item/weapon/folder/red{pixel_x = 3},/obj/item/weapon/folder/white{pixel_x = -4; pixel_y = 2},/obj/item/device/radio/intercom{dir = 4; name = "Station Intercom (General)"; pixel_x = 31},/obj/item/weapon/book/manual/security_space_law{pixel_x = -4; pixel_y = 4},/turf/simulated/shuttle/floor4,/area/shuttle/escape)
"bw" = (/obj/machinery/door/airlock/glass_command{name = "Cockpit"; req_access_txt = "19"},/turf/simulated/shuttle/floor,/area/shuttle/escape)
"bx" = (/turf/simulated/shuttle/wall{tag = "icon-swall15"; icon_state = "swall15"; dir = 2},/area/shuttle/escape)
"by" = (/obj/machinery/computer/security,/turf/simulated/shuttle/floor,/area/shuttle/escape)
"bz" = (/obj/machinery/light/spot{tag = "icon-tube1 (NORTH)"; icon_state = "tube1"; dir = 1},/turf/simulated/shuttle/floor,/area/shuttle/escape)
"bA" = (/obj/machinery/flasher_button{id = "emshuttlebridgeflash"; name = "cockpit flasher button"; pixel_y = 24; req_access_txt = "0"; req_one_access_txt = "1;63;19"},/obj/machinery/light/spot{tag = "icon-tube1 (NORTH)"; icon_state = "tube1"; dir = 1},/turf/simulated/shuttle/floor,/area/shuttle/escape)
"bB" = (/obj/machinery/computer/crew,/turf/simulated/shuttle/floor,/area/shuttle/escape)
"bC" = (/obj/machinery/space_heater,/obj/item/device/radio/intercom{dir = 4; name = "Station Intercom (General)"; pixel_x = 0; pixel_y = 27},/obj/structure/extinguisher_cabinet{pixel_x = -27; pixel_y = 0},/obj/machinery/light/spot{tag = "icon-tube1 (EAST)"; icon_state = "tube1"; dir = 4},/turf/simulated/shuttle/floor{icon_state = "floor4"},/area/shuttle/escape)
"bD" = (/obj/structure/stool/bed/chair{dir = 4},/obj/machinery/status_display{pixel_y = 31},/obj/machinery/light/spot{tag = "icon-tube1 (WEST)"; icon_state = "tube1"; dir = 8},/turf/simulated/shuttle/plating{icon_state = "floorgrime"},/area/shuttle/escape)
"bE" = (/obj/item/device/radio/intercom{dir = 4; name = "Station Intercom (General)"; pixel_x = 0; pixel_y = 27},/turf/simulated/shuttle/plating{icon_state = "floorgrime"},/area/shuttle/escape)
"bF" = (/obj/structure/stool/bed/chair/office/dark{dir = 1},/turf/simulated/shuttle/floor,/area/shuttle/escape)
"bG" = (/obj/structure/stool/bed/chair/office/dark{dir = 4},/turf/simulated/shuttle/floor,/area/shuttle/escape)
"bH" = (/obj/structure/stool/bed/chair/office/dark,/turf/simulated/shuttle/floor,/area/shuttle/escape)
"bI" = (/obj/structure/stool/bed/chair/office/dark{dir = 8},/turf/simulated/shuttle/floor,/area/shuttle/escape)
"bJ" = (/obj/machinery/door/airlock/command{name = "Emergency Recovery Airlock"; req_access = null; req_access_txt = "19"},/turf/simulated/shuttle/floor,/area/shuttle/escape)
"bK" = (/turf/simulated/shuttle/floor{icon_state = "floor4"},/area/shuttle/escape)
"bL" = (/obj/machinery/door/airlock/external{name = "Emergency Recovery Airlock"},/turf/simulated/shuttle/plating{icon_state = "floorgrime"},/area/shuttle/escape)
"bM" = (/obj/structure/table,/obj/item/weapon/storage/fancy/donut_box,/turf/simulated/shuttle/floor,/area/shuttle/escape)
"bN" = (/obj/structure/table,/obj/item/weapon/cigbutt/cigarbutt,/turf/simulated/shuttle/floor,/area/shuttle/escape)
"bO" = (/obj/machinery/computer/emergency_shuttle,/turf/simulated/shuttle/floor,/area/shuttle/escape)
"bP" = (/obj/machinery/computer/communications,/obj/machinery/status_display{pixel_y = -32},/turf/simulated/shuttle/floor,/area/shuttle/escape)
"bQ" = (/obj/machinery/computer/atmos_alert,/turf/simulated/shuttle/floor,/area/shuttle/escape)
"bR" = (/obj/structure/table,/obj/item/weapon/folder/blue,/obj/item/weapon/folder/blue,/turf/simulated/shuttle/floor,/area/shuttle/escape)
"bS" = (/obj/structure/extinguisher_cabinet{pixel_x = 27; pixel_y = 0},/obj/structure/table,/obj/item/weapon/paper_bin{pixel_x = -2; pixel_y = 5},/turf/simulated/shuttle/floor,/area/shuttle/escape)
"bT" = (/obj/machinery/suit_storage_unit/standard_unit,/turf/simulated/shuttle/floor{icon_state = "floor4"},/area/shuttle/escape)
"bU" = (/obj/structure/extinguisher_cabinet{pixel_x = -27; pixel_y = 0},/obj/structure/stool/bed/chair{dir = 4},/turf/simulated/shuttle/plating{icon_state = "floorgrime"},/area/shuttle/escape)
"bV" = (/turf/space,/turf/simulated/shuttle/wall{icon_state = "diagonalWall3"},/turf/simulated/shuttle/wall{tag = "icon-swall_f5"; icon_state = "swall_f5"; dir = 2},/area/shuttle/escape)
"bW" = (/turf/simulated/shuttle/wall{tag = "icon-swall13"; icon_state = "swall13"; dir = 2},/area/shuttle/escape)
"bX" = (/turf/space,/turf/simulated/shuttle/wall{tag = "icon-swall_f9"; icon_state = "swall_f9"; dir = 2},/area/shuttle/escape)
"bY" = (/turf/space,/area/shuttle/escape)
"bZ" = (/turf/space,/turf/simulated/shuttle/wall{icon_state = "diagonalWall3"},/area/shuttle/escape)
"ca" = (/obj/structure/window/reinforced{dir = 1},/obj/structure/shuttle/engine/heater,/turf/simulated/shuttle/plating,/area/shuttle/escape)
"cb" = (/turf/simulated/shuttle/wall{icon_state = "wall3"},/area/shuttle/escape)
"cc" = (/turf/space,/turf/simulated/shuttle/wall{dir = 4; icon_state = "diagonalWall3"},/area/shuttle/escape)
"cd" = (/turf/space,/area/space)
"ce" = (/obj/structure/shuttle/engine/propulsion,/turf/simulated/shuttle/plating,/area/shuttle/escape)

(1,1,1) = {"
aaabacabadabadabaeabafafabag
ahaiajakalamanaoapaqarasatah
acauauauauauauauavawaxaxayah
ahazauaAacaBauauavawaxaCaDac
acaBauaAacaBauaAahaEaxaxaFac
aGauauaHaIaJauaAacaKaCaxaLah
ahaMauaAacaBauaNahaOaPaQaRah
acaBauaAacaBauaSaTaUacaVaWaX
aYaBauauauauauaAacaZaZaubaah
acaBauaAacaBauauaVauauaubbac
apaJauaAacaBauaAacbcbdbebfah
adauauaHaIaJaubgaTababbhabaX
acaBauaAacaBauaAacbibjbibkah
blauauaAacaBauaubmbnbnbnboac
ahbpauauaubqaubracbsbtbubvah
aTabbhabbwabbhabbxabaeababaX
acbyaubzaubAaubBahbCahbDbEac
acbFaubGbHbIauaubJbKbLaxaxbL
acbMbNbObPbQbRbSahbTahbUaxac
bVabababababababbWabbWababbX
bYbZcacacacbcacacbcacacaccbY
cdbYcecececbcececbcececebYcd
"}
