//MAP CONVERTED BY dmm2tgm.py THIS HEADER COMMENT PREVENTS RECONVERSION, DO NOT REMOVE
"aa" = (
/obj/effect/turf_decal/delivery/hollow,
/obj/item/storage/firstaid/o2{
	pixel_y = 3
	},
/obj/structure/table/reinforced,
/turf/simulated/floor/plasteel,
/area/shuttle/escape)
"ab" = (
/turf/simulated/wall/mineral/titanium,
/area/shuttle/escape)
"ac" = (
/obj/effect/spawner/window/shuttle,
/turf/simulated/floor/plating,
/area/shuttle/escape)
"af" = (
/obj/item/radio/intercom{
	dir = 4;
	pixel_x = 28
	},
/turf/simulated/floor/mineral/titanium/blue,
/area/shuttle/escape)
"ah" = (
/turf/space,
/area/space)
"ai" = (
/obj/machinery/light/spot{
	dir = 4
	},
/obj/structure/chair/comfy/shuttle{
	dir = 8
	},
/turf/simulated/floor/mineral/plastitanium/red/brig,
/area/shuttle/escape)
"aj" = (
/obj/effect/turf_decal/woodsiding,
/turf/simulated/floor/carpet/royalblue,
/area/shuttle/escape)
"ak" = (
/obj/machinery/light/spot,
/turf/simulated/floor/wood,
/area/shuttle/escape)
"al" = (
/obj/machinery/door/airlock/command/glass{
	name = "Escape Shuttle Cockpit"
	},
/obj/effect/mapping_helpers/airlock/access/all/security/doors,
/turf/simulated/floor/mineral/titanium,
/area/shuttle/escape)
"am" = (
/obj/item/kirbyplants/large,
/turf/simulated/floor/mineral/titanium,
/area/shuttle/escape)
"an" = (
/turf/simulated/floor/wood,
/area/shuttle/escape)
"ao" = (
/obj/structure/toilet{
	dir = 4
	},
/obj/machinery/light/spot{
	dir = 8
	},
/turf/simulated/floor/plasteel{
	icon_state = "freezerfloor"
	},
/area/shuttle/escape)
"aq" = (
/obj/structure/closet/walllocker/emerglocker{
	pixel_y = 28
	},
/obj/effect/turf_decal/woodsiding,
/turf/simulated/floor/carpet/royalblue,
/area/shuttle/escape)
"ar" = (
/obj/structure/chair/comfy/shuttle{
	dir = 8
	},
/turf/simulated/floor/mineral/plastitanium/red/brig,
/area/shuttle/escape)
"as" = (
/obj/effect/turf_decal/woodsiding{
	dir = 5
	},
/turf/simulated/floor/carpet/royalblack,
/area/shuttle/escape)
"av" = (
/obj/structure/chair/comfy/shuttle{
	dir = 4
	},
/turf/simulated/floor/plasteel{
	icon_state = "cafeteria"
	},
/area/shuttle/escape)
"aw" = (
/obj/machinery/computer/aifixer{
	dir = 8
	},
/obj/effect/turf_decal/woodsiding{
	dir = 1
	},
/turf/simulated/floor/carpet/purple,
/area/shuttle/escape)
"ax" = (
/obj/structure/fans/tiny,
/obj/machinery/door/airlock/external/glass{
	id_tag = "s_docking_airlock"
	},
/turf/simulated/floor/plating,
/area/shuttle/escape)
"az" = (
/obj/item/kirbyplants/large,
/turf/simulated/floor/plasteel{
	icon_state = "cafeteria"
	},
/area/shuttle/escape)
"aA" = (
/turf/simulated/floor/plasteel{
	icon_state = "cafeteria"
	},
/area/shuttle/escape)
"aB" = (
/obj/item/kirbyplants/large,
/turf/simulated/floor/carpet/royalblack,
/area/shuttle/escape)
"aC" = (
/obj/effect/turf_decal/delivery/hollow,
/obj/structure/chair/comfy/shuttle,
/turf/simulated/floor/plasteel,
/area/shuttle/escape)
"aD" = (
/obj/machinery/computer/communications,
/turf/simulated/floor/carpet/royalblue,
/area/shuttle/escape)
"aE" = (
/obj/item/storage/fancy/donut_box{
	pixel_y = 5
	},
/obj/structure/table/reinforced,
/turf/simulated/floor/mineral/plastitanium/red/brig,
/area/shuttle/escape)
"aF" = (
/turf/simulated/floor/mineral/plastitanium/red/brig,
/area/shuttle/escape)
"aG" = (
/obj/machinery/door/airlock/security/glass{
	name = "Escape Shuttle Cell"
	},
/obj/effect/mapping_helpers/airlock/access/all/security/doors,
/turf/simulated/floor/mineral/plastitanium/red/brig,
/area/shuttle/escape)
"aH" = (
/obj/effect/turf_decal/woodsiding{
	dir = 4
	},
/turf/simulated/floor/carpet/royalblack,
/area/shuttle/escape)
"aI" = (
/obj/machinery/door/airlock/titanium/glass{
	name = "Shuttle Hatch";
	hackProof = 1;
	aiControlDisabled = 1;
	id_tag = "s_docking_airlock"
	},
/turf/simulated/floor/plasteel{
	icon_state = "freezerfloor"
	},
/area/shuttle/escape)
"aJ" = (
/obj/machinery/door/airlock/command/glass{
	name = "Escape Shuttle Cockpit"
	},
/obj/effect/mapping_helpers/airlock/access/all/command/general,
/turf/simulated/floor/wood,
/area/shuttle/escape)
"aK" = (
/obj/structure/closet/crate/internals,
/obj/item/clothing/mask/breath,
/obj/item/clothing/mask/breath,
/obj/item/clothing/mask/breath,
/obj/item/clothing/mask/breath,
/obj/item/tank/internals/emergency_oxygen/engi,
/obj/item/tank/internals/emergency_oxygen/engi,
/obj/item/tank/internals/emergency_oxygen/engi,
/obj/item/tank/internals/emergency_oxygen/engi,
/obj/effect/turf_decal/delivery/hollow,
/turf/simulated/floor/plasteel,
/area/shuttle/escape)
"aM" = (
/obj/structure/chair/stool/bar{
	dir = 1
	},
/turf/simulated/floor/plasteel{
	icon_state = "cafeteria"
	},
/area/shuttle/escape)
"aN" = (
/obj/structure/table/wood,
/turf/simulated/floor/plasteel{
	icon_state = "cafeteria"
	},
/area/shuttle/escape)
"aO" = (
/obj/machinery/light/spot{
	dir = 8
	},
/obj/structure/table/reinforced,
/obj/item/storage/firstaid/toxin{
	pixel_x = 3;
	pixel_y = 9
	},
/obj/item/storage/firstaid/o2,
/turf/simulated/floor/mineral/titanium/blue,
/area/shuttle/escape)
"aP" = (
/obj/structure/table/wood,
/obj/item/instrument/violin,
/turf/simulated/floor/plasteel{
	icon_state = "cafeteria"
	},
/area/shuttle/escape)
"aS" = (
/obj/machinery/light/spot{
	dir = 4
	},
/turf/simulated/floor/plasteel{
	icon_state = "cafeteria"
	},
/area/shuttle/escape)
"aT" = (
/obj/effect/turf_decal/woodsiding,
/obj/machinery/light/spot{
	dir = 8
	},
/turf/simulated/floor/carpet/royalblack,
/area/shuttle/escape)
"aU" = (
/obj/structure/table,
/obj/item/storage/box/drinkingglasses,
/obj/item/reagent_containers/drinks/shaker,
/turf/simulated/floor/plasteel{
	icon_state = "cafeteria"
	},
/area/shuttle/escape)
"aV" = (
/obj/structure/chair/wood/wings{
	dir = 8
	},
/obj/effect/turf_decal/woodsiding{
	dir = 4
	},
/turf/simulated/floor/carpet/royalblack,
/area/shuttle/escape)
"aW" = (
/obj/structure/table,
/obj/machinery/chem_dispenser/beer{
	dir = 8
	},
/obj/item/radio/intercom{
	name = "east bump";
	pixel_x = 28
	},
/turf/simulated/floor/plasteel{
	icon_state = "cafeteria"
	},
/area/shuttle/escape)
"aX" = (
/obj/structure/chair/wood/wings{
	dir = 4
	},
/turf/simulated/floor/carpet/royalblack,
/area/shuttle/escape)
"aY" = (
/obj/structure/table/wood/poker,
/turf/simulated/floor/carpet/royalblack,
/area/shuttle/escape)
"aZ" = (
/obj/structure/table,
/obj/machinery/chem_dispenser/soda{
	dir = 8
	},
/turf/simulated/floor/plasteel{
	icon_state = "cafeteria"
	},
/area/shuttle/escape)
"bb" = (
/obj/structure/table/wood/poker,
/obj/item/deck/cards,
/turf/simulated/floor/carpet/royalblack,
/area/shuttle/escape)
"bc" = (
/obj/structure/chair/comfy/brown{
	dir = 8
	},
/turf/simulated/floor/carpet/royalblack,
/area/shuttle/escape)
"bd" = (
/obj/effect/turf_decal/woodsiding{
	dir = 9
	},
/obj/structure/chair/comfy/shuttle{
	dir = 4
	},
/turf/simulated/floor/carpet/blue,
/area/shuttle/escape)
"be" = (
/obj/structure/chair/wood/wings{
	dir = 4
	},
/obj/effect/turf_decal/woodsiding{
	dir = 8
	},
/turf/simulated/floor/carpet/royalblack,
/area/shuttle/escape)
"bf" = (
/obj/structure/chair/stool/bar{
	dir = 1
	},
/obj/machinery/light/spot{
	dir = 4
	},
/turf/simulated/floor/plasteel{
	icon_state = "cafeteria"
	},
/area/shuttle/escape)
"bh" = (
/obj/effect/turf_decal/woodsiding{
	dir = 1
	},
/obj/structure/extinguisher_cabinet{
	name = "west bump";
	pixel_x = -27
	},
/turf/simulated/floor/carpet/royalblack,
/area/shuttle/escape)
"bi" = (
/obj/machinery/door/airlock{
	name = "Toilet"
	},
/turf/simulated/floor/plasteel{
	icon_state = "freezerfloor"
	},
/area/shuttle/escape)
"bn" = (
/turf/simulated/floor/mineral/titanium/blue,
/area/shuttle/escape)
"bo" = (
/turf/simulated/floor/plasteel{
	icon_state = "freezerfloor"
	},
/area/shuttle/escape)
"bp" = (
/obj/item/paper_bin{
	pixel_x = -4;
	pixel_y = 3
	},
/obj/item/pen{
	pixel_x = -4;
	pixel_y = 3
	},
/obj/item/folder/red{
	pixel_x = 11;
	pixel_y = 7
	},
/obj/structure/table/reinforced,
/turf/simulated/floor/mineral/plastitanium/red/brig,
/area/shuttle/escape)
"bq" = (
/obj/structure/table/wood,
/obj/item/instrument/guitar,
/turf/simulated/floor/plasteel{
	icon_state = "cafeteria"
	},
/area/shuttle/escape)
"br" = (
/turf/simulated/floor/mineral/titanium,
/area/shuttle/escape)
"bs" = (
/obj/structure/table/wood,
/obj/item/ashtray/glass,
/turf/simulated/floor/plasteel{
	icon_state = "cafeteria"
	},
/area/shuttle/escape)
"bt" = (
/obj/machinery/door/airlock{
	name = "Unit 1"
	},
/turf/simulated/floor/plasteel{
	icon_state = "freezerfloor"
	},
/area/shuttle/escape)
"bv" = (
/obj/machinery/door/airlock{
	name = "Unit 2"
	},
/turf/simulated/floor/plasteel{
	icon_state = "freezerfloor"
	},
/area/shuttle/escape)
"bw" = (
/obj/machinery/door/airlock{
	name = "Unit 3"
	},
/turf/simulated/floor/plasteel{
	icon_state = "freezerfloor"
	},
/area/shuttle/escape)
"bx" = (
/obj/machinery/sleeper{
	dir = 4
	},
/turf/simulated/floor/mineral/titanium/blue,
/area/shuttle/escape)
"by" = (
/obj/structure/chair/comfy/shuttle{
	dir = 1
	},
/turf/simulated/floor/mineral/titanium/blue,
/area/shuttle/escape)
"bz" = (
/obj/effect/turf_decal/stripes/line{
	dir = 4
	},
/turf/simulated/floor/plasteel,
/area/shuttle/escape)
"bA" = (
/obj/machinery/light/spot,
/turf/simulated/floor/plasteel{
	icon_state = "freezerfloor"
	},
/area/shuttle/escape)
"bB" = (
/obj/machinery/recharge_station,
/turf/simulated/floor/plasteel{
	icon_state = "freezerfloor"
	},
/area/shuttle/escape)
"bC" = (
/turf/simulated/wall/mineral/titanium/nodiagonal,
/area/shuttle/escape)
"bD" = (
/obj/machinery/computer/station_alert{
	dir = 4
	},
/obj/effect/turf_decal/woodsiding{
	dir = 1
	},
/turf/simulated/floor/carpet/orange,
/area/shuttle/escape)
"bG" = (
/obj/effect/spawner/window/shuttle,
/obj/structure/sign/greencross,
/turf/simulated/floor/plating,
/area/shuttle/escape)
"bJ" = (
/obj/structure/shuttle/engine/heater,
/obj/structure/window/reinforced{
	dir = 1
	},
/turf/simulated/floor/plating/airless,
/area/shuttle/escape)
"bL" = (
/obj/structure/shuttle/engine/propulsion,
/turf/simulated/floor/plating/airless,
/area/shuttle/escape)
"cE" = (
/obj/effect/turf_decal/woodsiding{
	dir = 9
	},
/obj/structure/chair/comfy/shuttle{
	dir = 4
	},
/turf/simulated/floor/carpet/purple,
/area/shuttle/escape)
"cF" = (
/obj/structure/table,
/obj/item/storage/box/drinkingglasses,
/obj/item/reagent_containers/drinks/shaker,
/obj/item/clothing/mask/cigarette/cigar,
/obj/item/lighter/zippo,
/turf/simulated/floor/plasteel{
	icon_state = "cafeteria"
	},
/area/shuttle/escape)
"dn" = (
/obj/machinery/status_display{
	pixel_y = -30
	},
/turf/simulated/floor/plasteel{
	icon_state = "cafeteria"
	},
/area/shuttle/escape)
"dQ" = (
/turf/simulated/wall/mineral/titanium/interior,
/area/shuttle/escape)
"ec" = (
/obj/machinery/computer/secure_data{
	dir = 4
	},
/obj/structure/sign/poster/official/cohiba_robusto_ad{
	pixel_x = -32
	},
/obj/effect/turf_decal/woodsiding,
/turf/simulated/floor/carpet/red,
/area/shuttle/escape)
"ff" = (
/obj/effect/turf_decal/delivery/hollow,
/obj/structure/chair/comfy/shuttle{
	dir = 1
	},
/turf/simulated/floor/plasteel,
/area/shuttle/escape)
"gH" = (
/obj/structure/chair/comfy/shuttle{
	dir = 4
	},
/obj/item/radio/intercom{
	name = "west bump";
	pixel_x = -28
	},
/turf/simulated/floor/mineral/plastitanium/red/brig,
/area/shuttle/escape)
"li" = (
/obj/structure/closet/fireaxecabinet{
	pixel_x = 32
	},
/turf/simulated/floor/mineral/titanium,
/area/shuttle/escape)
"lA" = (
/obj/structure/chair/wood/wings{
	dir = 8
	},
/obj/effect/turf_decal/woodsiding{
	dir = 5
	},
/turf/simulated/floor/carpet/royalblack,
/area/shuttle/escape)
"lG" = (
/obj/machinery/light/spot{
	dir = 1
	},
/obj/structure/musician/piano,
/turf/simulated/floor/carpet/royalblack,
/area/shuttle/escape)
"mV" = (
/obj/structure/chair/wood/wings,
/obj/effect/turf_decal/woodsiding{
	dir = 1
	},
/turf/simulated/floor/carpet/royalblack,
/area/shuttle/escape)
"nk" = (
/turf/simulated/floor/plasteel,
/area/shuttle/escape)
"nM" = (
/obj/effect/turf_decal/woodsiding{
	dir = 6
	},
/turf/simulated/floor/carpet/red,
/area/shuttle/escape)
"ol" = (
/obj/item/storage/firstaid/regular{
	pixel_x = 7;
	pixel_y = 9
	},
/obj/item/storage/firstaid/adv,
/obj/structure/table/reinforced,
/turf/simulated/floor/mineral/titanium/blue,
/area/shuttle/escape)
"pl" = (
/obj/docking_port/mobile/emergency{
	dwidth = 11;
	height = 13;
	name = "The Emergency Escape Bar";
	timid = 1;
	width = 24
	},
/obj/machinery/door/airlock/titanium/glass{
	name = "Shuttle Hatch";
	hackProof = 1;
	aiControlDisabled = 1;
	id_tag = "s_docking_airlock"
	},
/turf/simulated/floor/plasteel{
	icon_state = "cafeteria"
	},
/area/shuttle/escape)
"pC" = (
/obj/effect/turf_decal/woodsiding{
	dir = 10
	},
/turf/simulated/floor/carpet/purple,
/area/shuttle/escape)
"pH" = (
/obj/structure/table/wood,
/obj/item/ashtray/glass,
/obj/item/storage/fancy/cigarettes/cigpack_carp{
	pixel_x = 8;
	pixel_y = 11
	},
/turf/simulated/floor/plasteel{
	icon_state = "cafeteria"
	},
/area/shuttle/escape)
"pT" = (
/obj/machinery/status_display{
	pixel_y = 30
	},
/obj/item/restraints/handcuffs,
/obj/item/flash,
/obj/structure/table/reinforced,
/turf/simulated/floor/mineral/plastitanium/red/brig,
/area/shuttle/escape)
"qr" = (
/turf/simulated/wall/mineral/plastitanium,
/area/shuttle/escape)
"qJ" = (
/obj/item/kirbyplants/large,
/obj/item/radio/intercom{
	name = "north bump";
	pixel_y = 28
	},
/turf/simulated/floor/plasteel{
	icon_state = "cafeteria"
	},
/area/shuttle/escape)
"rh" = (
/obj/effect/turf_decal/woodsiding,
/turf/simulated/floor/carpet/royalblack,
/area/shuttle/escape)
"rr" = (
/obj/machinery/computer/crew{
	dir = 8
	},
/obj/effect/turf_decal/woodsiding{
	dir = 1
	},
/turf/simulated/floor/carpet/blue,
/area/shuttle/escape)
"ss" = (
/obj/machinery/light/spot,
/turf/simulated/floor/plasteel{
	icon_state = "cafeteria"
	},
/area/shuttle/escape)
"tx" = (
/obj/structure/chair/wood/wings{
	dir = 4
	},
/obj/effect/turf_decal/woodsiding{
	dir = 10
	},
/turf/simulated/floor/carpet/royalblack,
/area/shuttle/escape)
"us" = (
/obj/structure/table/wood,
/obj/effect/spawner/random/food_or_drink/three_course_meal,
/turf/simulated/floor/carpet/royalblue,
/area/shuttle/escape)
"uO" = (
/obj/machinery/defibrillator_mount/loaded{
	pixel_y = 29
	},
/obj/structure/bed/roller,
/turf/simulated/floor/mineral/titanium/blue,
/area/shuttle/escape)
"vF" = (
/obj/item/kirbyplants/large,
/obj/effect/turf_decal/woodsiding{
	dir = 8
	},
/obj/machinery/status_display{
	pixel_y = 30
	},
/turf/simulated/floor/carpet/royalblack,
/area/shuttle/escape)
"wk" = (
/obj/machinery/light/spot,
/obj/structure/sign/poster/contraband/borg_fancy_2{
	pixel_x = -32
	},
/turf/simulated/floor/plasteel{
	icon_state = "freezerfloor"
	},
/area/shuttle/escape)
"wC" = (
/obj/structure/chair/comfy/shuttle{
	dir = 4
	},
/turf/simulated/floor/mineral/plastitanium/red/brig,
/area/shuttle/escape)
"wF" = (
/obj/machinery/iv_drip,
/turf/simulated/floor/mineral/titanium/blue,
/area/shuttle/escape)
"xd" = (
/obj/effect/turf_decal/woodsiding{
	dir = 5
	},
/obj/structure/chair/comfy/shuttle{
	dir = 8
	},
/turf/simulated/floor/carpet/orange,
/area/shuttle/escape)
"zM" = (
/obj/machinery/computer/atmos_alert{
	dir = 4
	},
/obj/effect/turf_decal/woodsiding,
/turf/simulated/floor/carpet/orange,
/area/shuttle/escape)
"zU" = (
/obj/structure/table/wood/poker,
/obj/item/ashtray/bronze,
/obj/item/reagent_containers/drinks/drinkingglass/shotglass{
	pixel_x = 8;
	pixel_y = 14
	},
/obj/item/storage/fancy/cigarettes/cigpack_robustgold{
	pixel_x = -5;
	pixel_y = 12
	},
/obj/item/storage/fancy/matches{
	pixel_y = -10
	},
/obj/item/reagent_containers/drinks/drinkingglass/shotglass{
	pixel_x = -7;
	pixel_y = 3
	},
/turf/simulated/floor/carpet/royalblack,
/area/shuttle/escape)
"AA" = (
/obj/structure/chair/wood/wings{
	dir = 8
	},
/obj/effect/turf_decal/woodsiding{
	dir = 6
	},
/turf/simulated/floor/carpet/royalblack,
/area/shuttle/escape)
"AQ" = (
/obj/machinery/door/airlock/titanium/glass{
	name = "Emergency Airlock Access"
	},
/obj/effect/mapping_helpers/airlock/access/all/security/doors,
/turf/simulated/floor/plasteel,
/area/shuttle/escape)
"Bf" = (
/obj/structure/extinguisher_cabinet{
	name = "north bump";
	pixel_y = 30
	},
/turf/simulated/floor/plasteel{
	icon_state = "cafeteria"
	},
/area/shuttle/escape)
"Bz" = (
/obj/machinery/computer/emergency_shuttle,
/turf/simulated/floor/carpet/royalblue,
/area/shuttle/escape)
"BE" = (
/obj/structure/chair/comfy/shuttle{
	dir = 1
	},
/obj/effect/turf_decal/woodsiding,
/turf/simulated/floor/carpet/royalblue,
/area/shuttle/escape)
"CF" = (
/obj/machinery/door/airlock/titanium/glass{
	name = "Shuttle Hatch";
	hackProof = 1;
	aiControlDisabled = 1;
	id_tag = "s_docking_airlock"
	},
/turf/simulated/floor/plating,
/area/shuttle/escape)
"Dy" = (
/obj/structure/chair/wood/wings{
	dir = 1
	},
/obj/effect/turf_decal/woodsiding,
/turf/simulated/floor/carpet/royalblack,
/area/shuttle/escape)
"DY" = (
/obj/effect/turf_decal/woodsiding{
	dir = 10
	},
/turf/simulated/floor/carpet/royalblack,
/area/shuttle/escape)
"Ej" = (
/obj/machinery/light/spot,
/obj/machinery/economy/vending/wallmed/directional/east,
/obj/item/storage/box/bodybags,
/obj/structure/table/reinforced,
/turf/simulated/floor/mineral/titanium/blue,
/area/shuttle/escape)
"FK" = (
/obj/structure/table/reinforced,
/obj/machinery/recharger{
	pixel_x = 6;
	pixel_y = 4
	},
/obj/item/storage/firstaid/regular{
	pixel_y = 4;
	pixel_x = -7
	},
/turf/simulated/floor/mineral/titanium,
/area/shuttle/escape)
"HV" = (
/obj/effect/turf_decal/delivery/hollow,
/obj/structure/chair/comfy/shuttle,
/obj/item/radio/intercom{
	name = "north bump";
	pixel_y = 28
	},
/turf/simulated/floor/plasteel,
/area/shuttle/escape)
"Jz" = (
/obj/structure/chair/stool/bar{
	dir = 4
	},
/turf/simulated/floor/plasteel{
	icon_state = "cafeteria"
	},
/area/shuttle/escape)
"JD" = (
/obj/structure/closet/walllocker/emerglocker{
	pixel_x = -28
	},
/turf/simulated/floor/mineral/plastitanium/red/brig,
/area/shuttle/escape)
"JE" = (
/obj/machinery/computer/security{
	dir = 4
	},
/obj/item/radio/intercom{
	name = "north bump";
	pixel_y = 28
	},
/obj/effect/turf_decal/woodsiding{
	dir = 1
	},
/turf/simulated/floor/carpet/red,
/area/shuttle/escape)
"LD" = (
/obj/machinery/status_display{
	pixel_y = 30
	},
/obj/machinery/light/spot{
	dir = 8
	},
/obj/machinery/recharger{
	pixel_y = 4
	},
/obj/structure/table/wood,
/turf/simulated/floor/wood,
/area/shuttle/escape)
"LV" = (
/obj/effect/turf_decal/woodsiding{
	dir = 6
	},
/turf/simulated/floor/carpet/royalblack,
/area/shuttle/escape)
"Mp" = (
/obj/structure/table/wood,
/obj/item/ashtray/glass,
/obj/item/storage/fancy/cigarettes/dromedaryco{
	pixel_x = 8;
	pixel_y = 11
	},
/turf/simulated/floor/plasteel{
	icon_state = "cafeteria"
	},
/area/shuttle/escape)
"MX" = (
/obj/machinery/computer/robotics{
	dir = 8
	},
/obj/effect/turf_decal/woodsiding,
/turf/simulated/floor/carpet/purple,
/area/shuttle/escape)
"MZ" = (
/obj/structure/extinguisher_cabinet{
	name = "north bump";
	pixel_y = 30
	},
/turf/simulated/floor/mineral/titanium/blue,
/area/shuttle/escape)
"Na" = (
/obj/structure/chair/comfy/shuttle{
	dir = 8
	},
/turf/simulated/floor/carpet/royalblack,
/area/shuttle/escape)
"NC" = (
/obj/machinery/recharger{
	pixel_y = 4
	},
/obj/structure/table/reinforced,
/turf/simulated/floor/mineral/plastitanium/red/brig,
/area/shuttle/escape)
"NH" = (
/obj/structure/curtain/open/shower,
/obj/structure/window/reinforced/tinted/frosted{
	dir = 1
	},
/obj/item/soap/deluxe,
/obj/machinery/shower{
	dir = 1
	},
/turf/simulated/floor/plasteel{
	icon_state = "freezerfloor"
	},
/area/shuttle/escape)
"NK" = (
/obj/structure/chair/wood/wings{
	dir = 4
	},
/obj/effect/turf_decal/woodsiding{
	dir = 9
	},
/turf/simulated/floor/carpet/royalblack,
/area/shuttle/escape)
"Pf" = (
/obj/effect/turf_decal/woodsiding{
	dir = 5
	},
/obj/structure/chair/comfy/shuttle{
	dir = 8
	},
/turf/simulated/floor/carpet/red,
/area/shuttle/escape)
"Qp" = (
/obj/structure/table/wood,
/obj/item/storage/fancy/matches,
/turf/simulated/floor/plasteel{
	icon_state = "cafeteria"
	},
/area/shuttle/escape)
"Qy" = (
/obj/structure/table/wood/poker,
/obj/item/clothing/mask/cigarette/pipe{
	pixel_x = -1;
	pixel_y = 12
	},
/obj/item/clothing/mask/cigarette/cigar/cohiba{
	pixel_y = 3
	},
/obj/item/clothing/mask/cigarette/cigar/cohiba{
	pixel_x = 2;
	pixel_y = 8
	},
/obj/effect/turf_decal/woodsiding,
/turf/simulated/floor/carpet/royalblack,
/area/shuttle/escape)
"Rh" = (
/obj/machinery/status_display{
	pixel_y = 30
	},
/obj/machinery/light/spot{
	dir = 4
	},
/obj/machinery/cell_charger{
	pixel_y = 6
	},
/obj/item/stock_parts/cell/high{
	pixel_y = 6
	},
/obj/structure/table/wood,
/turf/simulated/floor/wood,
/area/shuttle/escape)
"Rt" = (
/obj/structure/table/wood/poker,
/obj/item/reagent_containers/drinks/drinkingglass/shotglass{
	pixel_x = 2;
	pixel_y = 12
	},
/obj/item/reagent_containers/drinks/bottle/wine{
	pixel_x = 8;
	pixel_y = 6
	},
/obj/item/reagent_containers/drinks/bottle/whiskey{
	pixel_x = -7;
	pixel_y = 2
	},
/obj/effect/turf_decal/woodsiding{
	dir = 1
	},
/turf/simulated/floor/carpet/royalblack,
/area/shuttle/escape)
"Rv" = (
/obj/machinery/door/airlock/titanium/glass{
	name = "Shuttle Hatch";
	hackProof = 1;
	aiControlDisabled = 1;
	id_tag = "s_docking_airlock"
	},
/turf/simulated/floor/plasteel{
	icon_state = "cafeteria"
	},
/area/shuttle/escape)
"RQ" = (
/obj/machinery/status_display{
	pixel_x = -30
	},
/obj/structure/table/reinforced,
/obj/item/reagent_containers/iv_bag/blood/o_minus,
/obj/item/reagent_containers/iv_bag/blood/o_minus,
/obj/item/reagent_containers/iv_bag/blood/o_minus,
/turf/simulated/floor/mineral/titanium/blue,
/area/shuttle/escape)
"SW" = (
/obj/structure/curtain/open/shower,
/obj/item/bikehorn/rubberducky,
/obj/machinery/shower{
	pixel_y = 22
	},
/turf/simulated/floor/plasteel{
	icon_state = "freezerfloor"
	},
/area/shuttle/escape)
"Tb" = (
/obj/machinery/computer/med_data{
	dir = 8
	},
/obj/structure/sign/poster/official/high_class_martini{
	pixel_x = 32
	},
/obj/effect/turf_decal/woodsiding,
/turf/simulated/floor/carpet/blue,
/area/shuttle/escape)
"Ul" = (
/obj/effect/turf_decal/woodsiding{
	dir = 6
	},
/turf/simulated/floor/carpet/orange,
/area/shuttle/escape)
"Uq" = (
/obj/machinery/door/airlock/medical/glass{
	name = "Escape Shuttle Infirmary"
	},
/turf/simulated/floor/mineral/titanium/blue,
/area/shuttle/escape)
"Uv" = (
/obj/effect/turf_decal/woodsiding{
	dir = 10
	},
/turf/simulated/floor/carpet/blue,
/area/shuttle/escape)
"YQ" = (
/obj/structure/bed/roller,
/turf/simulated/floor/mineral/titanium/blue,
/area/shuttle/escape)
"ZH" = (
/obj/effect/turf_decal/delivery/hollow,
/obj/item/storage/firstaid/regular{
	pixel_y = 3
	},
/obj/structure/table/reinforced,
/turf/simulated/floor/plasteel,
/area/shuttle/escape)

(1,1,1) = {"
ah
ah
ah
ah
ah
ah
ah
ab
ab
ab
ac
ac
ab
ab
ab
ab
CF
ab
pl
ab
ac
ac
ac
ab
Rv
ab
aI
ab
ab
ab
ab
ab
ah
"}
(2,1,1) = {"
ah
ah
ah
ah
ah
ab
ac
ab
ab
bp
wC
wC
wC
gH
wC
JD
aF
ac
aA
bh
aX
aB
aX
aT
aA
ab
bo
bo
bt
ao
ab
qr
qr
"}
(3,1,1) = {"
ah
ah
ah
ab
ac
bC
bD
zM
ab
pT
aF
aF
aF
aF
aF
aF
aF
ac
aA
mV
aY
bb
aY
Dy
aA
ab
bo
bo
dQ
dQ
ab
bJ
bL
"}
(4,1,1) = {"
ah
ah
ab
ab
JE
ec
xd
Ul
ab
NC
aF
aF
aF
aF
aF
aF
aF
ac
aA
mV
aY
bc
aY
Dy
aA
bi
bo
bo
bv
ao
ab
bJ
bL
"}
(5,1,1) = {"
ah
ab
ab
LD
Pf
nM
an
ak
ab
aE
aF
aF
aF
ai
ar
ar
ar
ac
aA
as
aH
aH
aH
LV
aA
ab
bo
bA
dQ
bC
ab
bJ
bL
"}
(6,1,1) = {"
ab
ab
aq
an
an
an
an
an
ab
ac
aG
aG
ac
ab
ac
ac
ac
bC
Bf
aA
aA
aA
aA
aA
ss
ab
bo
bo
bw
wk
ab
qr
qr
"}
(7,1,1) = {"
ac
us
aj
an
NK
be
tx
an
ac
FK
br
br
am
ac
av
av
av
av
aA
aA
aA
aA
aA
aA
aA
ab
SW
NH
ab
bB
ab
bJ
bL
"}
(8,1,1) = {"
ac
Bz
BE
an
Rt
zU
Qy
an
aJ
br
br
br
br
al
aA
aA
aA
aA
aA
aA
aA
aA
aA
aA
dn
ab
ab
ab
ab
ab
ab
bJ
bL
"}
(9,1,1) = {"
ac
aD
aj
an
lA
aV
AA
an
ac
li
br
br
am
ac
aA
aA
aA
aA
aA
aA
aA
aA
aA
aA
aA
ab
bx
RQ
aO
bx
ab
bJ
bL
"}
(10,1,1) = {"
ab
ab
aq
an
an
an
an
an
ab
ab
AQ
AQ
ab
ab
qJ
aA
Jz
Jz
Jz
Jz
Jz
Jz
Jz
aA
ss
ab
MZ
bn
bn
bn
ab
qr
qr
"}
(11,1,1) = {"
ah
ab
ab
Rh
bd
Uv
an
ak
ab
aa
nk
nk
ZH
ab
Bf
aA
aN
Mp
aN
aN
pH
aN
aN
aM
aA
bG
bn
bn
bn
by
ab
bJ
bL
"}
(12,1,1) = {"
ah
ah
ab
ab
rr
Tb
cE
pC
ab
HV
nk
nk
ff
ab
vF
DY
bq
aA
aA
aA
aA
aA
aN
aM
aA
Uq
bn
bn
bn
by
ab
bJ
bL
"}
(13,1,1) = {"
ah
ah
ah
ab
ac
ab
aw
MX
ab
aC
nk
nk
ff
ab
lG
rh
aP
aA
aA
aA
aA
aA
bs
aM
aA
bG
wF
bn
bn
ol
ab
bJ
bL
"}
(14,1,1) = {"
ah
ah
ah
ah
ah
ab
ac
ab
ab
aK
bz
bz
aK
ab
Na
rh
aA
aS
aU
aW
aZ
cF
Qp
bf
az
ab
uO
YQ
af
Ej
ab
qr
qr
"}
(15,1,1) = {"
ah
ah
ah
ah
ah
ah
ah
ab
ab
ab
ax
ax
ab
ab
ab
ab
ac
ab
ac
ab
ac
ac
ac
ab
ac
ab
ac
ab
ab
ab
ab
ab
ah
"}
