//MAP CONVERTED BY dmm2tgm.py THIS HEADER COMMENT PREVENTS RECONVERSION, DO NOT REMOVE
"aa" = (
/turf/space,
/area/space)
"ab" = (
/turf/simulated/wall/mineral/titanium,
/area/shuttle/escape)
"ac" = (
/obj/effect/spawner/window/shuttle,
/turf/simulated/floor/plating,
/area/shuttle/escape)
"af" = (
/obj/machinery/computer/emergency_shuttle,
/obj/effect/mapping_helpers/valid_shuttle_turf,
/turf/simulated/floor/carpet/red,
/area/shuttle/escape)
"ah" = (
/obj/machinery/computer/security{
	network = list("SS13","Telecomms","Research Outpost","Mining Outpost")
	},
/obj/effect/mapping_helpers/valid_shuttle_turf,
/turf/simulated/floor/carpet/red,
/area/shuttle/escape)
"ai" = (
/obj/structure/chair/comfy/shuttle{
	dir = 1
	},
/obj/effect/mapping_helpers/valid_shuttle_turf,
/turf/simulated/floor/carpet/red,
/area/shuttle/escape)
"aj" = (
/obj/machinery/computer/communications,
/obj/effect/mapping_helpers/valid_shuttle_turf,
/turf/simulated/floor/carpet/red,
/area/shuttle/escape)
"ak" = (
/obj/machinery/computer/station_alert,
/obj/effect/mapping_helpers/valid_shuttle_turf,
/turf/simulated/floor/carpet/red,
/area/shuttle/escape)
"al" = (
/obj/effect/mapping_helpers/valid_shuttle_turf,
/turf/simulated/floor/carpet/red,
/area/shuttle/escape)
"am" = (
/obj/machinery/computer/crew,
/obj/machinery/status_display{
	pixel_y = 30
	},
/obj/effect/mapping_helpers/valid_shuttle_turf,
/turf/simulated/floor/carpet/red,
/area/shuttle/escape)
"an" = (
/obj/structure/table/wood/poker,
/obj/item/reagent_containers/drinks/bottle/whiskey,
/obj/effect/mapping_helpers/valid_shuttle_turf,
/turf/simulated/floor/carpet/red,
/area/shuttle/escape)
"ao" = (
/obj/structure/closet/walllocker/emerglocker{
	pixel_x = 28
	},
/obj/structure/chair/comfy/shuttle{
	dir = 1
	},
/obj/effect/mapping_helpers/valid_shuttle_turf,
/turf/simulated/floor/carpet/red,
/area/shuttle/escape)
"aq" = (
/obj/machinery/computer/robotics{
	dir = 4
	},
/obj/effect/mapping_helpers/valid_shuttle_turf,
/turf/simulated/floor/carpet/red,
/area/shuttle/escape)
"ar" = (
/obj/structure/chair/comfy/shuttle{
	dir = 8
	},
/obj/effect/mapping_helpers/valid_shuttle_turf,
/turf/simulated/floor/carpet/red,
/area/shuttle/escape)
"as" = (
/obj/machinery/light/spot,
/obj/effect/mapping_helpers/valid_shuttle_turf,
/turf/simulated/floor/carpet/red,
/area/shuttle/escape)
"av" = (
/obj/machinery/door/airlock/command/glass{
	name = "Escape Shuttle Cockpit"
	},
/obj/effect/mapping_helpers/airlock/access/all/command/general,
/obj/effect/mapping_helpers/valid_shuttle_turf,
/turf/simulated/floor/carpet/red,
/area/shuttle/escape)
"aw" = (
/obj/structure/chair{
	dir = 4
	},
/obj/structure/chair/comfy/shuttle{
	dir = 4
	},
/obj/effect/mapping_helpers/valid_shuttle_turf,
/turf/simulated/floor/mineral/plastitanium/red/brig,
/area/shuttle/escape)
"ax" = (
/obj/machinery/status_display{
	pixel_y = 30
	},
/obj/machinery/light/spot{
	dir = 1
	},
/obj/structure/chair,
/obj/structure/chair/comfy/shuttle,
/obj/effect/mapping_helpers/valid_shuttle_turf,
/turf/simulated/floor/mineral/plastitanium/red/brig,
/area/shuttle/escape)
"az" = (
/obj/item/kirbyplants,
/obj/effect/mapping_helpers/valid_shuttle_turf,
/turf/simulated/floor/plasteel{
	icon_state = "cafeteria"
	},
/area/shuttle/escape)
"aA" = (
/obj/effect/mapping_helpers/valid_shuttle_turf,
/turf/simulated/floor/plasteel{
	icon_state = "cafeteria"
	},
/area/shuttle/escape)
"aB" = (
/obj/item/kirbyplants,
/obj/effect/mapping_helpers/valid_shuttle_turf,
/turf/simulated/floor/carpet/royalblack,
/area/shuttle/escape)
"aC" = (
/obj/machinery/status_display{
	pixel_y = 30
	},
/obj/machinery/light/spot{
	dir = 1
	},
/obj/structure/musician/piano,
/obj/effect/mapping_helpers/valid_shuttle_turf,
/turf/simulated/floor/carpet/royalblack,
/area/shuttle/escape)
"aD" = (
/obj/structure/chair/stool,
/obj/effect/mapping_helpers/valid_shuttle_turf,
/turf/simulated/floor/carpet/royalblack,
/area/shuttle/escape)
"aE" = (
/obj/structure/chair{
	dir = 4
	},
/obj/structure/closet/walllocker/emerglocker{
	pixel_x = -28
	},
/obj/structure/chair/comfy/shuttle{
	dir = 4
	},
/obj/effect/mapping_helpers/valid_shuttle_turf,
/turf/simulated/floor/mineral/plastitanium/red/brig,
/area/shuttle/escape)
"aF" = (
/obj/effect/mapping_helpers/valid_shuttle_turf,
/turf/simulated/floor/mineral/plastitanium/red/brig,
/area/shuttle/escape)
"aG" = (
/obj/machinery/door/airlock/security/glass{
	name = "Escape Shuttle Cell"
	},
/obj/effect/mapping_helpers/airlock/access/all/security/doors,
/obj/effect/mapping_helpers/valid_shuttle_turf,
/turf/simulated/floor/mineral/plastitanium/red/brig,
/area/shuttle/escape)
"aH" = (
/obj/effect/mapping_helpers/valid_shuttle_turf,
/turf/simulated/floor/carpet/royalblack,
/area/shuttle/escape)
"aI" = (
/obj/machinery/door/airlock/titanium{
	aiControlDisabled = 1;
	hackProof = 1;
	id_tag = "s_docking_airlock";
	name = "Shuttle Hatch"
	},
/turf/simulated/floor/plating,
/area/shuttle/escape)
"aJ" = (
/obj/structure/chair{
	dir = 1
	},
/obj/structure/chair/comfy/shuttle{
	dir = 1
	},
/obj/effect/mapping_helpers/valid_shuttle_turf,
/turf/simulated/floor/mineral/plastitanium/red/brig,
/area/shuttle/escape)
"aK" = (
/obj/structure/chair,
/obj/structure/chair/comfy/shuttle,
/obj/effect/mapping_helpers/valid_shuttle_turf,
/turf/simulated/floor/mineral/plastitanium/red/brig,
/area/shuttle/escape)
"aM" = (
/obj/structure/chair/stool/bar{
	dir = 1
	},
/obj/effect/mapping_helpers/valid_shuttle_turf,
/turf/simulated/floor/plasteel{
	icon_state = "cafeteria"
	},
/area/shuttle/escape)
"aN" = (
/obj/structure/table/wood,
/obj/effect/mapping_helpers/valid_shuttle_turf,
/turf/simulated/floor/plasteel{
	icon_state = "cafeteria"
	},
/area/shuttle/escape)
"aO" = (
/obj/structure/table,
/obj/item/storage/firstaid/o2{
	layer = 2.8;
	pixel_x = 4;
	pixel_y = 6
	},
/obj/item/storage/firstaid/regular{
	pixel_x = 2;
	pixel_y = 6
	},
/obj/item/storage/firstaid/regular{
	pixel_x = -2;
	pixel_y = 4
	},
/obj/item/bodybag{
	pixel_x = 5
	},
/obj/effect/mapping_helpers/valid_shuttle_turf,
/turf/simulated/floor/mineral/titanium,
/area/shuttle/escape)
"aP" = (
/obj/structure/table/wood,
/obj/item/instrument/violin,
/obj/effect/mapping_helpers/valid_shuttle_turf,
/turf/simulated/floor/plasteel{
	icon_state = "cafeteria"
	},
/area/shuttle/escape)
"aS" = (
/obj/machinery/light/spot{
	dir = 4
	},
/obj/effect/mapping_helpers/valid_shuttle_turf,
/turf/simulated/floor/plasteel{
	icon_state = "cafeteria"
	},
/area/shuttle/escape)
"aT" = (
/obj/docking_port/mobile/emergency{
	dwidth = 11;
	height = 13;
	name = "The Emergency Escape Bar";
	timid = 1;
	width = 24
	},
/obj/machinery/door/airlock/titanium{
	aiControlDisabled = 1;
	hackProof = 1;
	id_tag = "s_docking_airlock";
	name = "Shuttle Hatch"
	},
/turf/simulated/floor/plating,
/area/shuttle/escape)
"aU" = (
/obj/structure/table,
/obj/item/storage/box/drinkingglasses,
/obj/item/reagent_containers/drinks/shaker,
/obj/effect/mapping_helpers/valid_shuttle_turf,
/turf/simulated/floor/plasteel{
	icon_state = "cafeteria"
	},
/area/shuttle/escape)
"aV" = (
/obj/structure/chair/wood/wings,
/obj/effect/mapping_helpers/valid_shuttle_turf,
/turf/simulated/floor/carpet/royalblack,
/area/shuttle/escape)
"aW" = (
/obj/structure/table,
/obj/machinery/chem_dispenser/beer{
	dir = 8
	},
/obj/effect/mapping_helpers/valid_shuttle_turf,
/turf/simulated/floor/plasteel{
	icon_state = "cafeteria"
	},
/area/shuttle/escape)
"aX" = (
/obj/structure/chair/wood/wings{
	dir = 4
	},
/obj/effect/mapping_helpers/valid_shuttle_turf,
/turf/simulated/floor/carpet/royalblack,
/area/shuttle/escape)
"aY" = (
/obj/structure/table/wood/poker,
/obj/effect/mapping_helpers/valid_shuttle_turf,
/turf/simulated/floor/carpet/royalblack,
/area/shuttle/escape)
"aZ" = (
/obj/structure/table,
/obj/machinery/chem_dispenser/soda{
	dir = 8
	},
/obj/effect/mapping_helpers/valid_shuttle_turf,
/turf/simulated/floor/plasteel{
	icon_state = "cafeteria"
	},
/area/shuttle/escape)
"bb" = (
/obj/structure/table/wood/poker,
/obj/item/deck/cards,
/obj/effect/mapping_helpers/valid_shuttle_turf,
/turf/simulated/floor/carpet/royalblack,
/area/shuttle/escape)
"bc" = (
/obj/structure/chair/comfy/brown{
	dir = 8
	},
/obj/effect/mapping_helpers/valid_shuttle_turf,
/turf/simulated/floor/carpet/royalblack,
/area/shuttle/escape)
"bd" = (
/obj/structure/table,
/obj/item/storage/box/drinkingglasses,
/obj/item/reagent_containers/drinks/shaker,
/obj/item/clothing/mask/cigarette/cigar,
/obj/effect/mapping_helpers/valid_shuttle_turf,
/turf/simulated/floor/plasteel{
	icon_state = "cafeteria"
	},
/area/shuttle/escape)
"be" = (
/obj/structure/chair/wood/wings{
	dir = 1
	},
/obj/effect/mapping_helpers/valid_shuttle_turf,
/turf/simulated/floor/carpet/royalblack,
/area/shuttle/escape)
"bf" = (
/obj/structure/chair/stool/bar{
	dir = 1
	},
/obj/machinery/light/spot{
	dir = 4
	},
/obj/effect/mapping_helpers/valid_shuttle_turf,
/turf/simulated/floor/plasteel{
	icon_state = "cafeteria"
	},
/area/shuttle/escape)
"bh" = (
/obj/machinery/status_display{
	pixel_y = -30
	},
/obj/machinery/light/spot,
/obj/effect/mapping_helpers/valid_shuttle_turf,
/turf/simulated/floor/plasteel{
	icon_state = "cafeteria"
	},
/area/shuttle/escape)
"bi" = (
/obj/machinery/door/airlock{
	name = "Toilet"
	},
/obj/effect/mapping_helpers/valid_shuttle_turf,
/turf/simulated/floor/plasteel{
	icon_state = "freezerfloor"
	},
/area/shuttle/escape)
"bn" = (
/obj/machinery/door/airlock/medical/glass{
	name = "Escape Shuttle Infirmary"
	},
/obj/effect/mapping_helpers/valid_shuttle_turf,
/turf/simulated/floor/mineral/titanium,
/area/shuttle/escape)
"bo" = (
/obj/effect/mapping_helpers/valid_shuttle_turf,
/turf/simulated/floor/plasteel{
	icon_state = "freezerfloor"
	},
/area/shuttle/escape)
"bp" = (
/obj/machinery/light/spot{
	dir = 4
	},
/obj/machinery/shower,
/obj/structure/curtain/open/shower,
/obj/effect/mapping_helpers/valid_shuttle_turf,
/turf/simulated/floor/plasteel{
	icon_state = "freezerfloor"
	},
/area/shuttle/escape)
"bq" = (
/obj/structure/table/wood,
/obj/item/instrument/guitar,
/obj/effect/mapping_helpers/valid_shuttle_turf,
/turf/simulated/floor/plasteel{
	icon_state = "cafeteria"
	},
/area/shuttle/escape)
"br" = (
/obj/effect/mapping_helpers/valid_shuttle_turf,
/turf/simulated/floor/mineral/titanium,
/area/shuttle/escape)
"bs" = (
/obj/machinery/economy/vending/wallmed{
	layer = 3.3;
	name = "Emergency NanoMed";
	pixel_x = 28
	},
/obj/structure/bed/roller,
/obj/effect/mapping_helpers/valid_shuttle_turf,
/turf/simulated/floor/mineral/titanium,
/area/shuttle/escape)
"bt" = (
/obj/machinery/door/airlock{
	name = "Unit 1"
	},
/obj/effect/mapping_helpers/valid_shuttle_turf,
/turf/simulated/floor/plasteel{
	icon_state = "freezerfloor"
	},
/area/shuttle/escape)
"bv" = (
/obj/machinery/door/airlock{
	name = "Unit 2"
	},
/obj/effect/mapping_helpers/valid_shuttle_turf,
/turf/simulated/floor/plasteel{
	icon_state = "freezerfloor"
	},
/area/shuttle/escape)
"bw" = (
/obj/machinery/door/airlock{
	name = "Unit 3"
	},
/obj/effect/mapping_helpers/valid_shuttle_turf,
/turf/simulated/floor/plasteel{
	icon_state = "freezerfloor"
	},
/area/shuttle/escape)
"bx" = (
/obj/machinery/status_display{
	pixel_x = -30
	},
/obj/machinery/light/spot{
	dir = 8
	},
/obj/effect/mapping_helpers/valid_shuttle_turf,
/turf/simulated/floor/mineral/titanium,
/area/shuttle/escape)
"by" = (
/obj/item/radio/intercom{
	dir = 4;
	pixel_x = 28
	},
/obj/structure/bed/roller,
/obj/effect/mapping_helpers/valid_shuttle_turf,
/turf/simulated/floor/mineral/titanium,
/area/shuttle/escape)
"bz" = (
/obj/structure/toilet{
	dir = 4
	},
/obj/machinery/light/spot,
/obj/effect/mapping_helpers/valid_shuttle_turf,
/turf/simulated/floor/plasteel{
	icon_state = "freezerfloor"
	},
/area/shuttle/escape)
"bA" = (
/obj/machinery/light/spot,
/obj/effect/mapping_helpers/valid_shuttle_turf,
/turf/simulated/floor/plasteel{
	icon_state = "freezerfloor"
	},
/area/shuttle/escape)
"bB" = (
/obj/machinery/recharge_station,
/obj/effect/mapping_helpers/valid_shuttle_turf,
/turf/simulated/floor/plasteel{
	icon_state = "freezerfloor"
	},
/area/shuttle/escape)
"bC" = (
/obj/machinery/sleeper{
	dir = 1;
	icon_state = "sleeper"
	},
/obj/effect/mapping_helpers/valid_shuttle_turf,
/turf/simulated/floor/mineral/titanium,
/area/shuttle/escape)
"bD" = (
/obj/machinery/light/spot,
/obj/effect/mapping_helpers/valid_shuttle_turf,
/turf/simulated/floor/mineral/titanium,
/area/shuttle/escape)
"bG" = (
/obj/structure/window/reinforced{
	dir = 1
	},
/obj/structure/shuttle/engine/heater,
/turf/simulated/floor/plating/airless,
/area/shuttle/escape)
"bJ" = (
/obj/structure/shuttle/engine/heater,
/obj/structure/window/reinforced{
	dir = 1
	},
/turf/simulated/floor/plating/airless,
/area/shuttle/escape)
"bL" = (
/obj/structure/shuttle/engine/propulsion,
/turf/simulated/floor/plating/airless,
/area/shuttle/escape)
"eV" = (
/obj/effect/mapping_helpers/valid_shuttle_turf,
/turf/simulated/wall/mineral/titanium,
/area/shuttle/escape)
"oN" = (
/obj/effect/spawner/window/shuttle,
/obj/effect/mapping_helpers/valid_shuttle_turf,
/turf/simulated/floor/plating,
/area/shuttle/escape)
"Jz" = (
/obj/structure/chair/stool/bar{
	dir = 4
	},
/obj/effect/mapping_helpers/valid_shuttle_turf,
/turf/simulated/floor/plasteel{
	icon_state = "cafeteria"
	},
/area/shuttle/escape)

(1,1,1) = {"
aa
aa
aa
aa
aa
aa
ab
ab
ab
aI
ab
aT
ab
ac
ac
ac
ab
aI
ab
aI
ac
ab
ab
aa
"}
(2,1,1) = {"
aa
aa
aa
aa
aa
aa
ab
aw
aE
aF
eV
aA
aH
aX
aB
aX
aH
aA
eV
bo
bt
bz
ab
ab
"}
(3,1,1) = {"
aa
aa
aa
aa
ab
ab
ab
ax
aF
aF
eV
aA
aV
aY
bb
aY
be
aA
eV
bo
eV
eV
bG
bL
"}
(4,1,1) = {"
aa
aa
ab
ac
ab
aq
eV
aK
aF
aJ
eV
aA
aV
aY
bc
aY
be
aA
bi
bo
bv
bz
bG
bL
"}
(5,1,1) = {"
aa
ab
ab
ak
ai
ar
eV
aK
aF
aJ
eV
aA
aH
aH
aH
aH
aH
aA
eV
bo
eV
eV
bG
bL
"}
(6,1,1) = {"
ab
ab
ah
ai
al
al
eV
oN
aG
oN
oN
aA
aA
aA
aA
aA
aA
bh
eV
bo
bw
bA
ab
ab
"}
(7,1,1) = {"
ac
af
ai
al
an
al
av
aA
aA
aA
aA
aA
aA
aA
aA
aA
aA
aA
eV
bp
eV
bB
ab
aa
"}
(8,1,1) = {"
ab
ab
aj
ai
al
as
eV
az
aA
Jz
Jz
Jz
Jz
Jz
Jz
Jz
az
bh
eV
eV
eV
eV
ab
ab
"}
(9,1,1) = {"
aa
ab
ab
am
ao
al
eV
aA
aA
aN
aN
aN
aN
aN
aN
aN
aM
aA
oN
aO
bx
bC
bJ
bL
"}
(10,1,1) = {"
aa
aa
ab
ac
ab
ar
eV
aB
aH
bq
aA
aA
aA
aA
aA
aN
aM
aA
bn
br
br
br
bJ
bL
"}
(11,1,1) = {"
aa
aa
aa
aa
ab
ab
ab
aC
aH
aP
aA
aA
aA
aA
aA
aN
aM
aA
oN
br
br
bC
bJ
bL
"}
(12,1,1) = {"
aa
aa
aa
aa
aa
aa
ab
aD
aH
aA
aS
aU
aW
aZ
bd
aN
bf
aA
oN
bs
by
bD
ab
ab
"}
(13,1,1) = {"
aa
aa
aa
aa
aa
aa
ab
ab
ab
ac
ab
ab
ab
ac
ac
ac
ab
ac
ab
ab
ab
ab
ab
aa
"}
