//MAP CONVERTED BY dmm2tgm.py THIS HEADER COMMENT PREVENTS RECONVERSION, DO NOT REMOVE
"a" = (
/turf/simulated/wall/mineral/titanium,
/area/space)
"b" = (
/turf/simulated/wall/mineral/titanium,
/area/shuttle/escape)
"c" = (
/obj/effect/spawner/window/shuttle,
/turf/simulated/floor/plating,
/area/shuttle/escape)
"f" = (
/obj/structure/chair/comfy/shuttle{
	dir = 4
	},
/obj/machinery/light/spot{
	dir = 8
	},
/turf/simulated/floor/plating,
/area/shuttle/escape)
"h" = (
/turf/template_noop,
/area/template_noop)
"i" = (
/obj/machinery/door/airlock/titanium/glass{
	name = "Shuttle Hatch";
	id_tag = "s_docking_airlock";
	hackProof = 1;
	aiControlDisabled = 1
	},
/turf/simulated/floor/plating,
/area/shuttle/escape)
"j" = (
/obj/structure/chair/comfy/shuttle{
	dir = 1
	},
/turf/simulated/floor/plating,
/area/shuttle/escape)
"k" = (
/obj/machinery/door/window/reinforced/normal{
	dir = 8;
	name = "Brig"
	},
/turf/simulated/floor/mineral/plastitanium/red/brig,
/area/shuttle/escape)
"l" = (
/obj/structure/table,
/obj/item/gps,
/obj/machinery/light/spot{
	dir = 4
	},
/turf/simulated/floor/plating,
/area/shuttle/escape)
"m" = (
/turf/simulated/floor/plating,
/area/shuttle/escape)
"n" = (
/obj/machinery/computer/emergency_shuttle,
/turf/simulated/floor/plating,
/area/space)
"o" = (
/obj/structure/closet/crate,
/obj/effect/turf_decal/delivery/hollow,
/obj/effect/spawner/random/maintenance,
/turf/simulated/floor/plating,
/area/shuttle/escape)
"p" = (
/obj/structure/closet/crate,
/obj/effect/turf_decal/delivery/hollow,
/turf/simulated/floor/plating,
/area/shuttle/escape)
"q" = (
/obj/machinery/door/airlock/titanium/glass{
	name = "Cockpit"
	},
/obj/effect/mapping_helpers/airlock/access/all/security/doors,
/turf/simulated/floor/plating,
/area/shuttle/escape)
"r" = (
/obj/machinery/light/spot{
	dir = 4
	},
/obj/effect/turf_decal/delivery/hollow,
/obj/structure/closet/crate,
/obj/effect/spawner/random/maintenance,
/turf/simulated/floor/plating,
/area/shuttle/escape)
"s" = (
/obj/structure/chair/comfy/shuttle{
	dir = 4
	},
/turf/simulated/floor/plating,
/area/shuttle/escape)
"u" = (
/obj/effect/turf_decal/delivery/hollow,
/obj/structure/closet/crate,
/obj/effect/spawner/random/maintenance,
/turf/simulated/floor/plating,
/area/shuttle/escape)
"w" = (
/obj/effect/turf_decal/delivery/hollow,
/obj/structure/closet/crate,
/turf/simulated/floor/plating,
/area/shuttle/escape)
"x" = (
/obj/structure/window/plastitanium{
	dir = 1
	},
/obj/structure/window/plastitanium{
	dir = 8
	},
/obj/structure/chair/comfy/shuttle,
/turf/simulated/floor/mineral/plastitanium/red/brig,
/area/shuttle/escape)
"y" = (
/obj/structure/closet/emcloset,
/turf/simulated/floor/plating,
/area/shuttle/escape)
"z" = (
/obj/structure/shuttle/engine/heater,
/obj/structure/window/reinforced,
/obj/structure/window/reinforced{
	dir = 1;
	layer = 2.9
	},
/turf/simulated/floor/plating,
/area/shuttle/escape)
"B" = (
/obj/structure/shuttle/engine/propulsion{
	icon_state = "burst_l"
	},
/turf/simulated/floor/plating/airless,
/area/shuttle/escape)
"C" = (
/obj/structure/shuttle/engine/propulsion{
	icon_state = "propulsion_r"
	},
/turf/simulated/floor/plating/airless,
/area/shuttle/escape)
"D" = (
/obj/docking_port/mobile/emergency{
	name = "Secure Transport Vessel 5";
	timid = 1
	},
/obj/machinery/door/airlock/titanium/glass{
	name = "Shuttle Hatch";
	id_tag = "s_docking_airlock";
	hackProof = 1;
	aiControlDisabled = 1
	},
/turf/simulated/floor/plating,
/area/shuttle/escape)
"I" = (
/obj/structure/table,
/obj/item/book/manual/wiki/security_space_law/black,
/obj/item/storage/firstaid/regular,
/obj/machinery/light/spot{
	dir = 8
	},
/turf/simulated/floor/plating,
/area/shuttle/escape)
"V" = (
/obj/effect/spawner/window/shuttle,
/turf/simulated/floor/plating,
/area/space)

(1,1,1) = {"
h
a
a
b
i
b
D
b
c
c
c
b
i
b
i
b
b
b
"}
(2,1,1) = {"
a
a
I
m
m
c
m
f
s
s
s
s
m
f
m
s
z
B
"}
(3,1,1) = {"
V
n
j
m
m
q
m
m
m
m
m
m
m
m
m
m
z
C
"}
(4,1,1) = {"
a
a
l
x
k
c
y
r
u
u
p
w
u
u
o
y
z
C
"}
(5,1,1) = {"
h
a
a
b
c
b
c
b
c
c
c
b
c
b
c
b
b
b
"}
