//MAP CONVERTED BY dmm2tgm.py THIS HEADER COMMENT PREVENTS RECONVERSION, DO NOT REMOVE
"a" = (
/turf/space,
/area/space)
"b" = (
/obj/structure/shuttle/engine/propulsion{
	dir = 8
	},
/turf/simulated/wall/mineral/titanium,
/area/shuttle/transport)
"c" = (
/turf/simulated/wall/mineral/titanium,
/area/shuttle/transport)
"d" = (
/obj/effect/spawner/window/shuttle,
/turf/simulated/floor/plating,
/area/shuttle/transport)
"h" = (
/obj/machinery/light/spot{
	dir = 1
	},
/obj/structure/chair/comfy/shuttle{
	dir = 4
	},
/turf/simulated/floor/mineral/titanium/blue,
/area/shuttle/transport)
"i" = (
/obj/machinery/computer/shuttle/ferry/request,
/turf/simulated/floor/mineral/titanium/blue,
/area/shuttle/transport)
"j" = (
/obj/structure/chair/comfy/shuttle,
/turf/simulated/floor/mineral/titanium/blue,
/area/shuttle/transport)
"k" = (
/obj/machinery/light/spot{
	dir = 1
	},
/obj/structure/chair/comfy/shuttle,
/turf/simulated/floor/mineral/titanium/blue,
/area/shuttle/transport)
"l" = (
/obj/machinery/door/airlock/titanium{
	id_tag = "s_docking_airlock"
	},
/turf/simulated/floor/plating,
/area/shuttle/transport)
"m" = (
/turf/simulated/floor/mineral/titanium/blue,
/area/shuttle/transport)
"n" = (
/obj/machinery/door/airlock/titanium{
	id_tag = "s_docking_airlock"
	},
/obj/docking_port/mobile/ferry{
	timid = 1
	},
/turf/simulated/floor/plating,
/area/shuttle/transport)
"q" = (
/obj/structure/closet/crate,
/obj/machinery/light/spot,
/turf/simulated/floor/mineral/titanium/blue,
/area/shuttle/transport)
"r" = (
/obj/structure/closet/crate,
/turf/simulated/floor/mineral/titanium/blue,
/area/shuttle/transport)
"s" = (
/obj/structure/chair/comfy/shuttle{
	dir = 1
	},
/turf/simulated/floor/mineral/titanium/blue,
/area/shuttle/transport)
"t" = (
/obj/machinery/light/spot,
/obj/structure/chair/comfy/shuttle{
	dir = 1
	},
/turf/simulated/floor/mineral/titanium/blue,
/area/shuttle/transport)

(1,1,1) = {"
a
b
l
b
a
"}
(2,1,1) = {"
b
c
m
c
b
"}
(3,1,1) = {"
c
h
m
q
c
"}
(4,1,1) = {"
c
i
m
r
c
"}
(5,1,1) = {"
d
j
m
s
d
"}
(6,1,1) = {"
c
j
m
s
c
"}
(7,1,1) = {"
c
k
m
t
c
"}
(8,1,1) = {"
c
j
m
s
c
"}
(9,1,1) = {"
d
j
m
s
d
"}
(10,1,1) = {"
c
j
m
s
c
"}
(11,1,1) = {"
c
k
m
t
c
"}
(12,1,1) = {"
c
d
n
d
c
"}
